기준_년월_코드,기준_분기_코드,상권_구분_코드,상권_구분_코드_명,상권_코드,상권_코드_명,총_직장_인구_수,남성_직장_인구_수,여성_직장_인구_수
2021,2,U,관광특구,1001496,강남 마이스 관광특구,15904,8904,7000
2021,2,U,관광특구,1001495,잠실 관광특구,24375,14199,10176
2021,2,U,관광특구,1001494,종로?청계 관광특구,32935,17150,15785
2021,2,U,관광특구,1001493,동대문패션타운 관광특구,6054,2958,3096
2021,2,U,관광특구,1001492,명동 남대문 북창동 다동 무교동 관광특구,104830,53674,51156
2021,2,U,관광특구,1001491,이태원 관광특구,5839,3064,2775
2021,2,R,전통시장,1001490,길동복조리시장,430,242,188
2021,2,R,전통시장,1001489,둔촌역전통시장,224,108,116
2021,2,R,전통시장,1001488,성내골목시장,30,18,12
2021,2,R,전통시장,1001487,천호시장,35,19,16
2021,2,R,전통시장,1001486,동서울시장,5,3,2
2021,2,R,전통시장,1001484,양지골목시장,60,36,24
2021,2,R,전통시장,1001483,암사종합시장,95,53,42
2021,2,R,전통시장,1001482,고덕전통시장,935,850,85
2021,2,R,전통시장,1001481,명일골목시장,89,30,59
2021,2,R,전통시장,1001480,새마을시장,208,122,86
2021,2,R,전통시장,1001479,석촌시장,286,99,187
2021,2,R,전통시장,1001478,방이시장,3469,1526,1943
2021,2,R,전통시장,1001477,마천시장,102,70,32
2021,2,R,전통시장,1001476,풍납시장,51,20,31
2021,2,R,전통시장,1001475,강남개포시장,138,84,54
2021,2,R,전통시장,1001474,도곡시장,57,25,32
2021,2,R,전통시장,1001473,청담삼익시장,48,30,18
2021,2,R,전통시장,1001472,논현종합시장,85,43,42
2021,2,R,전통시장,1001471,영동전통시장,242,95,147
2021,2,R,전통시장,1001470,강남시장_강남,58,33,25
2021,2,R,전통시장,1001469,양재시장,35,22,13
2021,2,R,전통시장,1001468,남부종합시장,85,63,22
2021,2,R,전통시장,1001467,우림시장,1,0,1
2021,2,R,전통시장,1001466,미성동도깨비시장,75,16,59
2021,2,R,전통시장,1001463,신림중앙시장,43,27,16
2021,2,R,전통시장,1001462,강남골목시장,168,124,44
2021,2,R,전통시장,1001461,신림종합시장,8,7,1
2021,2,R,전통시장,1001460,관악신사시장,120,63,57
2021,2,R,전통시장,1001459,신원시장,42,21,21
2021,2,R,전통시장,1001458,인헌시장,122,46,76
2021,2,R,전통시장,1001457,봉천중앙시장,154,42,112
2021,2,R,전통시장,1001455,봉일시장,44,23,21
2021,2,R,전통시장,1001454,봉천제일종합시장,6,1,5
2021,2,R,전통시장,1001453,낙성대시장,10,6,4
2021,2,R,전통시장,1001452,중부시장,102,40,62
2021,2,R,전통시장,1001451,사당시장,45,20,25
2021,2,R,전통시장,1001450,남성역골목시장,467,268,199
2021,2,R,전통시장,1001449,남성사계시장,136,59,77
2021,2,R,전통시장,1001448,흑석시장,78,31,47
2021,2,R,전통시장,1001447,상도4동도깨비골목시장,95,49,46
2021,2,R,전통시장,1001446,성대시장,141,55,86
2021,2,R,전통시장,1001445,영도시장,73,6,67
2021,2,R,전통시장,1001444,상도전통시장,239,104,135
2021,2,R,전통시장,1001442,신노량진시장,11,3,8
2021,2,R,전통시장,1001441,본동인정시장,59,41,18
2021,2,R,전통시장,1001440,노량진중앙시장,244,157,87
2021,2,R,전통시장,1001439,대림중앙시장,42,29,13
2021,2,R,전통시장,1001438,우리시장,6,5,1
2021,2,R,전통시장,1001436,사러가시장,57,35,22
2021,2,R,전통시장,1001435,대신시장,12,9,3
2021,2,R,전통시장,1001433,영일시장,155,115,40
2021,2,R,전통시장,1001432,도림시장,6,4,2
2021,2,R,전통시장,1001431,영등포청과시장,23,17,6
2021,2,R,전통시장,1001430,영등포전통시장,2127,1061,1066
2021,2,R,전통시장,1001429,은행나무시장,67,40,27
2021,2,R,전통시장,1001428,박미시장,39,26,13
2021,2,R,전통시장,1001427,현대시장,139,42,97
2021,2,R,전통시장,1001426,대명시장,28,11,17
2021,2,R,전통시장,1001425,푸른터시장,3,2,1
2021,2,R,전통시장,1001424,남문시장,76,47,29
2021,2,R,전통시장,1001423,독산동 우시장,611,476,135
2021,2,R,전통시장,1001422,오류시장,132,21,111
2021,2,R,전통시장,1001421,개봉중앙시장,10,7,3
2021,2,R,전통시장,1001420,고척근린시장,55,19,36
2021,2,R,전통시장,1001418,남구로시장,236,135,101
2021,2,R,전통시장,1001417,구로시장,10,5,5
2021,2,R,전통시장,1001415,방신전통시장,116,81,35
2021,2,R,전통시장,1001414,송화골목시장,119,44,75
2021,2,R,전통시장,1001413,까치산시장,114,35,79
2021,2,R,전통시장,1001412,화곡본동시장,36,16,20
2021,2,R,전통시장,1001411,남부골목시장,156,58,98
2021,2,R,전통시장,1001410,대원종합시장,9,7,2
2021,2,R,전통시장,1001409,화곡중앙골목시장,75,32,43
2021,2,R,전통시장,1001408,신월중앙시장,118,53,65
2021,2,R,전통시장,1001406,신정3동골목시장,123,81,42
2021,2,R,전통시장,1001405,신정2동골목시장,41,13,28
2021,2,R,전통시장,1001404,신정제일시장,38,21,17
2021,2,R,전통시장,1001403,신월7동골목시장,24,16,8
2021,2,R,전통시장,1001402,신월6동골목시장,141,103,38
2021,2,R,전통시장,1001400,신월3동골목시장,12,7,5
2021,2,R,전통시장,1001399,경창시장,53,23,30
2021,2,R,전통시장,1001398,월정로시장,61,42,19
2021,2,R,전통시장,1001397,신영시장,40,13,27
2021,2,R,전통시장,1001396,목4동시장,52,35,17
2021,2,R,전통시장,1001395,목3동시장,148,67,81
2021,2,R,전통시장,1001394,목2동시장,432,251,181
2021,2,R,전통시장,1001393,마포농수산물시장,77,40,37
2021,2,R,전통시장,1001392,동진시장,10,6,4
2021,2,R,전통시장,1001391,망원월드컵시장,190,123,67
2021,2,R,전통시장,1001390,망원시장,173,81,92
2021,2,R,전통시장,1001388,영진시장,29,14,15
2021,2,R,전통시장,1001387,서교시장,24,10,14
2021,2,R,전통시장,1001386,신수시장,34,19,15
2021,2,R,전통시장,1001385,아현시장,803,430,373
2021,2,R,전통시장,1001384,마포시장,11,3,8
2021,2,R,전통시장,1001383,공덕시장,3948,2001,1947
2021,2,R,전통시장,1001382,백련시장,5,3,2
2021,2,R,전통시장,1001381,모래내시장,14,9,5
2021,2,R,전통시장,1001380,포방터시장,35,23,12
2021,2,R,전통시장,1001379,인왕시장,44,7,37
2021,2,R,전통시장,1001378,아현가구거리상점가,45,22,23
2021,2,R,전통시장,1001377,영천시장,35,19,16
2021,2,R,전통시장,1001376,수일시장,7,2,5
2021,2,R,전통시장,1001375,증산종합시장,8,5,3
2021,2,R,전통시장,1001374,대림골목시장,237,46,191
2021,2,R,전통시장,1001373,신응암시장,17,10,7
2021,2,R,전통시장,1001372,녹번시장,22,9,13
2021,2,R,전통시장,1001371,대조시장,15,7,8
2021,2,R,전통시장,1001370,역촌중앙시장,9,3,6
2021,2,R,전통시장,1001369,갈현시장,287,186,101
2021,2,R,전통시장,1001368,연서시장,206,144,62
2021,2,R,전통시장,1001367,상계중앙시장,105,59,46
2021,2,R,전통시장,1001366,상계시장,8,2,6
2021,2,R,전통시장,1001365,공릉동도깨비시장,98,47,51
2021,2,R,전통시장,1001364,방학동도깨비시장,39,16,23
2021,2,R,전통시장,1001363,쌍문역골목시장,61,14,47
2021,2,R,전통시장,1001362,백운시장,33,14,19
2021,2,R,전통시장,1001361,신도봉시장,5,5,0
2021,2,R,전통시장,1001360,창동골목시장,84,47,37
2021,2,R,전통시장,1001359,창동신창시장,104,40,64
2021,2,R,전통시장,1001358,수유북부시장,20,14,6
2021,2,R,전통시장,1001357,장미원골목시장,911,571,340
2021,2,R,전통시장,1001356,수유중앙시장,13,8,5
2021,2,R,전통시장,1001355,강북종합시장,23,9,14
2021,2,R,전통시장,1001354,우이시장,69,61,8
2021,2,R,전통시장,1001353,수유전통시장,231,55,176
2021,2,R,전통시장,1001352,번동북부골목시장,50,25,25
2021,2,R,전통시장,1001351,솔샘시장,73,30,43
2021,2,R,전통시장,1001350,숭인시장,62,27,35
2021,2,R,전통시장,1001349,방천골목시장,92,55,37
2021,2,R,전통시장,1001348,동북시장,121,49,72
2021,2,R,전통시장,1001347,석관황금시장,191,157,34
2021,2,R,전통시장,1001345,새석관시장,3,1,2
2021,2,R,전통시장,1001343,장위전통시장,40,20,20
2021,2,R,전통시장,1001342,밤나무골시장,17,5,12
2021,2,R,전통시장,1001341,길음시장,91,19,72
2021,2,R,전통시장,1001340,정릉시장,131,72,59
2021,2,R,전통시장,1001339,정릉아리랑시장,22,7,15
2021,2,R,전통시장,1001338,돈암제일시장,97,22,75
2021,2,R,전통시장,1001337,유영시장,31,20,11
2021,2,R,전통시장,1001336,우림골목시장,344,118,226
2021,2,R,전통시장,1001335,묵1동도깨비시장,35,24,11
2021,2,R,전통시장,1001334,태능시장,81,34,47
2021,2,R,전통시장,1001333,중화제일시장,69,30,39
2021,2,R,전통시장,1001332,사가정시장,86,28,58
2021,2,R,전통시장,1001331,면목골목시장,45,21,24
2021,2,R,전통시장,1001330,동원시장,224,109,115
2021,2,R,전통시장,1001329,동부골목시장,179,59,120
2021,2,R,전통시장,1001327,이경시장,16,8,8
2021,2,R,전통시장,1001326,회기시장,55,17,38
2021,2,R,전통시장,1001325,청량리청과물시장,12,9,3
2021,2,R,전통시장,1001324,전곡시장,77,42,35
2021,2,R,전통시장,1001323,답십리시장,93,40,53
2021,2,R,전통시장,1001322,동부시장,14,9,5
2021,2,R,전통시장,1001321,답십리현대시장,36,31,5
2021,2,R,전통시장,1001320,전농로터리시장,7,3,4
2021,2,R,전통시장,1001319,청량리종합시장,13,8,5
2021,2,R,전통시장,1001318,청량리전통시장,9,7,2
2021,2,R,전통시장,1001316,서울약령시장,1171,642,529
2021,2,R,전통시장,1001315,동서시장,5,3,2
2021,2,R,전통시장,1001314,경동시장,130,61,69
2021,2,R,전통시장,1001313,청량리수산시장,20,11,9
2021,2,R,전통시장,1001312,용두시장,4,2,2
2021,2,R,전통시장,1001309,조양시장,31,19,12
2021,2,R,전통시장,1001308,영동교골목시장,41,30,11
2021,2,R,전통시장,1001307,능동로골목시장,56,42,14
2021,2,R,전통시장,1001306,노룬산골목시장,23,13,10
2021,2,R,전통시장,1001305,자양종합시장,14,10,4
2021,2,R,전통시장,1001304,자양골목시장,54,36,18
2021,2,R,전통시장,1001303,신성골목시장,19,6,13
2021,2,R,전통시장,1001302,면곡골목시장,49,35,14
2021,2,R,전통시장,1001301,중곡제일시장,111,68,43
2021,2,R,전통시장,1001300,화양제일골목시장,43,11,32
2021,2,R,전통시장,1001299,한아름시장,40,29,11
2021,2,R,전통시장,1001298,성동용답상가시장,66,33,33
2021,2,R,전통시장,1001297,뚝도시장,45,17,28
2021,2,R,전통시장,1001296,금남시장,36,13,23
2021,2,R,전통시장,1001295,행당시장,314,140,174
2021,2,R,전통시장,1001294,마장축산물시장,532,358,174
2021,2,R,전통시장,1001293,보광시장,31,12,19
2021,2,R,전통시장,1001292,이태원제일시장,2,1,1
2021,2,R,전통시장,1001291,이태원시장,32,20,12
2021,2,R,전통시장,1001290,이촌종합시장,109,78,31
2021,2,R,전통시장,1001289,용문전통시장,19,10,9
2021,2,R,전통시장,1001288,만리시장,12,9,3
2021,2,R,전통시장,1001287,신흥시장,4,1,3
2021,2,R,전통시장,1001286,후암시장,15,14,1
2021,2,R,전통시장,1001285,합동(새벽)시장,365,209,156
2021,2,R,전통시장,1001284,서울중앙시장,451,320,131
2021,2,R,전통시장,1001283,백학시장,95,43,52
2021,2,R,전통시장,1001282,약수시장,271,105,166
2021,2,R,전통시장,1001281,청평화시장,120,50,70
2021,2,R,전통시장,1001280,제일평화시장,53,29,24
2021,2,R,전통시장,1001279,동평화시장,178,121,57
2021,2,R,전통시장,1001278,남평화시장,5,3,2
2021,2,R,전통시장,1001277,방산종합시장,1190,736,454
2021,2,R,전통시장,1001276,평화시장,906,614,292
2021,2,R,전통시장,1001275,인현시장,167,123,44
2021,2,R,전통시장,1001274,신중부시장,3089,921,2168
2021,2,R,전통시장,1001273,남대문시장,8186,3966,4220
2021,2,R,전통시장,1001272,신설종합시장,50,37,13
2021,2,R,전통시장,1001271,동묘시장,474,223,251
2021,2,R,전통시장,1001270,창신골목시장,13,7,6
2021,2,R,전통시장,1001269,동문시장,3,1,2
2021,2,R,전통시장,1001268,충신시장,77,40,37
2021,2,R,전통시장,1001267,종로신진시장,158,89,69
2021,2,R,전통시장,1001266,동대문종합시장,1319,965,354
2021,2,R,전통시장,1001265,광장시장,444,301,143
2021,2,R,전통시장,1001264,통인시장,59,29,30
2021,2,D,발달상권,1001263,서울 노원구 노원역_3,418,159,259
2021,2,D,발달상권,1001262,서울 노원구 노원역_2,274,126,148
2021,2,D,발달상권,1001261,서울 노원구 노원역_1,336,86,250
2021,2,D,발달상권,1001260,창동역,1003,570,433
2021,2,D,발달상권,1001259,서울 강북구 수유역_3,70,36,34
2021,2,D,발달상권,1001258,등나무근린공원 주변,65,19,46
2021,2,D,발달상권,1001257,서울 강북구 수유역_2,2284,1108,1176
2021,2,D,발달상권,1001256,서울 강북구 수유역_1,831,408,423
2021,2,D,발달상권,1001255,서울 은평구 연신내역_3,108,20,88
2021,2,D,발달상권,1001254,서울 은평구 연신내역_2,555,168,387
2021,2,D,발달상권,1001253,서울 은평구 연신내역_1,70,25,45
2021,2,D,발달상권,1001252,서울 성북구 미아삼거리역_2,322,144,178
2021,2,D,발달상권,1001251,서울 강북구 미아삼거리역_1,140,86,54
2021,2,D,발달상권,1001250,서울 은평구 불광역_3,67,24,43
2021,2,D,발달상권,1001249,서울 은평구 불광역_2,116,39,77
2021,2,D,발달상권,1001248,서울 은평구 불광역_1,180,73,107
2021,2,D,발달상권,1001247,미아사거리_2,102,47,55
2021,2,D,발달상권,1001246,미아사거리_1,210,68,142
2021,2,D,발달상권,1001245,서울 성북구 성신여대입구역,2865,1629,1236
2021,2,D,발달상권,1001244,경희대학교,70,24,46
2021,2,D,발달상권,1001243,서울 성북구 안암역,59,28,31
2021,2,D,발달상권,1001242,혜화역 대학로_3,477,210,267
2021,2,D,발달상권,1001241,혜화역 대학로_2,334,256,78
2021,2,D,발달상권,1001240,혜화역 대학로_1,1230,573,657
2021,2,D,발달상권,1001239,디지털미디어시티,6727,3880,2847
2021,2,D,발달상권,1001238,서울 동대문구 청량리역,776,413,363
2021,2,D,발달상권,1001237,서울 종로구 경복궁역_2,239,107,132
2021,2,D,발달상권,1001236,서울 종로구 안국역_2,810,409,401
2021,2,D,발달상권,1001235,서울 종로구 안국역_1,8804,7324,1480
2021,2,D,발달상권,1001234,서울 종로구 경복궁역_1,599,413,186
2021,2,D,발달상권,1001233,서울 종로구 종로3가역_3,2136,1442,694
2021,2,D,발달상권,1001232,서울 종로구 종로3가역_2,1823,948,875
2021,2,D,발달상권,1001231,서울 동대문구 신설동역_2,5440,2247,3193
2021,2,D,발달상권,1001230,인사동,26072,14829,11243
2021,2,D,발달상권,1001229,서울 종로구 종로5가역_4,1358,810,548
2021,2,D,발달상권,1001228,서울 종로구 종로5가역_3,1766,1160,606
2021,2,D,발달상권,1001227,종로구청,20709,10947,9762
2021,2,D,발달상권,1001226,서울 종로구 종로5가역_2,16173,10184,5989
2021,2,D,발달상권,1001225,신설동역,118,54,64
2021,2,D,발달상권,1001224,서울 동대문구 신설동역_1,1543,677,866
2021,2,D,발달상권,1001223,서울 종로구 광화문역_2,27999,17199,10800
2021,2,D,발달상권,1001222,동묘앞역,223,138,85
2021,2,D,발달상권,1001221,장안동사거리,1587,632,955
2021,2,D,발달상권,1001220,서울 종로구 동대문역_2,748,244,504
2021,2,D,발달상권,1001219,서울 종로구 동대문역_1,28,17,11
2021,2,D,발달상권,1001218,동대문시장_2,195,123,72
2021,2,D,발달상권,1001217,서울 종로구 종로5가역_1,22,9,13
2021,2,D,발달상권,1001216,서울 종로구 종로3가역_1,2657,1167,1490
2021,2,D,발달상권,1001215,서울 종로구 광화문역_1,12759,8498,4261
2021,2,D,발달상권,1001214,종각역,10396,8086,2310
2021,2,D,발달상권,1001213,종각역 젊음의 거리,13040,3576,9464
2021,2,D,발달상권,1001212,서대문구 서대문역_1,99,67,32
2021,2,D,발달상권,1001211,동대문시장_1,1663,493,1170
2021,2,D,발달상권,1001210,시청역_2,14646,9603,5043
2021,2,D,발달상권,1001209,서울시청,9257,4890,4367
2021,2,D,발달상권,1001208,서울 중구 을지로3가역_2,3181,2166,1015
2021,2,D,발달상권,1001207,서울 중구 신당역_2,939,534,405
2021,2,D,발달상권,1001206,서대문구 서대문역_2,1486,1018,468
2021,2,D,발달상권,1001205,동대문역사문화공원역,3166,2548,618
2021,2,D,발달상권,1001204,서울 중구 을지로3가역_1,4549,2258,2291
2021,2,D,발달상권,1001203,명동거리,8147,4244,3903
2021,2,D,발달상권,1001202,롯데백화점,27149,9657,17492
2021,2,D,발달상권,1001201,서울 중구 신당역_1,277,142,135
2021,2,D,발달상권,1001200,북창동,5197,3160,2037
2021,2,D,발달상권,1001199,서울 중구 충무로역_2,16329,7851,8478
2021,2,D,발달상권,1001198,서울 강서구 송정역,335,140,195
2021,2,D,발달상권,1001197,장한평역_2,1492,995,497
2021,2,D,발달상권,1001196,시청역_1,24904,15705,9199
2021,2,D,발달상권,1001195,왕십리역_2,233,102,131
2021,2,D,발달상권,1001194,서울 강서구 발산역,983,431,552
2021,2,D,발달상권,1001193,장한평역_1,1129,748,381
2021,2,D,발달상권,1001192,서울 중구 충무로역_1,3743,2160,1583
2021,2,D,발달상권,1001191,왕십리역_1,8,2,6
2021,2,D,발달상권,1001190,장한평역,3644,2178,1466
2021,2,D,발달상권,1001189,서울 중구 명동역,3595,1952,1643
2021,2,D,발달상권,1001188,장충동 족발거리,2100,985,1115
2021,2,D,발달상권,1001187,한양시장,55,30,25
2021,2,D,발달상권,1001186,서울 서대문구 이대역,380,160,220
2021,2,D,발달상권,1001185,서울 서대문구 신촌역,924,404,520
2021,2,D,발달상권,1001184,서울 마포구 홍대입구역_3,659,386,273
2021,2,D,발달상권,1001183,서울 마포구 홍대입구역_2,977,535,442
2021,2,D,발달상권,1001182,홍익대학교 주변,8725,5062,3663
2021,2,D,발달상권,1001181,서울 광진구 군자역,621,342,279
2021,2,D,발달상권,1001180,신촌역,4403,2012,2391
2021,2,D,발달상권,1001179,강서구청,4278,2468,1810
2021,2,D,발달상권,1001178,서울 마포구 홍대입구역_1,1618,826,792
2021,2,D,발달상권,1001177,서울 중구 약수역_2,210,91,119
2021,2,D,발달상권,1001176,서울 중구 약수역_1,24,6,18
2021,2,D,발달상권,1001175,서울 강동구 고덕역,1359,916,443
2021,2,D,발달상권,1001174,등촌역,64,37,27
2021,2,D,발달상권,1001173,서울 강동구 명일역,671,252,419
2021,2,D,발달상권,1001172,어린이대공원역,41,17,24
2021,2,D,발달상권,1001171,서울 마포구 공덕역_2,3697,2404,1293
2021,2,D,발달상권,1001170,공덕역,2092,1198,894
2021,2,D,발달상권,1001169,서울 용산구 숙대입구역,3807,1436,2371
2021,2,D,발달상권,1001168,남영역,4055,2796,1259
2021,2,D,발달상권,1001167,서울 마포구 공덕역_1,2420,796,1624
2021,2,D,발달상권,1001166,서울 마포구 마포역_2,10151,6130,4021
2021,2,D,발달상권,1001165,서울 광진구 건대입구역_2,529,268,261
2021,2,D,발달상권,1001164,서울 마포구 마포역_1,3369,2292,1077
2021,2,D,발달상권,1001163,서울 강동구 천호역_2,1208,565,643
2021,2,D,발달상권,1001162,서울 광진구 건대입구역_1,109,52,57
2021,2,D,발달상권,1001161,건대입구역,24,11,13
2021,2,D,발달상권,1001160,서울 광진구 구의역,928,584,344
2021,2,D,발달상권,1001159,서울 강동구 천호역,259,93,166
2021,2,D,발달상권,1001158,당산역_2,1429,1069,360
2021,2,D,발달상권,1001157,서울 강동구 천호역_1,138,57,81
2021,2,D,발달상권,1001156,서울 강동구 길동역,2628,1190,1438
2021,2,D,발달상권,1001155,용산 전자상가_5,1976,1461,515
2021,2,D,발달상권,1001154,용산 전자상가_4,248,182,66
2021,2,D,발달상권,1001153,당산역_1,310,186,124
2021,2,D,발달상권,1001152,서울 광진구 강변역,1337,859,478
2021,2,D,발달상권,1001151,용산 전자상가_3,1752,1311,441
2021,2,D,발달상권,1001150,서울 용산구 이태원역,452,292,160
2021,2,D,발달상권,1001149,한남오거리,823,524,299
2021,2,D,발달상권,1001148,목동사거리,41,13,28
2021,2,D,발달상권,1001147,용산 전자상가_2,392,317,75
2021,2,D,발달상권,1001146,용산구청,1526,755,771
2021,2,D,발달상권,1001145,용산 전자상가_1,3893,2851,1042
2021,2,D,발달상권,1001144,국회의사당역_2,19439,11619,7820
2021,2,D,발달상권,1001143,서울 용산구 신용산역,979,675,304
2021,2,D,발달상권,1001142,국회의사당역_1,4563,3517,1046
2021,2,D,발달상권,1001141,압구정 로데오거리_2,7107,2323,4784
2021,2,D,발달상권,1001140,서울 강남구 압구정역,9345,4345,5000
2021,2,D,발달상권,1001139,서울 영등포구 영등포구청역,449,275,174
2021,2,D,발달상권,1001138,압구정 로데오거리_1,14564,7168,7396
2021,2,D,발달상권,1001137,서울 강동구 둔촌동역,250,102,148
2021,2,D,발달상권,1001136,오목교역,125,72,53
2021,2,D,발달상권,1001135,신사동 가로수길,14671,7582,7089
2021,2,D,발달상권,1001134,서울 영등포구 여의도역_2,33585,23274,10311
2021,2,D,발달상권,1001133,청담사거리_3,1376,693,683
2021,2,D,발달상권,1001132,영등포유통상가,1504,962,542
2021,2,D,발달상권,1001131,청담역_2,4142,3212,930
2021,2,D,발달상권,1001130,청담역_1,4062,2913,1149
2021,2,D,발달상권,1001129,청담사거리_2,1289,759,530
2021,2,D,발달상권,1001128,청담사거리_1,529,295,234
2021,2,D,발달상권,1001127,서울 영등포구 여의도역_1,27015,17171,9844
2021,2,D,발달상권,1001126,서울 양천구 신정네거리역_2,28,18,10
2021,2,D,발달상권,1001125,학동사거리_2,2498,1332,1166
2021,2,D,발달상권,1001124,서울 영등포구 영등포시장역,411,246,165
2021,2,D,발달상권,1001123,학동사거리_1,4075,2555,1520
2021,2,D,발달상권,1001122,여의도 시범아파트앞,10435,6976,3459
2021,2,D,발달상권,1001121,영등포역_3,121,70,51
2021,2,D,발달상권,1001120,도산공원사거리_1,4075,1954,2121
2021,2,D,발달상권,1001119,영등포역_2,583,245,338
2021,2,D,발달상권,1001118,문래동 주민센터,6184,3312,2872
2021,2,D,발달상권,1001117,강남구 신사역_2,6953,3586,3367
2021,2,D,발달상권,1001116,영등포역_1,77,27,50
2021,2,D,발달상권,1001115,서울 강남구 강남구청역_2,3172,1916,1256
2021,2,D,발달상권,1001114,강남구 신사역_1,1108,570,538
2021,2,D,발달상권,1001113,서울 동작구 노량진1동_1,40,25,15
2021,2,D,발달상권,1001112,서울 강남구 학동역_3,3152,1780,1372
2021,2,D,발달상권,1001111,서울 강남구 강남구청역_1,3516,2335,1181
2021,2,D,발달상권,1001110,잠실역,42527,22605,19922
2021,2,D,발달상권,1001109,강남구 논현역_4,4927,2720,2207
2021,2,D,발달상권,1001108,학동역,1014,616,398
2021,2,D,발달상권,1001107,방이동 먹자골목,6881,4444,2437
2021,2,D,발달상권,1001106,서울 강남구 학동역_2,2510,1674,836
2021,2,D,발달상권,1001105,서울 동작구 노량진역,436,252,184
2021,2,D,발달상권,1001104,삼성역_3,52277,41226,11051
2021,2,D,발달상권,1001103,코엑스,15904,8904,7000
2021,2,D,발달상권,1001102,서울 강남구 학동역_1,1691,1037,654
2021,2,D,발달상권,1001101,선정릉역_2,3758,2684,1074
2021,2,D,발달상권,1001100,강남구 논현역_3,2466,700,1766
2021,2,D,발달상권,1001099,포스코사거리_2,16526,9641,6885
2021,2,D,발달상권,1001098,포스코사거리_1,22702,15610,7092
2021,2,D,발달상권,1001097,잠실역 롯데월드,2247,1185,1062
2021,2,D,발달상권,1001096,신도림역,1674,907,767
2021,2,D,발달상권,1001095,강남구 논현역_2,9009,5256,3753
2021,2,D,발달상권,1001094,선정릉역_1,2392,1492,900
2021,2,D,발달상권,1001093,신천역,4789,2992,1797
2021,2,D,발달상권,1001092,강남구 논현역_1,2284,1208,1076
2021,2,D,발달상권,1001091,삼성역_2,7062,3420,3642
2021,2,D,발달상권,1001090,삼정역_2,1162,721,441
2021,2,D,발달상권,1001089,삼정역_1,2277,1123,1154
2021,2,D,발달상권,1001088,삼성역_1,18695,12565,6130
2021,2,D,발달상권,1001087,서울 강남구 선릉역_2,40183,20392,19791
2021,2,D,발달상권,1001086,고속터미널역,2010,1612,398
2021,2,D,발달상권,1001085,서울 서초구 강남역,19954,10752,9202
2021,2,D,발달상권,1001084,서울 강남구 선릉역_1,21572,9107,12465
2021,2,D,발달상권,1001083,서울 송파구 석촌역_2,597,380,217
2021,2,D,발달상권,1001082,선릉역_2,26260,16412,9848
2021,2,D,발달상권,1001081,서울 강남구 역삼역_2,19179,15530,3649
2021,2,D,발달상권,1001080,서울 송파구 석촌역_1,168,96,72
2021,2,D,발달상권,1001079,석촌역,170,135,35
2021,2,D,발달상권,1001078,서울 강남구 강남역_2,9449,4629,4820
2021,2,D,발달상권,1001077,선릉역_1,16454,10830,5624
2021,2,D,발달상권,1001076,구로역,201,101,100
2021,2,D,발달상권,1001075,역삼역_2,10137,4381,5756
2021,2,D,발달상권,1001074,대림역_2,5179,3395,1784
2021,2,D,발달상권,1001073,서울 강남구 역삼역_1,22546,15049,7497
2021,2,D,발달상권,1001072,신대방삼거리역,259,129,130
2021,2,D,발달상권,1001071,서울 강남구 한티역,673,371,302
2021,2,D,발달상권,1001070,은마아파트입구사거리_4,570,252,318
2021,2,D,발달상권,1001069,은마아파트입구사거리_3,103,45,58
2021,2,D,발달상권,1001068,은마아파트입구사거리_2,15650,5160,10490
2021,2,D,발달상권,1001067,오류동역,2297,1736,561
2021,2,D,발달상권,1001066,서울 강남구 강남역,27566,14310,13256
2021,2,D,발달상권,1001065,은마아파트입구사거리_1,277,92,185
2021,2,D,발달상권,1001064,대림역_1,340,205,135
2021,2,D,발달상권,1001063,교대역_4,6267,3940,2327
2021,2,D,발달상권,1001062,서울 강남구 강남역_1,25938,14288,11650
2021,2,D,발달상권,1001061,방배동카페골목,374,218,156
2021,2,D,발달상권,1001059,교대역_3,1005,649,356
2021,2,D,발달상권,1001058,역삼역_1,10667,5507,5160
2021,2,D,발달상권,1001057,교대역_2,3971,2510,1461
2021,2,D,발달상권,1001056,서울 송파구 가락시장역,5421,3249,2172
2021,2,D,발달상권,1001055,서울 서초구 서초역,1858,988,870
2021,2,D,발달상권,1001054,서울 강남구 대치역_2,1139,629,510
2021,2,D,발달상권,1001053,서울 강남구 대치역_1,102,38,64
2021,2,D,발달상권,1001052,뱅뱅사거리_2,12301,8384,3917
2021,2,D,발달상권,1001051,보라매공원,2417,1455,962
2021,2,D,발달상권,1001050,교대역_1,17722,8352,9370
2021,2,D,발달상권,1001049,개봉동 현대아파트 인근,271,126,145
2021,2,D,발달상권,1001048,뱅뱅사거리,7114,4891,2223
2021,2,D,발달상권,1001047,뱅뱅사거리_1,4820,3658,1162
2021,2,D,발달상권,1001046,서울 관악구 신림역_4,332,165,167
2021,2,D,발달상권,1001045,동작구 총신대입구역_1,327,125,202
2021,2,D,발달상권,1001044,양재역_3,9025,5664,3361
2021,2,D,발달상권,1001043,동작구 총신대입구역_2,1633,741,892
2021,2,D,발달상권,1001042,서울 서초구 남부터미널역_3,3060,1217,1843
2021,2,D,발달상권,1001041,서울 강남구 수서역,12418,6339,6079
2021,2,D,발달상권,1001040,서울 관악구 신림역_3,77,20,57
2021,2,D,발달상권,1001039,서울 서초구 남부터미널역_2,3012,1965,1047
2021,2,D,발달상권,1001038,구로디지탈1단지,43655,28446,15209
2021,2,D,발달상권,1001037,양재역,904,474,430
2021,2,D,발달상권,1001036,문정역,88,52,36
2021,2,D,발달상권,1001035,매봉역,5760,4107,1653
2021,2,D,발달상권,1001034,서울 서초구 방배역,1690,910,780
2021,2,D,발달상권,1001033,서울 서초구 남부터미널역_1,2033,1323,710
2021,2,D,발달상권,1001032,서울 관악구 신림역_2,166,63,103
2021,2,D,발달상권,1001031,서울 관악구 신림역_1,615,316,299
2021,2,D,발달상권,1001030,양재역_2,2634,1725,909
2021,2,D,발달상권,1001029,양재역_1,515,305,210
2021,2,D,발달상권,1001028,서울 관악구 서울대입구역_2,57,28,29
2021,2,D,발달상권,1001027,가산디지털단지역_3,22935,14390,8545
2021,2,D,발달상권,1001026,구로디지털단지역,91,67,24
2021,2,D,발달상권,1001025,서울 관악구 서울대입구역_1,1502,797,705
2021,2,D,발달상권,1001024,관악구 사당역_1,5523,2253,3270
2021,2,D,발달상권,1001023,가산디지털단지역_2,25194,16241,8953
2021,2,D,발달상권,1001022,관악구 사당역_2,744,453,291
2021,2,D,발달상권,1001021,가산디지털단지역_1,18317,12138,6179
2021,2,D,발달상권,1001020,장지역,4411,3129,1282
2021,2,D,발달상권,1001019,포이사거리_1,192,141,51
2021,2,D,발달상권,1001018,포이사거리_2,7673,5359,2314
2021,2,D,발달상권,1001017,관악구 사당역_3,1538,1135,403
2021,2,D,발달상권,1001016,서울 관악구 대학동_1,662,558,104
2021,2,D,발달상권,1001015,서울 금천구 독산1동_1,716,485,231
2021,2,D,발달상권,1001014,양재동 꽃시장,1540,858,682
2021,2,D,발달상권,1001013,양재 화물트럭터미널앞_2,843,619,224
2021,2,D,발달상권,1001012,양재 화물트럭터미널앞_1,1944,1643,301
2021,2,D,발달상권,1001011,서울 금천구 시흥1동_4,486,164,322
2021,2,A,골목상권,1001010,풍성로37가길,128,57,71
2021,2,A,골목상권,1001009,천호옛길,420,288,132
2021,2,A,골목상권,1001008,천호옛14길,177,93,84
2021,2,A,골목상권,1001007,천호대로219길,486,338,148
2021,2,A,골목상권,1001006,천호대로197길,239,168,71
2021,2,A,골목상권,1001005,천호대로187길,371,200,171
2021,2,A,골목상권,1001004,천호대로170길,303,177,126
2021,2,A,골목상권,1001003,천호대로162길,286,149,137
2021,2,A,골목상권,1001002,천중로51길,761,536,225
2021,2,A,골목상권,1001001,천중로39길,574,375,199
2021,2,A,골목상권,1001000,진황도로47길,131,63,68
2021,2,A,골목상권,1000999,진황도로27길,298,174,124
2021,2,A,골목상권,1000998,올림픽로98길,257,169,88
2021,2,A,골목상권,1000997,올림픽로80길,152,54,98
2021,2,A,골목상권,1000996,올림픽로78길,115,58,57
2021,2,A,골목상권,1000995,올림픽로77길,210,114,96
2021,2,A,골목상권,1000994,올림픽로71길,184,101,83
2021,2,A,골목상권,1000993,올림픽로48길,1847,1272,575
2021,2,A,골목상권,1000992,양재대로96길,197,131,66
2021,2,A,골목상권,1000991,양재대로95길,602,324,278
2021,2,A,골목상권,1000990,양재대로91길,358,230,128
2021,2,A,골목상권,1000989,양재대로133길,189,122,67
2021,2,A,골목상권,1000988,양재대로124길,435,258,177
2021,2,A,골목상권,1000987,양재대로116길,75,41,34
2021,2,A,골목상권,1000986,양재대로101길,677,313,364
2021,2,A,골목상권,1000985,암사길,112,70,42
2021,2,A,골목상권,1000984,성안로3길,5508,4242,1266
2021,2,A,골목상권,1000983,성내로5길,1005,650,355
2021,2,A,골목상권,1000982,상일로5길,172,124,48
2021,2,A,골목상권,1000981,상암로5길,271,99,172
2021,2,A,골목상권,1000980,상암로51길,302,122,180
2021,2,A,골목상권,1000979,상암로4길,232,147,85
2021,2,A,골목상권,1000978,상암로14길,432,261,171
2021,2,A,골목상권,1000977,명일로13길,302,182,120
2021,2,A,골목상권,1000976,동남로85길,635,344,291
2021,2,A,골목상권,1000975,동남로82길,108,64,44
2021,2,A,골목상권,1000974,동남로65길,297,202,95
2021,2,A,골목상권,1000973,구천면로42길,87,52,35
2021,2,A,골목상권,1000972,구천면로41길,442,228,214
2021,2,A,골목상권,1000971,구천면로36길,32,14,18
2021,2,A,골목상권,1000970,고덕로61길,137,93,44
2021,2,A,골목상권,1000969,고덕로25길,143,91,52
2021,2,A,골목상권,1000968,고덕로10길,738,335,403
2021,2,A,골목상권,1000967,강동대로53길,1092,726,366
2021,2,A,골목상권,1000966,풍성로25길,84,43,41
2021,2,A,골목상권,1000965,오금로46길,711,359,352
2021,2,A,골목상권,1000964,오금로36길,1133,803,330
2021,2,A,골목상권,1000963,오금로11길,1427,884,543
2021,2,A,골목상권,1000962,양재대로72길,245,124,121
2021,2,A,골목상권,1000961,양재대로71길,1999,1458,541
2021,2,A,골목상권,1000960,양재대로64길,1212,705,507
2021,2,A,골목상권,1000959,양재대로62길,3230,2137,1093
2021,2,A,골목상권,1000958,송파대로30길,2240,1393,847
2021,2,A,골목상권,1000957,송이로36길,2096,1409,687
2021,2,A,골목상권,1000956,송이로32길,1295,733,562
2021,2,A,골목상권,1000955,송이로23길,1850,1269,581
2021,2,A,골목상권,1000954,삼전로13길,1420,916,504
2021,2,A,골목상권,1000953,백제고분로50길,1209,796,413
2021,2,A,골목상권,1000952,백제고분로46길,665,472,193
2021,2,A,골목상권,1000951,백제고분로45길,1349,869,480
2021,2,A,골목상권,1000950,백제고분로42길,590,289,301
2021,2,A,골목상권,1000949,백제고분로39길,566,393,173
2021,2,A,골목상권,1000948,백제고분로34길,1779,1368,411
2021,2,A,골목상권,1000947,백제고분로33길,921,574,347
2021,2,A,골목상권,1000946,백제고분로32길,725,407,318
2021,2,A,골목상권,1000945,백제고분로31길,1708,1370,338
2021,2,A,골목상권,1000944,백제고분로22길,1371,955,416
2021,2,A,골목상권,1000943,백제고분로21길,483,309,174
2021,2,A,골목상권,1000942,마천로51길,417,245,172
2021,2,A,골목상권,1000941,동남로20길,2463,1773,690
2021,2,A,골목상권,1000940,거마로20길,503,229,274
2021,2,A,골목상권,1000939,학동로77길,1851,1119,732
2021,2,A,골목상권,1000938,학동로6길,1447,977,470
2021,2,A,골목상권,1000937,학동로56길,2421,1533,888
2021,2,A,골목상권,1000936,학동로38길,1862,891,971
2021,2,A,골목상권,1000935,테헤란로81길,1637,791,846
2021,2,A,골목상권,1000934,일원로9길,590,334,256
2021,2,A,골목상권,1000933,일원로3길,513,237,276
2021,2,A,골목상권,1000932,영동대로65길,1175,692,483
2021,2,A,골목상권,1000931,영동대로112길,9367,7734,1633
2021,2,A,골목상권,1000930,언주로81길,5810,3989,1821
2021,2,A,골목상권,1000929,압구정로2길,1937,1352,585
2021,2,A,골목상권,1000928,선릉로18길,466,366,100
2021,2,A,골목상권,1000927,선릉로146길,1123,536,587
2021,2,A,골목상권,1000926,선릉로133길,739,434,305
2021,2,A,골목상권,1000925,선릉로132길,1305,645,660
2021,2,A,골목상권,1000924,선릉로121길,2263,1243,1020
2021,2,A,골목상권,1000923,삼성로75길,1814,1262,552
2021,2,A,골목상권,1000922,삼성로69길,2064,1086,978
2021,2,A,골목상권,1000921,삼성로64길,2957,1473,1484
2021,2,A,골목상권,1000920,삼성로63길,1079,554,525
2021,2,A,골목상권,1000919,삼성로57길,3231,1896,1335
2021,2,A,골목상권,1000918,삼성로147길,190,88,102
2021,2,A,골목상권,1000917,삼성로115길,839,429,410
2021,2,A,골목상권,1000916,봉은사로68길,1265,789,476
2021,2,A,골목상권,1000915,봉은사로57길,638,409,229
2021,2,A,골목상권,1000914,봉은사로43길,2978,1692,1286
2021,2,A,골목상권,1000913,봉은사로29길,1860,1203,657
2021,2,A,골목상권,1000912,봉은사로109길,2837,2093,744
2021,2,A,골목상권,1000911,도산대로89길,1284,730,554
2021,2,A,골목상권,1000910,도산대로81길,3094,1363,1731
2021,2,A,골목상권,1000909,도산대로50길,2685,1863,822
2021,2,A,골목상권,1000908,도산대로38길,1043,622,421
2021,2,A,골목상권,1000907,도산대로30길,3153,1611,1542
2021,2,A,골목상권,1000906,도산대로23길,425,176,249
2021,2,A,골목상권,1000905,도산대로15길,123,65,58
2021,2,A,골목상권,1000904,도곡로37길,7206,4518,2688
2021,2,A,골목상권,1000903,논현로8길,1081,701,380
2021,2,A,골목상권,1000902,논현로63길,2139,1352,787
2021,2,A,골목상권,1000901,논현로28길,2736,1826,910
2021,2,A,골목상권,1000900,논현로26길,17916,5148,12768
2021,2,A,골목상권,1000899,논현로159길,109,49,60
2021,2,A,골목상권,1000898,논현로139길,3565,2123,1442
2021,2,A,골목상권,1000897,논현로123길,162,106,56
2021,2,A,골목상권,1000896,논현로115길,2866,1752,1114
2021,2,A,골목상권,1000895,논현로10길,454,271,183
2021,2,A,골목상권,1000894,논현로106길,1488,1027,461
2021,2,A,골목상권,1000893,남부순환로365길,691,445,246
2021,2,A,골목상권,1000892,개포로82길,103,51,52
2021,2,A,골목상권,1000891,개포로28길,589,445,144
2021,2,A,골목상권,1000890,개포로20길,647,400,247
2021,2,A,골목상권,1000889,개포로17길,961,659,302
2021,2,A,골목상권,1000888,강남대로140길,1433,810,623
2021,2,A,골목상권,1000887,강남대로136길,5070,3655,1415
2021,2,A,골목상권,1000886,강남대로118길,218,91,127
2021,2,A,골목상권,1000885,서초중앙로8길,21671,11288,10383
2021,2,A,골목상권,1000884,방배중앙로21길,7153,2605,4548
2021,2,A,골목상권,1000883,효령로72길,3428,2690,738
2021,2,A,골목상권,1000882,효령로34길,1015,653,362
2021,2,A,골목상권,1000881,효령로31길,2710,2198,512
2021,2,A,골목상권,1000880,효령로23길,1492,964,528
2021,2,A,골목상권,1000879,청두곶길,1446,795,651
2021,2,A,골목상권,1000878,주흥길,164,111,53
2021,2,A,골목상권,1000877,주흥15길,834,539,295
2021,2,A,골목상권,1000876,언남길,1128,742,386
2021,2,A,골목상권,1000875,신반포로45길,1192,625,567
2021,2,A,골목상권,1000874,서초대로8길,2598,644,1954
2021,2,A,골목상권,1000873,서초대로64길,829,489,340
2021,2,A,골목상권,1000872,서초대로4길,847,478,369
2021,2,A,골목상권,1000871,서초대로25길,2073,1591,482
2021,2,A,골목상권,1000870,서초대로23길,2098,1239,859
2021,2,A,골목상권,1000869,서초대로15길,467,253,214
2021,2,A,골목상권,1000868,사평대로57길,65,33,32
2021,2,A,골목상권,1000867,사평대로26길,509,346,163
2021,2,A,골목상권,1000866,사평대로22길,1697,1052,645
2021,2,A,골목상권,1000865,사임당로17길,1939,1273,666
2021,2,A,골목상권,1000864,방배로42길,861,707,154
2021,2,A,골목상권,1000863,방배로35길,1137,711,426
2021,2,A,골목상권,1000862,방배로18길,873,535,338
2021,2,A,골목상권,1000861,반포대로9길,538,288,250
2021,2,A,골목상권,1000860,바우뫼로39길,2648,1935,713
2021,2,A,골목상권,1000859,마방로2길,3582,2570,1012
2021,2,A,골목상권,1000858,방배천로4안길,959,401,558
2021,2,A,골목상권,1000857,동산로19길,1276,633,643
2021,2,A,골목상권,1000856,동산로10길,2158,1493,665
2021,2,A,골목상권,1000855,동광로39길,1227,825,402
2021,2,A,골목상권,1000854,동광로1길,2565,1862,703
2021,2,A,골목상권,1000853,동광로12길,1237,610,627
2021,2,A,골목상권,1000852,논현로27길,2808,2146,662
2021,2,A,골목상권,1000851,논현로1길,1227,780,447
2021,2,A,골목상권,1000850,남부순환로339길,1451,978,473
2021,2,A,골목상권,1000849,남부순환로325길,1477,1061,416
2021,2,A,골목상권,1000848,남부순환로317길,2386,1532,854
2021,2,A,골목상권,1000847,고무래로8길,5479,3568,1911
2021,2,A,골목상권,1000846,강남대로8길,1850,1231,619
2021,2,A,골목상권,1000845,강남대로34길,1734,1204,530
2021,2,A,골목상권,1000844,강남대로23길,2897,1993,904
2021,2,A,골목상권,1000843,소담길,14,4,10
2021,2,A,골목상권,1000842,원신길,22,11,11
2021,2,A,골목상권,1000840,양산길,11,3,8
2021,2,A,골목상권,1000839,호암로24길,1218,1084,134
2021,2,A,골목상권,1000838,호암로20길,186,77,109
2021,2,A,골목상권,1000837,행운길,557,428,129
2021,2,A,골목상권,1000836,행운1길,250,151,99
2021,2,A,골목상권,1000835,청림3길,167,58,109
2021,2,A,골목상권,1000834,청룡길,404,224,180
2021,2,A,골목상권,1000833,청룡8길,222,53,169
2021,2,A,골목상권,1000832,중앙길,99,30,69
2021,2,A,골목상권,1000831,조원중앙로2길,921,694,227
2021,2,A,골목상권,1000830,조원로18길,179,92,87
2021,2,A,골목상권,1000829,조원로10길,397,215,182
2021,2,A,골목상권,1000828,장군봉2길,201,115,86
2021,2,A,골목상권,1000827,장군봉1길,326,166,160
2021,2,A,골목상권,1000826,인헌길,115,61,54
2021,2,A,골목상권,1000825,은천로25길,44,21,23
2021,2,A,골목상권,1000824,양녕로6길,205,124,81
2021,2,A,골목상권,1000823,신원로3길,180,103,77
2021,2,A,골목상권,1000822,신사로20길,121,93,28
2021,2,A,골목상권,1000821,신림로65길,228,175,53
2021,2,A,골목상권,1000820,신림로64길,113,45,68
2021,2,A,골목상권,1000819,신림로48길,75,49,26
2021,2,A,골목상권,1000818,신림로38길,147,90,57
2021,2,A,골목상권,1000817,신림로28길,442,283,159
2021,2,A,골목상권,1000816,신림로11길,284,183,101
2021,2,A,골목상권,1000815,신림동길,669,435,234
2021,2,A,골목상권,1000814,승방길,251,141,110
2021,2,A,골목상권,1000813,서림7길,116,58,58
2021,2,A,골목상권,1000812,봉천로33길,211,131,80
2021,2,A,골목상권,1000811,봉천로13길,241,86,155
2021,2,A,골목상권,1000810,복은길,405,229,176
2021,2,A,골목상권,1000809,법원단지길,16,5,11
2021,2,A,골목상권,1000808,법원단지9길,163,102,61
2021,2,A,골목상권,1000807,미성5길,309,154,155
2021,2,A,골목상권,1000806,대학길,80,45,35
2021,2,A,골목상권,1000805,대학14길,61,31,30
2021,2,A,골목상권,1000804,당곡길,227,117,110
2021,2,A,골목상권,1000803,남현길,117,28,89
2021,2,A,골목상권,1000802,남현3길,372,256,116
2021,2,A,골목상권,1000801,남현2길,568,398,170
2021,2,A,골목상권,1000800,남부순환로248길,404,213,191
2021,2,A,골목상권,1000799,남부순환로234길,126,81,45
2021,2,A,골목상권,1000798,남부순환로172길,450,316,134
2021,2,A,골목상권,1000797,남부순환로161길,347,223,124
2021,2,A,골목상권,1000796,남부순환로151길,788,369,419
2021,2,A,골목상권,1000795,남부순환로142길,418,252,166
2021,2,A,골목상권,1000794,난향길,206,89,117
2021,2,A,골목상권,1000793,난우길,217,121,96
2021,2,A,골목상권,1000792,난곡로74길,2179,1754,425
2021,2,A,골목상권,1000791,난곡로34길,47,19,28
2021,2,A,골목상권,1000790,난곡로26길,120,85,35
2021,2,A,골목상권,1000789,난곡로24길,89,34,55
2021,2,A,골목상권,1000788,낙성대역길,431,230,201
2021,2,A,골목상권,1000787,국회단지길,1430,396,1034
2021,2,A,골목상권,1000786,구암길,228,72,156
2021,2,A,골목상권,1000785,관천로22길,194,117,77
2021,2,A,골목상권,1000784,관천로15길,236,149,87
2021,2,A,골목상권,1000783,관악로30길,140,51,89
2021,2,A,골목상권,1000782,관악로28길,122,39,83
2021,2,A,골목상권,1000781,관악로14길,109,42,67
2021,2,A,골목상권,1000780,관악로10길,1482,1050,432
2021,2,A,골목상권,1000779,흑석로9길,110,76,34
2021,2,A,골목상권,1000778,흑석로13길,77,33,44
2021,2,A,골목상권,1000777,장승배기로27길,260,135,125
2021,2,A,골목상권,1000776,장승배기로19길,518,409,109
2021,2,A,골목상권,1000775,장승배기로10길,223,90,133
2021,2,A,골목상권,1000774,여의대방로46길,1238,733,505
2021,2,A,골목상권,1000773,여의대방로24길,16249,10586,5663
2021,2,A,골목상권,1000772,여의대방로22카길,346,202,144
2021,2,A,골목상권,1000771,여의대방로22나길,188,95,93
2021,2,A,골목상권,1000770,여의대방로22길,241,128,113
2021,2,A,골목상권,1000769,양녕로26길,92,49,43
2021,2,A,골목상권,1000768,신대방길,191,90,101
2021,2,A,골목상권,1000767,성대로29길,297,143,154
2021,2,A,골목상권,1000766,성대로1길,87,43,44
2021,2,A,골목상권,1000765,서달로8가길,83,34,49
2021,2,A,골목상권,1000764,서달로15길,42,14,28
2021,2,A,골목상권,1000763,서달로14길,21,7,14
2021,2,A,골목상권,1000762,서달로10길,51,28,23
2021,2,A,골목상권,1000761,상도로62길,332,179,153
2021,2,A,골목상권,1000760,상도로61길,187,67,120
2021,2,A,골목상권,1000759,상도로47길,601,288,313
2021,2,A,골목상권,1000758,상도로37길,128,65,63
2021,2,A,골목상권,1000757,상도로15길,320,121,199
2021,2,A,골목상권,1000756,사당로8길,131,70,61
2021,2,A,골목상권,1000755,사당로30길,514,180,334
2021,2,A,골목상권,1000754,사당로2차길,324,216,108
2021,2,A,골목상권,1000753,사당로29길,128,78,50
2021,2,A,골목상권,1000752,사당로26길,321,199,122
2021,2,A,골목상권,1000751,사당로23나길,36,21,15
2021,2,A,골목상권,1000749,사당로20길,103,53,50
2021,2,A,골목상권,1000748,사당로16길,116,36,80
2021,2,A,골목상권,1000747,사당로16가길,237,147,90
2021,2,A,골목상권,1000746,만양로8길,824,512,312
2021,2,A,골목상권,1000745,만양로14길,47,29,18
2021,2,A,골목상권,1000744,등용로14길,409,134,275
2021,2,A,골목상권,1000743,동작대로7길,182,84,98
2021,2,A,골목상권,1000742,동작대로35길,190,87,103
2021,2,A,골목상권,1000741,동작대로33길,170,88,82
2021,2,A,골목상권,1000740,동작대로29길,224,49,175
2021,2,A,골목상권,1000739,동작대로17길,806,386,420
2021,2,A,골목상권,1000738,대방동2길,281,134,147
2021,2,A,골목상권,1000737,대방동27길,465,223,242
2021,2,A,골목상권,1000736,노량진로6길,307,204,103
2021,2,A,골목상권,1000735,국사봉길,138,79,59
2021,2,A,골목상권,1000734,국사봉2길,55,34,21
2021,2,A,골목상권,1000733,국사봉1길,85,52,33
2021,2,A,골목상권,1000732,영신로9길,3221,1646,1575
2021,2,A,골목상권,1000731,영등포로84길,1933,673,1260
2021,2,A,골목상권,1000730,영등포로80길,96,48,48
2021,2,A,골목상권,1000729,영등포로62길,118,85,33
2021,2,A,골목상권,1000728,영등포로35길,340,192,148
2021,2,A,골목상권,1000727,영등포로27길,301,189,112
2021,2,A,골목상권,1000726,영등포로25길,493,363,130
2021,2,A,골목상권,1000725,여의대방로61길,514,400,114
2021,2,A,골목상권,1000724,여의대방로43나길,859,661,198
2021,2,A,골목상권,1000723,여의대방로39길,193,112,81
2021,2,A,골목상권,1000722,여의대방로35길,197,65,132
2021,2,A,골목상권,1000721,양평로28길,847,707,140
2021,2,A,골목상권,1000720,양평로22라길,555,299,256
2021,2,A,골목상권,1000719,양평로19길,748,436,312
2021,2,A,골목상권,1000718,신길로60길,260,196,64
2021,2,A,골목상권,1000717,신길로42길,501,270,231
2021,2,A,골목상권,1000716,신길로42가길,210,90,120
2021,2,A,골목상권,1000715,신길로39길,56,32,24
2021,2,A,골목상권,1000714,신길로17길,676,289,387
2021,2,A,골목상권,1000713,선유서로28길,208,110,98
2021,2,A,골목상권,1000712,선유서로25길,1697,1284,413
2021,2,A,골목상권,1000711,선유서로24길,114,70,44
2021,2,A,골목상권,1000710,선유로55길,416,273,143
2021,2,A,골목상권,1000709,디지털로74길,13,8,5
2021,2,A,골목상권,1000708,디지털로57길,1036,639,397
2021,2,A,골목상권,1000707,디지털로37길,172,55,117
2021,2,A,골목상권,1000706,도신로62길,227,173,54
2021,2,A,골목상권,1000705,도신로60길,124,51,73
2021,2,A,골목상권,1000704,도신로29길,108,49,59
2021,2,A,골목상권,1000703,도신로15길,437,238,199
2021,2,A,골목상권,1000702,도림천로21길,236,157,79
2021,2,A,골목상권,1000701,도림로63길,53,41,12
2021,2,A,골목상권,1000700,도림로147길,334,255,79
2021,2,A,골목상권,1000699,도림로112길,30,19,11
2021,2,A,골목상권,1000698,대림로8길,234,113,121
2021,2,A,골목상권,1000697,대림로7길,49,23,26
2021,2,A,골목상권,1000696,대림로44길,411,289,122
2021,2,A,골목상권,1000695,대림로34길,201,139,62
2021,2,A,골목상권,1000694,대림로31길,454,281,173
2021,2,A,골목상권,1000693,대림로29길,964,624,340
2021,2,A,골목상권,1000692,대림로22길,190,98,92
2021,2,A,골목상권,1000691,당산로46길,698,529,169
2021,2,A,골목상권,1000690,당산로38길,676,471,205
2021,2,A,골목상권,1000689,당산로37길,2439,1483,956
2021,2,A,골목상권,1000688,당산로31길,1481,749,732
2021,2,A,골목상권,1000687,국회대로56길,3275,1590,1685
2021,2,A,골목상권,1000686,경인로90길,282,210,72
2021,2,A,골목상권,1000685,경인로80길,1007,706,301
2021,2,A,골목상권,1000684,경인로77길,741,512,229
2021,2,A,골목상권,1000683,가마산로61길,47,35,12
2021,2,A,골목상권,1000682,시흥대로94길,446,164,282
2021,2,A,골목상권,1000681,시흥대로84길,178,103,75
2021,2,A,골목상권,1000680,시흥대로68길,549,219,330
2021,2,A,골목상권,1000679,시흥대로63길,1016,542,474
2021,2,A,골목상권,1000678,시흥대로62가길,86,59,27
2021,2,A,골목상권,1000677,시흥대로36길,288,173,115
2021,2,A,골목상권,1000676,시흥대로22길,259,143,116
2021,2,A,골목상권,1000675,시흥대로153길,92,55,37
2021,2,A,골목상권,1000674,시흥대로150길,421,278,143
2021,2,A,골목상권,1000673,시흥대로141길,214,142,72
2021,2,A,골목상권,1000672,시흥대로138길,341,246,95
2021,2,A,골목상권,1000671,시흥대로120길,192,117,75
2021,2,A,골목상권,1000670,벚꽃로56길,301,260,41
2021,2,A,골목상권,1000669,범안로17길,4567,2830,1737
2021,2,A,골목상권,1000668,범안로11길,1498,819,679
2021,2,A,골목상권,1000667,문성로5길,379,199,180
2021,2,A,골목상권,1000666,독산로85길,68,34,34
2021,2,A,골목상권,1000665,독산로78다길,195,124,71
2021,2,A,골목상권,1000664,독산로70길,74,31,43
2021,2,A,골목상권,1000663,독산로64길,186,152,34
2021,2,A,골목상권,1000662,독산로50길,27,6,21
2021,2,A,골목상권,1000661,독산로40길,219,75,144
2021,2,A,골목상권,1000660,독산로108길,1619,1443,176
2021,2,A,골목상권,1000659,남부순환로112길,96,66,30
2021,2,A,골목상권,1000658,금하로24길,132,72,60
2021,2,A,골목상권,1000657,금하로1길,227,175,52
2021,2,A,골목상권,1000656,금하로14길,96,65,31
2021,2,A,골목상권,1000655,가산로5길,499,350,149
2021,2,A,골목상권,1000654,가산로3길,999,756,243
2021,2,A,골목상권,1000653,중앙로1길,960,704,256
2021,2,A,골목상권,1000652,중앙로15길,171,106,65
2021,2,A,골목상권,1000651,우마길,43,19,24
2021,2,A,골목상권,1000650,오류로8길,442,219,223
2021,2,A,골목상권,1000649,신도림로13길,148,100,48
2021,2,A,골목상권,1000648,새말로18길,933,549,384
2021,2,A,골목상권,1000647,부일로1길,356,321,35
2021,2,A,골목상권,1000646,부일로15길,156,107,49
2021,2,A,골목상권,1000645,부일로11길,281,115,166
2021,2,A,골목상권,1000644,디지털로32길,815,435,380
2021,2,A,골목상권,1000643,디지털로32가길,2221,1322,899
2021,2,A,골목상권,1000642,디지털로27길,26,20,6
2021,2,A,골목상권,1000641,도림로6길,160,93,67
2021,2,A,골목상권,1000640,도림로12길,186,124,62
2021,2,A,골목상권,1000639,남부순환로97길,101,48,53
2021,2,A,골목상권,1000638,구로중앙로8길,107,41,66
2021,2,A,골목상권,1000637,구로중앙로7길,86,42,44
2021,2,A,골목상권,1000636,구로중앙로42길,403,284,119
2021,2,A,골목상권,1000635,구로중앙로34길,189,149,40
2021,2,A,골목상권,1000634,구로중앙로28길,470,226,244
2021,2,A,골목상권,1000633,구로중앙로19길,666,398,268
2021,2,A,골목상권,1000632,구로동로8길,298,153,145
2021,2,A,골목상권,1000631,구로동로7길,115,71,44
2021,2,A,골목상권,1000630,구로동로42길,131,75,56
2021,2,A,골목상권,1000629,구로동로41길,119,79,40
2021,2,A,골목상권,1000628,구로동로38길,625,240,385
2021,2,A,골목상권,1000627,구로동로28길,42,18,24
2021,2,A,골목상권,1000626,구로동로15길,88,50,38
2021,2,A,골목상권,1000625,공원로6가길,1158,755,403
2021,2,A,골목상권,1000624,고척로52길,40,27,13
2021,2,A,골목상권,1000623,고척로27다길,169,99,70
2021,2,A,골목상권,1000622,고척로27길,309,167,142
2021,2,A,골목상권,1000621,고척로21나길,369,197,172
2021,2,A,골목상권,1000620,경인로47길,657,264,393
2021,2,A,골목상권,1000619,경인로35길,364,232,132
2021,2,A,골목상권,1000618,경인로31길,130,61,69
2021,2,A,골목상권,1000617,경인로15길,259,93,166
2021,2,A,골목상권,1000616,개봉로3길,273,139,134
2021,2,A,골목상권,1000615,개봉로2길,186,99,87
2021,2,A,골목상권,1000614,개봉로23가길,826,590,236
2021,2,A,골목상권,1000613,개봉로20길,3082,1346,1736
2021,2,A,골목상권,1000612,개봉로1길,187,126,61
2021,2,A,골목상권,1000611,개봉로17다길,2362,1606,756
2021,2,A,골목상권,1000610,개봉로17길,1304,418,886
2021,2,A,골목상권,1000609,개봉로11길,181,97,84
2021,2,A,골목상권,1000608,화곡로64길,1128,686,442
2021,2,A,골목상권,1000607,화곡로59길,316,232,84
2021,2,A,골목상권,1000606,화곡로44나길,625,559,66
2021,2,A,골목상권,1000605,화곡로31길,618,375,243
2021,2,A,골목상권,1000604,화곡로20길,355,193,162
2021,2,A,골목상권,1000603,화곡로13길,368,249,119
2021,2,A,골목상권,1000602,초원로16길,523,369,154
2021,2,A,골목상권,1000601,초록마을로8길,116,68,48
2021,2,A,골목상권,1000600,초록마을로3길,439,355,84
2021,2,A,골목상권,1000599,월정로20길,135,31,104
2021,2,A,골목상권,1000598,우장산로6길,486,298,188
2021,2,A,골목상권,1000597,양천로73가길,468,360,108
2021,2,A,골목상권,1000596,양천로71길,1203,752,451
2021,2,A,골목상권,1000595,양천로49길,342,232,110
2021,2,A,골목상권,1000594,양천로26길,479,377,102
2021,2,A,골목상권,1000593,양천로24길,186,100,86
2021,2,A,골목상권,1000592,양천로24가길,207,113,94
2021,2,A,골목상권,1000591,양천로14길,257,143,114
2021,2,A,골목상권,1000590,방화대로6라길,653,413,240
2021,2,A,골목상권,1000589,방화대로21길,390,243,147
2021,2,A,골목상권,1000588,등촌로5길,1524,514,1010
2021,2,A,골목상권,1000587,등촌로55길,432,323,109
2021,2,A,골목상권,1000586,등촌로51길,239,137,102
2021,2,A,골목상권,1000585,등촌로39길,313,146,167
2021,2,A,골목상권,1000584,등촌로13길,183,128,55
2021,2,A,골목상권,1000583,남부순환로11길,307,201,106
2021,2,A,골목상권,1000582,까치산로4길,189,112,77
2021,2,A,골목상권,1000581,국회대로7길,215,101,114
2021,2,A,골목상권,1000580,공항대로8길,276,172,104
2021,2,A,골목상권,1000579,공항대로61길,547,415,132
2021,2,A,골목상권,1000578,공항대로59다길,1037,645,392
2021,2,A,골목상권,1000577,공항대로59길,654,454,200
2021,2,A,골목상권,1000576,공항대로55길,900,577,323
2021,2,A,골목상권,1000575,공항대로42길,514,323,191
2021,2,A,골목상권,1000574,공항대로38길,92,49,43
2021,2,A,골목상권,1000573,곰달래로60길,221,146,75
2021,2,A,골목상권,1000572,곰달래로53길,130,89,41
2021,2,A,골목상권,1000571,곰달래로47길,333,218,115
2021,2,A,골목상권,1000570,곰달래로31길,120,78,42
2021,2,A,골목상권,1000569,곰달래로25길,245,139,106
2021,2,A,골목상권,1000568,개화동로25길,351,201,150
2021,2,A,골목상권,1000567,개화동로23길,857,669,188
2021,2,A,골목상권,1000566,강서로8길,214,125,89
2021,2,A,골목상권,1000565,강서로5라길,245,176,69
2021,2,A,골목상권,1000564,강서로5나길,360,221,139
2021,2,A,골목상권,1000563,강서로5가길,182,98,84
2021,2,A,골목상권,1000562,강서로47라길,207,150,57
2021,2,A,골목상권,1000561,강서로47길,327,146,181
2021,2,A,골목상권,1000560,강서로45다길,243,178,65
2021,2,A,골목상권,1000559,강서로45길,101,43,58
2021,2,A,골목상권,1000558,강서로35길,280,120,160
2021,2,A,골목상권,1000557,강서로29길,384,230,154
2021,2,A,골목상권,1000556,강서로18길,676,545,131
2021,2,A,골목상권,1000555,강서로17가길,554,386,168
2021,2,A,골목상권,1000554,강서로15길,261,152,109
2021,2,A,골목상권,1000553,가로공원로80길,270,175,95
2021,2,A,골목상권,1000552,가로공원로76가길,168,91,77
2021,2,A,골목상권,1000551,화곡로4길,421,219,202
2021,2,A,골목상권,1000550,화곡로3길,351,177,174
2021,2,A,골목상권,1000549,지양로7길,245,105,140
2021,2,A,골목상권,1000548,중앙로55길,592,261,331
2021,2,A,골목상권,1000547,중앙로51길,283,178,105
2021,2,A,골목상권,1000546,중앙로47길,94,40,54
2021,2,A,골목상권,1000545,중앙로45길,1386,1342,44
2021,2,A,골목상권,1000544,중앙로36길,133,49,84
2021,2,A,골목상권,1000543,중앙로32길,145,87,58
2021,2,A,골목상권,1000542,중앙로25길,97,61,36
2021,2,A,골목상권,1000541,은행정로7길,472,183,289
2021,2,A,골목상권,1000540,은행정로5길,109,57,52
2021,2,A,골목상권,1000539,오목로5길,120,85,35
2021,2,A,골목상권,1000538,오목로3길,375,296,79
2021,2,A,골목상권,1000537,오목로30길,220,125,95
2021,2,A,골목상권,1000536,오목로23길,401,155,246
2021,2,A,골목상권,1000535,신월로20길,47,30,17
2021,2,A,골목상권,1000534,신월로15길,357,184,173
2021,2,A,골목상권,1000533,신목로6길,582,383,199
2021,2,A,골목상권,1000532,신목로5길,645,416,229
2021,2,A,골목상권,1000531,신목로2길,386,255,131
2021,2,A,골목상권,1000530,목동중앙서로8가길,317,200,117
2021,2,A,골목상권,1000529,목동중앙서로7길,75,52,23
2021,2,A,골목상권,1000528,목동중앙북로8길,171,102,69
2021,2,A,골목상권,1000527,목동중앙북로16길,488,190,298
2021,2,A,골목상권,1000526,목동중앙본로7길,131,70,61
2021,2,A,골목상권,1000525,목동중앙로3길,157,95,62
2021,2,A,골목상권,1000524,목동중앙로13나길,346,248,98
2021,2,A,골목상권,1000523,목동중앙남로3가길,190,108,82
2021,2,A,골목상권,1000522,목동로9길,768,479,289
2021,2,A,골목상권,1000521,목동로19길,351,190,161
2021,2,A,골목상권,1000520,목동동로8길,184,106,78
2021,2,A,골목상권,1000519,목동동로12길,335,228,107
2021,2,A,골목상권,1000518,목동남로4길,797,494,303
2021,2,A,골목상권,1000517,남부순환로88길,328,124,204
2021,2,A,골목상권,1000516,남부순환로79길,142,74,68
2021,2,A,골목상권,1000515,남부순환로70길,165,101,64
2021,2,A,골목상권,1000514,남부순환로58길,282,179,103
2021,2,A,골목상권,1000513,남부순환로40길,122,46,76
2021,2,A,골목상권,1000512,남부순환로33길,179,116,63
2021,2,A,골목상권,1000511,곰달래로5길,211,125,86
2021,2,A,골목상권,1000510,곰달래로3길,313,213,100
2021,2,A,골목상권,1000509,곰달래로2길,610,344,266
2021,2,A,골목상권,1000508,곰달래로10길,543,449,94
2021,2,A,골목상권,1000507,가로공원로58길,91,54,37
2021,2,A,골목상권,1000506,효창원로93길,243,99,144
2021,2,A,골목상권,1000505,토정로37길,431,166,265
2021,2,A,골목상권,1000504,월드컵로8길,939,462,477
2021,2,A,골목상권,1000503,월드컵로7길,759,308,451
2021,2,A,골목상권,1000502,월드컵로36길,461,286,175
2021,2,A,골목상권,1000501,월드컵로25길,309,125,184
2021,2,A,골목상권,1000500,월드컵로19길,284,181,103
2021,2,A,골목상권,1000499,월드컵로16길,1538,929,609
2021,2,A,골목상권,1000498,월드컵로11길,421,153,268
2021,2,A,골목상권,1000497,월드컵로10길,1102,654,448
2021,2,A,골목상권,1000496,와우산로3길,257,176,81
2021,2,A,골목상권,1000495,와우산로29길,78,30,48
2021,2,A,골목상권,1000494,와우산로29가길,989,653,336
2021,2,A,골목상권,1000493,양화진길,676,412,264
2021,2,A,골목상권,1000492,양화로1길,544,248,296
2021,2,A,골목상권,1000491,양화로11길,2761,1012,1749
2021,2,A,골목상권,1000490,신촌로30길,109,64,45
2021,2,A,골목상권,1000489,신촌로28가길,59,19,40
2021,2,A,골목상권,1000488,신촌로12길,197,95,102
2021,2,A,골목상권,1000487,숭문길,1467,1016,451
2021,2,A,골목상권,1000486,숭문8길,109,65,44
2021,2,A,골목상권,1000485,성지3길,338,228,110
2021,2,A,골목상권,1000484,성산로4길,855,546,309
2021,2,A,골목상권,1000483,성미산로32길,243,172,71
2021,2,A,골목상권,1000482,성미산로1길,554,299,255
2021,2,A,골목상권,1000481,성미산로11길,1114,807,307
2021,2,A,골목상권,1000480,백범로16길,1908,1298,610
2021,2,A,골목상권,1000479,방울내로9안길,619,351,268
2021,2,A,골목상권,1000478,모래내로7길,91,63,28
2021,2,A,골목상권,1000477,매봉산로2길,806,601,205
2021,2,A,골목상권,1000476,망원로2길,282,190,92
2021,2,A,골목상권,1000475,망원로11길,144,73,71
2021,2,A,골목상권,1000474,만리재옛길,1190,687,503
2021,2,A,골목상권,1000473,마포대로4길,674,365,309
2021,2,A,골목상권,1000472,마포대로20길,483,258,225
2021,2,A,골목상권,1000471,마포대로12길,78,39,39
2021,2,A,골목상권,1000470,동교로38길,464,247,217
2021,2,A,골목상권,1000469,동교로27길,1172,795,377
2021,2,A,골목상권,1000468,동교로25길,1378,581,797
2021,2,A,골목상권,1000467,동교로19길,1207,739,468
2021,2,A,골목상권,1000466,동교로17길,405,240,165
2021,2,A,골목상권,1000465,독막로8길,441,274,167
2021,2,A,골목상권,1000464,독막로32길,487,240,247
2021,2,A,골목상권,1000463,독막로22길,91,61,30
2021,2,A,골목상권,1000462,도화길,56,32,24
2021,2,A,골목상권,1000461,도화4길,825,292,533
2021,2,A,골목상권,1000460,대흥로28길,50,17,33
2021,2,A,골목상권,1000459,대흥로21길,372,188,184
2021,2,A,골목상권,1000458,광성로6길,295,169,126
2021,2,A,골목상권,1000457,홍제내길,565,201,364
2021,2,A,골목상권,1000456,홍연길,79,47,32
2021,2,A,골목상권,1000455,통일로39길,67,32,35
2021,2,A,골목상권,1000454,통일로37길,611,407,204
2021,2,A,골목상권,1000453,통일로11길,97,46,51
2021,2,A,골목상권,1000452,충정로6길,3185,1879,1306
2021,2,A,골목상권,1000451,충정로4길,2044,1298,746
2021,2,A,골목상권,1000450,증가로6길,326,277,49
2021,2,A,골목상권,1000449,증가로23나길,902,441,461
2021,2,A,골목상권,1000448,증가로20가길,336,99,237
2021,2,A,골목상권,1000447,증가로10길,1463,1123,340
2021,2,A,골목상권,1000446,응암로1길,621,380,241
2021,2,A,골목상권,1000445,연희로10길,3448,3135,313
2021,2,A,골목상권,1000444,신촌로37길,52,25,27
2021,2,A,골목상권,1000443,수색로8길,1090,905,185
2021,2,A,골목상권,1000442,세무서길,164,78,86
2021,2,A,골목상권,1000441,세무서2길,186,77,109
2021,2,A,골목상권,1000440,세검정로1길,109,37,72
2021,2,A,골목상권,1000439,북아현로4길,350,225,125
2021,2,A,골목상권,1000438,모래내로15길,74,54,20
2021,2,A,골목상권,1000437,명지대길,107,58,49
2021,2,A,골목상권,1000436,독립문로8길,679,422,257
2021,2,A,골목상권,1000435,가재울로6길,168,108,60
2021,2,A,골목상권,1000434,통일로92길,186,72,114
2021,2,A,골목상권,1000433,통일로87길,255,130,125
2021,2,A,골목상권,1000432,통일로78길,172,60,112
2021,2,A,골목상권,1000431,통일로69길,107,55,52
2021,2,A,골목상권,1000430,진흥로1길,310,165,145
2021,2,A,골목상권,1000429,진흥로12길,392,144,248
2021,2,A,골목상권,1000428,증산서길,334,189,145
2021,2,A,골목상권,1000427,증산로9길,606,525,81
2021,2,A,골목상권,1000426,증산로5길,508,308,200
2021,2,A,골목상권,1000425,증산로21길,237,122,115
2021,2,A,골목상권,1000424,증산로17길,161,110,51
2021,2,A,골목상권,1000423,증산로15길,398,297,101
2021,2,A,골목상권,1000422,증산로13길,79,42,37
2021,2,A,골목상권,1000421,응암로34길,231,118,113
2021,2,A,골목상권,1000420,응암로22길,130,53,77
2021,2,A,골목상권,1000419,응암로14길,99,50,49
2021,2,A,골목상권,1000418,응암로13길,156,44,112
2021,2,A,골목상권,1000417,응암로12길,67,32,35
2021,2,A,골목상권,1000416,은평로8길,275,194,81
2021,2,A,골목상권,1000415,은평로3길,242,110,132
2021,2,A,골목상권,1000414,은평로20길,9,2,7
2021,2,A,골목상권,1000413,은평로13길,655,283,372
2021,2,A,골목상권,1000412,은평로10길,246,148,98
2021,2,A,골목상권,1000411,연서로5길,647,303,344
2021,2,A,골목상권,1000410,연서로41길,64,33,31
2021,2,A,골목상권,1000409,연서로3길,119,51,68
2021,2,A,골목상권,1000408,연서로34길,1310,709,601
2021,2,A,골목상권,1000407,연서로33길,109,49,60
2021,2,A,골목상권,1000406,연서로29길,100,60,40
2021,2,A,골목상권,1000405,연서로28길,226,118,108
2021,2,A,골목상권,1000404,연서로27길,339,148,191
2021,2,A,골목상권,1000403,연서로21길,684,486,198
2021,2,A,골목상권,1000402,연서로17길,540,162,378
2021,2,A,골목상권,1000401,연서로16길,121,66,55
2021,2,A,골목상권,1000400,연서로13길,218,135,83
2021,2,A,골목상권,1000399,연서로11길,640,263,377
2021,2,A,골목상권,1000398,역말로9길,159,82,77
2021,2,A,골목상권,1000397,수색로18길,128,93,35
2021,2,A,골목상권,1000396,서오릉로8길,160,104,56
2021,2,A,골목상권,1000395,서오릉로21길,153,56,97
2021,2,A,골목상권,1000394,불광천길,192,95,97
2021,2,A,골목상권,1000393,갈현로7길,398,205,193
2021,2,A,골목상권,1000392,갈현로41길,171,78,93
2021,2,A,골목상권,1000391,갈현로33길,255,149,106
2021,2,A,골목상권,1000390,갈현로1길,66,36,30
2021,2,A,골목상권,1000389,가좌로7길,329,203,126
2021,2,A,골목상권,1000388,한글비석로44길,232,95,137
2021,2,A,골목상권,1000387,한글비석로24길,180,62,118
2021,2,A,골목상권,1000386,한글비석로22길,172,92,80
2021,2,A,골목상권,1000385,석계로1길,605,255,350
2021,2,A,골목상권,1000384,상계로9가길,151,82,69
2021,2,A,골목상권,1000383,상계로1길,334,244,90
2021,2,A,골목상권,1000382,상계로12길,144,90,54
2021,2,A,골목상권,1000381,동일로242길,302,142,160
2021,2,A,골목상권,1000380,동일로192길,429,326,103
2021,2,A,골목상권,1000379,동일로173가길,1230,946,284
2021,2,A,골목상권,1000378,공릉로58길,129,61,68
2021,2,A,골목상권,1000377,해등로16길,285,134,151
2021,2,A,골목상권,1000376,우이천로4다길,125,83,42
2021,2,A,골목상권,1000375,우이천로32길,206,83,123
2021,2,A,골목상권,1000374,시루봉로23길,267,128,139
2021,2,A,골목상권,1000373,삼양로144길,50,24,26
2021,2,A,골목상권,1000372,방학로6가길,167,67,100
2021,2,A,골목상권,1000371,방학로5길,124,87,37
2021,2,A,골목상권,1000370,방학로15길,687,454,233
2021,2,A,골목상권,1000369,방학로10길,67,51,16
2021,2,A,골목상권,1000368,도봉산길,135,64,71
2021,2,A,골목상권,1000367,도봉산4길,27,24,3
2021,2,A,골목상권,1000366,도봉로181길,93,30,63
2021,2,A,골목상권,1000365,도봉로169나길,244,184,60
2021,2,A,골목상권,1000364,도봉로156길,93,62,31
2021,2,A,골목상권,1000363,도봉로152가길,342,311,31
2021,2,A,골목상권,1000362,도봉로147길,161,81,80
2021,2,A,골목상권,1000361,도봉로143길,73,48,25
2021,2,A,골목상권,1000360,도봉로114길,380,143,237
2021,2,A,골목상권,1000359,도봉로109길,276,223,53
2021,2,A,골목상권,1000358,도당로29길,518,292,226
2021,2,A,골목상권,1000357,도당로19길,597,66,531
2021,2,A,골목상권,1000356,도당로13바길,74,35,39
2021,2,A,골목상권,1000355,도당로13가길,36,21,15
2021,2,A,골목상권,1000354,덕릉로60길,177,126,51
2021,2,A,골목상권,1000353,노해로63다길,43,19,24
2021,2,A,골목상권,1000352,노해로60길,136,85,51
2021,2,A,골목상권,1000351,한천로140길,36,25,11
2021,2,A,골목상권,1000350,한천로139가길,108,47,61
2021,2,A,골목상권,1000349,한천로132길,56,31,25
2021,2,A,골목상권,1000348,한천로130길,91,69,22
2021,2,A,골목상권,1000347,한천로124나길,54,23,31
2021,2,A,골목상권,1000346,한천로109길,439,280,159
2021,2,A,골목상권,1000345,인수봉로79길,242,153,89
2021,2,A,골목상권,1000344,인수봉로72길,54,18,36
2021,2,A,골목상권,1000343,인수봉로56길,44,25,19
2021,2,A,골목상권,1000342,오패산로67길,238,89,149
2021,2,A,골목상권,1000341,오패산로52길,105,47,58
2021,2,A,골목상권,1000340,오패산로30길,13,5,8
2021,2,A,골목상권,1000339,수유로12길,281,199,82
2021,2,A,골목상권,1000338,솔샘로65길,284,66,218
2021,2,A,골목상권,1000337,솔매로50길,442,162,280
2021,2,A,골목상권,1000336,솔매로45길,65,32,33
2021,2,A,골목상권,1000335,솔매로41길,67,38,29
2021,2,A,골목상권,1000334,삼양로93길,209,94,115
2021,2,A,골목상권,1000333,삼양로77길,131,58,73
2021,2,A,골목상권,1000332,삼양로54길,295,66,229
2021,2,A,골목상권,1000331,삼양로41길,338,275,63
2021,2,A,골목상권,1000330,삼양로27길,7,4,3
2021,2,A,골목상권,1000329,삼양로24길,26,16,10
2021,2,A,골목상권,1000328,삼양로20길,179,168,11
2021,2,A,골목상권,1000327,삼각산로28길,70,33,37
2021,2,A,골목상권,1000326,도봉로99길,250,155,95
2021,2,A,골목상권,1000325,도봉로8길,6,4,2
2021,2,A,골목상권,1000324,도봉로76길,311,138,173
2021,2,A,골목상권,1000323,도봉로67길,116,57,59
2021,2,A,골목상권,1000322,도봉로45길,112,54,58
2021,2,A,골목상권,1000321,도봉로18길,225,182,43
2021,2,A,골목상권,1000320,도봉로13길,13,8,5
2021,2,A,골목상권,1000319,덕릉로41길,185,105,80
2021,2,A,골목상권,1000318,덕릉로40길,187,95,92
2021,2,A,골목상권,1000317,노해로33길,84,30,54
2021,2,A,골목상권,1000316,노해로23길,70,47,23
2021,2,A,골목상권,1000315,노해로17길,103,56,47
2021,2,A,골목상권,1000314,화랑로40길,71,46,25
2021,2,A,골목상권,1000313,화랑로32길,395,292,103
2021,2,A,골목상권,1000312,화랑로1길,1112,811,301
2021,2,A,골목상권,1000311,화랑로19길,43,19,24
2021,2,A,골목상권,1000310,화랑로14길,99,73,26
2021,2,A,골목상권,1000309,화랑로13길,267,95,172
2021,2,A,골목상권,1000308,한천로76길,132,100,32
2021,2,A,골목상권,1000307,한천로101가길,15,9,6
2021,2,A,골목상권,1000306,창경궁로43길,917,434,483
2021,2,A,골목상권,1000305,지봉로20길,3780,3162,618
2021,2,A,골목상권,1000304,종암로5길,404,201,203
2021,2,A,골목상권,1000303,종암로24가길,81,18,63
2021,2,A,골목상권,1000302,종암로21길,550,344,206
2021,2,A,골목상권,1000301,종암로19길,18269,9427,8842
2021,2,A,골목상권,1000300,종암로16길,140,61,79
2021,2,A,골목상권,1000299,정릉로8길,1407,1165,242
2021,2,A,골목상권,1000298,정릉로27길,75,30,45
2021,2,A,골목상권,1000297,정릉로26길,214,103,111
2021,2,A,골목상권,1000296,장위로50길,343,160,183
2021,2,A,골목상권,1000295,장월로1길,74,19,55
2021,2,A,골목상권,1000294,인촌로6길,195,131,64
2021,2,A,골목상권,1000293,인촌로5길,63,31,32
2021,2,A,골목상권,1000292,인촌로24길,1580,1010,570
2021,2,A,골목상권,1000291,개운사길,150,83,67
2021,2,A,골목상권,1000290,인촌로1길,127,78,49
2021,2,A,골목상권,1000289,인촌로17가길,90,48,42
2021,2,A,골목상권,1000288,오패산로4길,841,540,301
2021,2,A,골목상권,1000287,오패산로3길,310,187,123
2021,2,A,골목상권,1000286,오패산로19길,101,36,65
2021,2,A,골목상권,1000285,안암로5길,960,743,217
2021,2,A,골목상권,1000284,아리랑로4길,595,281,314
2021,2,A,골목상권,1000283,솔샘로6길,74,48,26
2021,2,A,골목상권,1000282,성북로8길,143,88,55
2021,2,A,골목상권,1000281,삼양로8길,147,70,77
2021,2,A,골목상권,1000280,삼선교로16가길,99,42,57
2021,2,A,골목상권,1000279,삼선교로10다길,38,17,21
2021,2,A,골목상권,1000278,삼선교로10길,186,110,76
2021,2,A,골목상권,1000277,보문로32길,267,128,139
2021,2,A,골목상권,1000276,보문로31길,253,128,125
2021,2,A,골목상권,1000275,보문로26길,134,62,72
2021,2,A,골목상권,1000274,보문로13길,1048,741,307
2021,2,A,골목상권,1000273,보국문로16길,181,97,84
2021,2,A,골목상권,1000272,동소문로6길,62,28,34
2021,2,A,골목상권,1000271,동소문로2길,53,21,32
2021,2,A,골목상권,1000270,동소문로26가길,219,122,97
2021,2,A,골목상권,1000269,동소문로15길,209,152,57
2021,2,A,골목상권,1000268,동소문로13길,572,285,287
2021,2,A,골목상권,1000267,돌곶이로8길,117,75,42
2021,2,A,골목상권,1000266,돌곶이로41길,40,13,27
2021,2,A,골목상권,1000265,돌곶이로28길,222,96,126
2021,2,A,골목상권,1000264,돌곶이로27길,103,59,44
2021,2,A,골목상권,1000263,돌곶이로22길,61,34,27
2021,2,A,골목상권,1000262,돌곶이로14길,77,58,19
2021,2,A,골목상권,1000261,길음로7길,14,5,9
2021,2,A,골목상권,1000260,중랑천로10길,207,109,98
2021,2,A,골목상권,1000259,용마산로94길,304,259,45
2021,2,A,골목상권,1000258,용마산로118길,108,63,45
2021,2,A,골목상권,1000257,용마산로112길,114,69,45
2021,2,A,골목상권,1000256,용마산로100길,122,52,70
2021,2,A,골목상권,1000255,신내로7가길,276,115,161
2021,2,A,골목상권,1000254,사가정로54길,122,47,75
2021,2,A,골목상권,1000253,사가정로42길,183,89,94
2021,2,A,골목상권,1000252,봉화산로56길,649,289,360
2021,2,A,골목상권,1000251,봉화산로4길,58,30,28
2021,2,A,골목상권,1000250,봉화산로30길,139,38,101
2021,2,A,골목상권,1000249,봉우재로33길,150,59,91
2021,2,A,골목상권,1000248,면목로78길,93,44,49
2021,2,A,골목상권,1000247,면목로56길,91,53,38
2021,2,A,골목상권,1000246,면목로55길,473,306,167
2021,2,A,골목상권,1000245,면목로49길,109,67,42
2021,2,A,골목상권,1000244,면목로48길,873,544,329
2021,2,A,골목상권,1000243,면목로45길,454,364,90
2021,2,A,골목상권,1000242,면목로33길,86,28,58
2021,2,A,골목상권,1000241,면목로21길,54,37,17
2021,2,A,골목상권,1000240,망우로73길,51,34,17
2021,2,A,골목상권,1000239,망우로68길,107,44,63
2021,2,A,골목상권,1000238,동일로163길,112,67,45
2021,2,A,골목상권,1000237,동일로157길,443,270,173
2021,2,A,골목상권,1000236,동일로149길,870,749,121
2021,2,A,골목상권,1000235,동일로140길,432,314,118
2021,2,A,골목상권,1000234,동일로139길,77,53,24
2021,2,A,골목상권,1000233,동일로139가길,187,81,106
2021,2,A,골목상권,1000232,동일로130길,130,99,31
2021,2,A,골목상권,1000231,동일로123길,145,74,71
2021,2,A,골목상권,1000230,동일로112길,193,120,73
2021,2,A,골목상권,1000229,동일로101길,202,58,144
2021,2,A,골목상권,1000228,동일로100길,328,240,88
2021,2,A,골목상권,1000227,답십리로75길,57,33,24
2021,2,A,골목상권,1000226,공릉로2길,148,69,79
2021,2,A,골목상권,1000225,공릉로12가길,75,50,25
2021,2,A,골목상권,1000224,겸재로54길,131,79,52
2021,2,A,골목상권,1000223,겸재로36길,134,60,74
2021,2,A,골목상권,1000222,겸재로29길,126,74,52
2021,2,A,골목상권,1000221,휘경로3길,127,69,58
2021,2,A,골목상권,1000220,휘경로2길,138,88,50
2021,2,A,골목상권,1000219,휘경로23길,89,56,33
2021,2,A,골목상권,1000218,휘경로14길,113,41,72
2021,2,A,골목상권,1000217,한천로46길,257,101,156
2021,2,A,골목상권,1000216,한천로40길,90,57,33
2021,2,A,골목상권,1000215,한천로33길,203,76,127
2021,2,A,골목상권,1000214,한천로14길,696,440,256
2021,2,A,골목상권,1000213,천호대로97길,878,590,288
2021,2,A,골목상권,1000212,천호대로77길,169,111,58
2021,2,A,골목상권,1000211,천호대로45길,47,38,9
2021,2,A,골목상권,1000210,천호대로17길,2512,1893,619
2021,2,A,골목상권,1000209,천호대로12길,55,35,20
2021,2,A,골목상권,1000208,천장산로7길,74,32,42
2021,2,A,골목상권,1000207,제기로5길,45,39,6
2021,2,A,골목상권,1000206,제기로21길,101,62,39
2021,2,A,골목상권,1000205,전농로4길,274,210,64
2021,2,A,골목상권,1000204,전농로3길,170,120,50
2021,2,A,골목상권,1000203,전농로29길,461,336,125
2021,2,A,골목상권,1000202,장한로8길,438,295,143
2021,2,A,골목상권,1000201,장한로5길,314,189,125
2021,2,A,골목상권,1000200,장한로27길,167,119,48
2021,2,A,골목상권,1000199,장한로27가길,148,81,67
2021,2,A,골목상권,1000198,장한로26길,2436,1696,740
2021,2,A,골목상권,1000197,장한로26가길,122,87,35
2021,2,A,골목상권,1000196,장한로25길,408,210,198
2021,2,A,골목상권,1000195,장한로14길,179,98,81
2021,2,A,골목상권,1000194,이문로42길,48,29,19
2021,2,A,골목상권,1000193,왕산로43길,560,199,361
2021,2,A,골목상권,1000192,왕산로33길,72,30,42
2021,2,A,골목상권,1000191,왕산로32길,129,64,65
2021,2,A,골목상권,1000190,약령시로17길,109,77,32
2021,2,A,골목상권,1000189,서울시립대로4길,404,264,140
2021,2,A,골목상권,1000188,서울시립대로29길,368,263,105
2021,2,A,골목상권,1000187,서울시립대로16길,42,14,28
2021,2,A,골목상권,1000186,사가정로2길,268,177,91
2021,2,A,골목상권,1000185,사가정로23가길,84,46,38
2021,2,A,골목상권,1000184,사가정로13길,180,65,115
2021,2,A,골목상권,1000183,무학로45길,227,141,86
2021,2,A,골목상권,1000182,무학로16길,574,441,133
2021,2,A,골목상권,1000181,망우로21길,96,67,29
2021,2,A,골목상권,1000180,망우로18길,52,17,35
2021,2,A,골목상권,1000179,망우로18가길,114,75,39
2021,2,A,골목상권,1000178,답십리로72길,54,20,34
2021,2,A,골목상권,1000177,답십리로69길,533,270,263
2021,2,A,골목상권,1000176,답십리로68길,287,158,129
2021,2,A,골목상권,1000175,답십리로64길,103,73,30
2021,2,A,골목상권,1000174,답십리로63길,1747,1051,696
2021,2,A,골목상권,1000173,답십리로60길,341,213,128
2021,2,A,골목상권,1000172,답십리로56길,78,39,39
2021,2,A,골목상권,1000171,답십리로23길,47,22,25
2021,2,A,골목상권,1000170,난계로30길,4980,2233,2747
2021,2,A,골목상권,1000169,경희대로4길,41,18,23
2021,2,A,골목상권,1000168,경희대로3길,28,16,12
2021,2,A,골목상권,1000167,천호대로129길,344,207,137
2021,2,A,골목상권,1000166,천호대로123길,625,282,343
2021,2,A,골목상권,1000165,천호대로109길,915,504,411
2021,2,A,골목상권,1000164,자양번영로3길,587,462,125
2021,2,A,골목상권,1000163,자양로53길,170,120,50
2021,2,A,골목상권,1000162,자양로50길,218,121,97
2021,2,A,골목상권,1000161,자양로45길,448,184,264
2021,2,A,골목상권,1000160,자양로26길,141,91,50
2021,2,A,골목상권,1000159,자양로15길,106,45,61
2021,2,A,골목상권,1000158,자양로11길,646,250,396
2021,2,A,골목상권,1000157,용마산로3길,541,431,110
2021,2,A,골목상권,1000156,용마산로21길,396,253,143
2021,2,A,골목상권,1000155,아차산로78길,575,421,154
2021,2,A,골목상권,1000154,아차산로65길,357,214,143
2021,2,A,골목상권,1000153,아차산로55길,243,150,93
2021,2,A,골목상권,1000152,아차산로51길,432,110,322
2021,2,A,골목상권,1000151,아차산로40길,357,207,150
2021,2,A,골목상권,1000150,면목로17길,230,138,92
2021,2,A,골목상권,1000149,뚝섬로64길,239,127,112
2021,2,A,골목상권,1000148,뚝섬로58길,278,141,137
2021,2,A,골목상권,1000147,뚝섬로54길,948,798,150
2021,2,A,골목상권,1000146,뚝섬로48길,228,134,94
2021,2,A,골목상권,1000145,뚝섬로24길,111,66,45
2021,2,A,골목상권,1000144,뚝섬로23길,209,148,61
2021,2,A,골목상권,1000143,동일로24길,42,32,10
2021,2,A,골목상권,1000142,동일로18길,79,54,25
2021,2,A,골목상권,1000141,능동로4길,947,834,113
2021,2,A,골목상권,1000140,능동로3길,71,45,26
2021,2,A,골목상권,1000139,능동로34길,1018,676,342
2021,2,A,골목상권,1000138,능동로19길,133,77,56
2021,2,A,골목상권,1000137,능동로13길,221,109,112
2021,2,A,골목상권,1000136,긴고랑로9길,138,51,87
2021,2,A,골목상권,1000135,긴고랑로8길,947,573,374
2021,2,A,골목상권,1000134,긴고랑로7길,460,353,107
2021,2,A,골목상권,1000133,긴고랑로20길,174,98,76
2021,2,A,골목상권,1000132,광나루로52길,649,395,254
2021,2,A,골목상권,1000131,광나루로40길,242,128,114
2021,2,A,골목상권,1000130,광나루로37길,60,29,31
2021,2,A,골목상권,1000129,광나루로36길,412,169,243
2021,2,A,골목상권,1000128,광나루로24길,25,12,13
2021,2,A,골목상권,1000127,광나루로12길,60,19,41
2021,2,A,골목상권,1000126,한림말길,355,174,181
2021,2,A,골목상권,1000125,한림말3길,3329,1128,2201
2021,2,A,골목상권,1000124,청계천로10나길,4951,3728,1223
2021,2,A,골목상권,1000123,장터길,90,46,44
2021,2,A,골목상권,1000122,용답중앙길,93,66,27
2021,2,A,골목상권,1000121,용답29길,537,360,177
2021,2,A,골목상권,1000120,왕십리로6길,538,350,188
2021,2,A,골목상권,1000119,왕십리로31길,208,95,113
2021,2,A,골목상권,1000118,왕십리로26길,2076,1357,719
2021,2,A,골목상권,1000117,왕십리로21길,164,77,87
2021,2,A,골목상권,1000116,왕십리로14길,997,776,221
2021,2,A,골목상권,1000115,아차산로5길,1871,1041,830
2021,2,A,골목상권,1000114,아차산로15길,3361,2374,987
2021,2,A,골목상권,1000113,아차산로11길,3213,2213,1000
2021,2,A,골목상권,1000112,송정4가길,291,123,168
2021,2,A,골목상권,1000111,송정12라길,94,48,46
2021,2,A,골목상권,1000110,성수일로6길,1342,928,414
2021,2,A,골목상권,1000109,성수이로7길,1442,895,547
2021,2,A,골목상권,1000108,성수이로18길,2988,1968,1020
2021,2,A,골목상권,1000107,성덕정길,227,152,75
2021,2,A,골목상권,1000106,성덕정17길,393,244,149
2021,2,A,골목상권,1000105,서울숲2길,335,196,139
2021,2,A,골목상권,1000104,상원길,1919,1334,585
2021,2,A,골목상권,1000103,상원12길,398,238,160
2021,2,A,골목상권,1000102,사근동길,78,48,30
2021,2,A,골목상권,1000101,무학봉길,22,11,11
2021,2,A,골목상권,1000100,무학봉28길,143,69,74
2021,2,A,골목상권,1000099,무학로6길,1897,382,1515
2021,2,A,골목상권,1000098,무수막길,164,122,42
2021,2,A,골목상권,1000097,매봉길,60,30,30
2021,2,A,골목상권,1000096,마조로1길,30,14,16
2021,2,A,골목상권,1000095,마조로16길,155,93,62
2021,2,A,골목상권,1000094,마장로39길,443,258,185
2021,2,A,골목상권,1000093,마장로27길,197,92,105
2021,2,A,골목상권,1000092,뚝섬로5길,2136,1426,710
2021,2,A,골목상권,1000091,둘레9길,419,255,164
2021,2,A,골목상권,1000090,금호산길,159,83,76
2021,2,A,골목상권,1000089,금호산2길,22,12,10
2021,2,A,골목상권,1000088,고산자로6길,704,495,209
2021,2,A,골목상권,1000087,후암로28길,582,313,269
2021,2,A,골목상권,1000086,효창원로39길,163,87,76
2021,2,A,골목상권,1000085,회나무로13길,90,45,45
2021,2,A,골목상권,1000084,한남대로20길,231,131,100
2021,2,A,골목상권,1000083,한강대로88길,224,138,86
2021,2,A,골목상권,1000082,한강대로7길,722,462,260
2021,2,A,골목상권,1000081,한강대로62길,1047,535,512
2021,2,A,골목상권,1000080,한강대로52길,8713,2847,5866
2021,2,A,골목상권,1000079,한강대로43길,1841,1074,767
2021,2,A,골목상권,1000078,한강대로15길,774,417,357
2021,2,A,골목상권,1000077,한강대로104길,8152,1754,6398
2021,2,A,골목상권,1000076,청파로73길,248,128,120
2021,2,A,골목상권,1000075,청파로71길,1317,727,590
2021,2,A,골목상권,1000074,청파로47나길,259,176,83
2021,2,A,골목상권,1000073,청파로47길,192,87,105
2021,2,A,골목상권,1000072,장문로45길,242,106,136
2021,2,A,골목상권,1000071,이태원로54길,812,552,260
2021,2,A,골목상권,1000070,이태원로27길,567,430,137
2021,2,A,골목상권,1000069,이촌로22길,385,307,78
2021,2,A,골목상권,1000068,원효로89길,1387,969,418
2021,2,A,골목상권,1000067,원효로53길,341,222,119
2021,2,A,골목상권,1000066,원효로41길,243,153,90
2021,2,A,골목상권,1000065,원효로19길,609,435,174
2021,2,A,골목상권,1000064,우사단로4길,308,143,165
2021,2,A,골목상권,1000063,우사단로14길,1987,984,1003
2021,2,A,골목상권,1000062,우사단로10길,570,508,62
2021,2,A,골목상권,1000061,신흥로20길,178,118,60
2021,2,A,골목상권,1000060,소월로20길,151,76,75
2021,2,A,골목상권,1000059,서빙고로71길,432,265,167
2021,2,A,골목상권,1000058,백범로90길,535,288,247
2021,2,A,골목상권,1000057,백범로79길,899,560,339
2021,2,A,골목상권,1000056,두텁바위로1길,1111,483,628
2021,2,A,골목상권,1000055,대사관로34길,606,393,213
2021,2,A,골목상권,1000054,녹사평대로46길,43,19,24
2021,2,A,골목상권,1000053,녹사평대로40나길,46,21,25
2021,2,A,골목상권,1000052,녹사평대로32길,56,31,25
2021,2,A,골목상권,1000051,녹사평대로26길,494,230,264
2021,2,A,골목상권,1000050,녹사평대로11길,107,78,29
2021,2,A,골목상권,1000049,퇴계로90길,463,225,238
2021,2,A,골목상권,1000048,퇴계로8길,438,246,192
2021,2,A,골목상권,1000047,퇴계로56길,569,424,145
2021,2,A,골목상권,1000046,퇴계로46길,1098,613,485
2021,2,A,골목상권,1000045,퇴계로18길,967,435,532
2021,2,A,골목상권,1000044,퇴계로12길,180,103,77
2021,2,A,골목상권,1000043,청구로1길,108,72,36
2021,2,A,골목상권,1000042,청구로17길,485,306,179
2021,2,A,골목상권,1000041,장충단로8길,3778,1997,1781
2021,2,A,골목상권,1000040,삼일대로4길,1571,1113,458
2021,2,A,골목상권,1000039,명동길,7830,4550,3280
2021,2,A,골목상권,1000038,동호로8길,386,160,226
2021,2,A,골목상권,1000037,동호로20길,2429,1304,1125
2021,2,A,골목상권,1000036,동호로15길,1161,835,326
2021,2,A,골목상권,1000035,동호로11길,337,208,129
2021,2,A,골목상권,1000034,동호로10길,1553,857,696
2021,2,A,골목상권,1000033,다산로39길,39,19,20
2021,2,A,골목상권,1000032,다산로38길,674,311,363
2021,2,A,골목상권,1000031,다산로36길,91,55,36
2021,2,A,골목상권,1000030,다산로33길,320,201,119
2021,2,A,골목상권,1000029,난계로21길,128,93,35
2021,2,A,골목상권,1000028,난계로11길,255,170,85
2021,2,A,골목상권,1000027,필운대로1길,202,62,140
2021,2,A,골목상권,1000026,평창길,6654,2605,4049
2021,2,A,골목상권,1000025,통일로12길,13,6,7
2021,2,A,골목상권,1000024,창신길,146,29,117
2021,2,A,골목상권,1000023,창신5길,15,7,8
2021,2,A,골목상권,1000022,창신2길,56,26,30
2021,2,A,골목상권,1000021,창경궁로35길,787,171,616
2021,2,A,골목상권,1000020,지봉로8길,183,90,93
2021,2,A,골목상권,1000019,종로65길,275,157,118
2021,2,A,골목상권,1000018,종로58가길,137,71,66
2021,2,A,골목상권,1000017,종로24길,1011,716,295
2021,2,A,골목상권,1000016,자하문로7길,214,83,131
2021,2,A,골목상권,1000015,이화장길,497,221,276
2021,2,A,골목상권,1000014,율곡로16길,235,143,92
2021,2,A,골목상권,1000013,율곡로10길,313,206,107
2021,2,A,골목상권,1000012,옥인길,58,32,26
2021,2,A,골목상권,1000011,숭인동길,329,133,196
2021,2,A,골목상권,1000010,성균관로5길,148,84,64
2021,2,A,골목상권,1000009,삼청로5길,2703,2626,77
2021,2,A,골목상권,1000008,북촌로5나길,234,113,121
2021,2,A,골목상권,1000007,북촌로5길,503,419,84
2021,2,A,골목상권,1000006,북촌로11길,671,232,439
2021,2,A,골목상권,1000005,백석동길,1797,1066,731
2021,2,A,골목상권,1000004,명륜길,56,32,24
2021,2,A,골목상권,1000003,돈화문로11가길,3686,2700,986
2021,2,A,골목상권,1000002,난계로27길,201,114,87
2021,2,A,골목상권,1000001,계동길,842,388,454
2021,1,U,관광특구,1001496,강남 마이스 관광특구,15904,8904,7000
2021,1,U,관광특구,1001495,잠실 관광특구,24375,14199,10176
2021,1,U,관광특구,1001494,종로?청계 관광특구,32935,17150,15785
2021,1,U,관광특구,1001493,동대문패션타운 관광특구,6054,2958,3096
2021,1,U,관광특구,1001492,명동 남대문 북창동 다동 무교동 관광특구,104830,53674,51156
2021,1,U,관광특구,1001491,이태원 관광특구,5839,3064,2775
2021,1,R,전통시장,1001490,길동복조리시장,430,242,188
2021,1,R,전통시장,1001489,둔촌역전통시장,224,108,116
2021,1,R,전통시장,1001488,성내골목시장,30,18,12
2021,1,R,전통시장,1001487,천호시장,35,19,16
2021,1,R,전통시장,1001486,동서울시장,5,3,2
2021,1,R,전통시장,1001484,양지골목시장,60,36,24
2021,1,R,전통시장,1001483,암사종합시장,95,53,42
2021,1,R,전통시장,1001482,고덕전통시장,935,850,85
2021,1,R,전통시장,1001481,명일골목시장,89,30,59
2021,1,R,전통시장,1001480,새마을시장,208,122,86
2021,1,R,전통시장,1001479,석촌시장,286,99,187
2021,1,R,전통시장,1001478,방이시장,3469,1526,1943
2021,1,R,전통시장,1001477,마천시장,102,70,32
2021,1,R,전통시장,1001476,풍납시장,51,20,31
2021,1,R,전통시장,1001475,강남개포시장,138,84,54
2021,1,R,전통시장,1001474,도곡시장,57,25,32
2021,1,R,전통시장,1001473,청담삼익시장,48,30,18
2021,1,R,전통시장,1001472,논현종합시장,85,43,42
2021,1,R,전통시장,1001471,영동전통시장,242,95,147
2021,1,R,전통시장,1001470,강남시장_강남,58,33,25
2021,1,R,전통시장,1001469,양재시장,35,22,13
2021,1,R,전통시장,1001468,남부종합시장,85,63,22
2021,1,R,전통시장,1001467,우림시장,1,0,1
2021,1,R,전통시장,1001466,미성동도깨비시장,75,16,59
2021,1,R,전통시장,1001463,신림중앙시장,43,27,16
2021,1,R,전통시장,1001462,강남골목시장,168,124,44
2021,1,R,전통시장,1001461,신림종합시장,8,7,1
2021,1,R,전통시장,1001460,관악신사시장,120,63,57
2021,1,R,전통시장,1001459,신원시장,42,21,21
2021,1,R,전통시장,1001458,인헌시장,122,46,76
2021,1,R,전통시장,1001457,봉천중앙시장,154,42,112
2021,1,R,전통시장,1001455,봉일시장,44,23,21
2021,1,R,전통시장,1001454,봉천제일종합시장,6,1,5
2021,1,R,전통시장,1001453,낙성대시장,10,6,4
2021,1,R,전통시장,1001452,중부시장,102,40,62
2021,1,R,전통시장,1001451,사당시장,45,20,25
2021,1,R,전통시장,1001450,남성역골목시장,467,268,199
2021,1,R,전통시장,1001449,남성사계시장,136,59,77
2021,1,R,전통시장,1001448,흑석시장,78,31,47
2021,1,R,전통시장,1001447,상도4동도깨비골목시장,95,49,46
2021,1,R,전통시장,1001446,성대시장,141,55,86
2021,1,R,전통시장,1001445,영도시장,73,6,67
2021,1,R,전통시장,1001444,상도전통시장,239,104,135
2021,1,R,전통시장,1001442,신노량진시장,11,3,8
2021,1,R,전통시장,1001441,본동인정시장,59,41,18
2021,1,R,전통시장,1001440,노량진중앙시장,244,157,87
2021,1,R,전통시장,1001439,대림중앙시장,42,29,13
2021,1,R,전통시장,1001438,우리시장,6,5,1
2021,1,R,전통시장,1001436,사러가시장,57,35,22
2021,1,R,전통시장,1001435,대신시장,12,9,3
2021,1,R,전통시장,1001433,영일시장,155,115,40
2021,1,R,전통시장,1001432,도림시장,6,4,2
2021,1,R,전통시장,1001431,영등포청과시장,23,17,6
2021,1,R,전통시장,1001430,영등포전통시장,2127,1061,1066
2021,1,R,전통시장,1001429,은행나무시장,67,40,27
2021,1,R,전통시장,1001428,박미시장,39,26,13
2021,1,R,전통시장,1001427,현대시장,139,42,97
2021,1,R,전통시장,1001426,대명시장,28,11,17
2021,1,R,전통시장,1001425,푸른터시장,3,2,1
2021,1,R,전통시장,1001424,남문시장,76,47,29
2021,1,R,전통시장,1001423,독산동 우시장,611,476,135
2021,1,R,전통시장,1001422,오류시장,132,21,111
2021,1,R,전통시장,1001421,개봉중앙시장,10,7,3
2021,1,R,전통시장,1001420,고척근린시장,55,19,36
2021,1,R,전통시장,1001418,남구로시장,236,135,101
2021,1,R,전통시장,1001417,구로시장,10,5,5
2021,1,R,전통시장,1001415,방신전통시장,116,81,35
2021,1,R,전통시장,1001414,송화골목시장,119,44,75
2021,1,R,전통시장,1001413,까치산시장,114,35,79
2021,1,R,전통시장,1001412,화곡본동시장,36,16,20
2021,1,R,전통시장,1001411,남부골목시장,156,58,98
2021,1,R,전통시장,1001410,대원종합시장,9,7,2
2021,1,R,전통시장,1001409,화곡중앙골목시장,75,32,43
2021,1,R,전통시장,1001408,신월중앙시장,118,53,65
2021,1,R,전통시장,1001406,신정3동골목시장,123,81,42
2021,1,R,전통시장,1001405,신정2동골목시장,41,13,28
2021,1,R,전통시장,1001404,신정제일시장,38,21,17
2021,1,R,전통시장,1001403,신월7동골목시장,24,16,8
2021,1,R,전통시장,1001402,신월6동골목시장,141,103,38
2021,1,R,전통시장,1001400,신월3동골목시장,12,7,5
2021,1,R,전통시장,1001399,경창시장,53,23,30
2021,1,R,전통시장,1001398,월정로시장,61,42,19
2021,1,R,전통시장,1001397,신영시장,40,13,27
2021,1,R,전통시장,1001396,목4동시장,52,35,17
2021,1,R,전통시장,1001395,목3동시장,148,67,81
2021,1,R,전통시장,1001394,목2동시장,432,251,181
2021,1,R,전통시장,1001393,마포농수산물시장,77,40,37
2021,1,R,전통시장,1001392,동진시장,10,6,4
2021,1,R,전통시장,1001391,망원월드컵시장,190,123,67
2021,1,R,전통시장,1001390,망원시장,173,81,92
2021,1,R,전통시장,1001388,영진시장,29,14,15
2021,1,R,전통시장,1001387,서교시장,24,10,14
2021,1,R,전통시장,1001386,신수시장,34,19,15
2021,1,R,전통시장,1001385,아현시장,803,430,373
2021,1,R,전통시장,1001384,마포시장,11,3,8
2021,1,R,전통시장,1001383,공덕시장,3948,2001,1947
2021,1,R,전통시장,1001382,백련시장,5,3,2
2021,1,R,전통시장,1001381,모래내시장,14,9,5
2021,1,R,전통시장,1001380,포방터시장,35,23,12
2021,1,R,전통시장,1001379,인왕시장,44,7,37
2021,1,R,전통시장,1001378,아현가구거리상점가,45,22,23
2021,1,R,전통시장,1001377,영천시장,35,19,16
2021,1,R,전통시장,1001376,수일시장,7,2,5
2021,1,R,전통시장,1001375,증산종합시장,8,5,3
2021,1,R,전통시장,1001374,대림골목시장,237,46,191
2021,1,R,전통시장,1001373,신응암시장,17,10,7
2021,1,R,전통시장,1001372,녹번시장,22,9,13
2021,1,R,전통시장,1001371,대조시장,15,7,8
2021,1,R,전통시장,1001370,역촌중앙시장,9,3,6
2021,1,R,전통시장,1001369,갈현시장,287,186,101
2021,1,R,전통시장,1001368,연서시장,206,144,62
2021,1,R,전통시장,1001367,상계중앙시장,105,59,46
2021,1,R,전통시장,1001366,상계시장,8,2,6
2021,1,R,전통시장,1001365,공릉동도깨비시장,98,47,51
2021,1,R,전통시장,1001364,방학동도깨비시장,39,16,23
2021,1,R,전통시장,1001363,쌍문역골목시장,61,14,47
2021,1,R,전통시장,1001362,백운시장,33,14,19
2021,1,R,전통시장,1001361,신도봉시장,5,5,0
2021,1,R,전통시장,1001360,창동골목시장,84,47,37
2021,1,R,전통시장,1001359,창동신창시장,104,40,64
2021,1,R,전통시장,1001358,수유북부시장,20,14,6
2021,1,R,전통시장,1001357,장미원골목시장,911,571,340
2021,1,R,전통시장,1001356,수유중앙시장,13,8,5
2021,1,R,전통시장,1001355,강북종합시장,23,9,14
2021,1,R,전통시장,1001354,우이시장,69,61,8
2021,1,R,전통시장,1001353,수유전통시장,231,55,176
2021,1,R,전통시장,1001352,번동북부골목시장,50,25,25
2021,1,R,전통시장,1001351,솔샘시장,73,30,43
2021,1,R,전통시장,1001350,숭인시장,62,27,35
2021,1,R,전통시장,1001349,방천골목시장,92,55,37
2021,1,R,전통시장,1001348,동북시장,121,49,72
2021,1,R,전통시장,1001347,석관황금시장,191,157,34
2021,1,R,전통시장,1001345,새석관시장,3,1,2
2021,1,R,전통시장,1001343,장위전통시장,40,20,20
2021,1,R,전통시장,1001342,밤나무골시장,17,5,12
2021,1,R,전통시장,1001341,길음시장,91,19,72
2021,1,R,전통시장,1001340,정릉시장,131,72,59
2021,1,R,전통시장,1001339,정릉아리랑시장,22,7,15
2021,1,R,전통시장,1001338,돈암제일시장,97,22,75
2021,1,R,전통시장,1001337,유영시장,31,20,11
2021,1,R,전통시장,1001336,우림골목시장,344,118,226
2021,1,R,전통시장,1001335,묵1동도깨비시장,35,24,11
2021,1,R,전통시장,1001334,태능시장,81,34,47
2021,1,R,전통시장,1001333,중화제일시장,69,30,39
2021,1,R,전통시장,1001332,사가정시장,86,28,58
2021,1,R,전통시장,1001331,면목골목시장,45,21,24
2021,1,R,전통시장,1001330,동원시장,224,109,115
2021,1,R,전통시장,1001329,동부골목시장,179,59,120
2021,1,R,전통시장,1001327,이경시장,16,8,8
2021,1,R,전통시장,1001326,회기시장,55,17,38
2021,1,R,전통시장,1001325,청량리청과물시장,12,9,3
2021,1,R,전통시장,1001324,전곡시장,77,42,35
2021,1,R,전통시장,1001323,답십리시장,93,40,53
2021,1,R,전통시장,1001322,동부시장,14,9,5
2021,1,R,전통시장,1001321,답십리현대시장,36,31,5
2021,1,R,전통시장,1001320,전농로터리시장,7,3,4
2021,1,R,전통시장,1001319,청량리종합시장,13,8,5
2021,1,R,전통시장,1001318,청량리전통시장,9,7,2
2021,1,R,전통시장,1001316,서울약령시장,1171,642,529
2021,1,R,전통시장,1001315,동서시장,5,3,2
2021,1,R,전통시장,1001314,경동시장,130,61,69
2021,1,R,전통시장,1001313,청량리수산시장,20,11,9
2021,1,R,전통시장,1001312,용두시장,4,2,2
2021,1,R,전통시장,1001309,조양시장,31,19,12
2021,1,R,전통시장,1001308,영동교골목시장,41,30,11
2021,1,R,전통시장,1001307,능동로골목시장,56,42,14
2021,1,R,전통시장,1001306,노룬산골목시장,23,13,10
2021,1,R,전통시장,1001305,자양종합시장,14,10,4
2021,1,R,전통시장,1001304,자양골목시장,54,36,18
2021,1,R,전통시장,1001303,신성골목시장,19,6,13
2021,1,R,전통시장,1001302,면곡골목시장,49,35,14
2021,1,R,전통시장,1001301,중곡제일시장,111,68,43
2021,1,R,전통시장,1001300,화양제일골목시장,43,11,32
2021,1,R,전통시장,1001299,한아름시장,40,29,11
2021,1,R,전통시장,1001298,성동용답상가시장,66,33,33
2021,1,R,전통시장,1001297,뚝도시장,45,17,28
2021,1,R,전통시장,1001296,금남시장,36,13,23
2021,1,R,전통시장,1001295,행당시장,314,140,174
2021,1,R,전통시장,1001294,마장축산물시장,532,358,174
2021,1,R,전통시장,1001293,보광시장,31,12,19
2021,1,R,전통시장,1001292,이태원제일시장,2,1,1
2021,1,R,전통시장,1001291,이태원시장,32,20,12
2021,1,R,전통시장,1001290,이촌종합시장,109,78,31
2021,1,R,전통시장,1001289,용문전통시장,19,10,9
2021,1,R,전통시장,1001288,만리시장,12,9,3
2021,1,R,전통시장,1001287,신흥시장,4,1,3
2021,1,R,전통시장,1001286,후암시장,15,14,1
2021,1,R,전통시장,1001285,합동(새벽)시장,365,209,156
2021,1,R,전통시장,1001284,서울중앙시장,451,320,131
2021,1,R,전통시장,1001283,백학시장,95,43,52
2021,1,R,전통시장,1001282,약수시장,271,105,166
2021,1,R,전통시장,1001281,청평화시장,120,50,70
2021,1,R,전통시장,1001280,제일평화시장,53,29,24
2021,1,R,전통시장,1001279,동평화시장,178,121,57
2021,1,R,전통시장,1001278,남평화시장,5,3,2
2021,1,R,전통시장,1001277,방산종합시장,1190,736,454
2021,1,R,전통시장,1001276,평화시장,906,614,292
2021,1,R,전통시장,1001275,인현시장,167,123,44
2021,1,R,전통시장,1001274,신중부시장,3089,921,2168
2021,1,R,전통시장,1001273,남대문시장,8186,3966,4220
2021,1,R,전통시장,1001272,신설종합시장,50,37,13
2021,1,R,전통시장,1001271,동묘시장,474,223,251
2021,1,R,전통시장,1001270,창신골목시장,13,7,6
2021,1,R,전통시장,1001269,동문시장,3,1,2
2021,1,R,전통시장,1001268,충신시장,77,40,37
2021,1,R,전통시장,1001267,종로신진시장,158,89,69
2021,1,R,전통시장,1001266,동대문종합시장,1319,965,354
2021,1,R,전통시장,1001265,광장시장,444,301,143
2021,1,R,전통시장,1001264,통인시장,59,29,30
2021,1,D,발달상권,1001263,서울 노원구 노원역_3,418,159,259
2021,1,D,발달상권,1001262,서울 노원구 노원역_2,274,126,148
2021,1,D,발달상권,1001261,서울 노원구 노원역_1,336,86,250
2021,1,D,발달상권,1001260,창동역,1003,570,433
2021,1,D,발달상권,1001259,서울 강북구 수유역_3,70,36,34
2021,1,D,발달상권,1001258,등나무근린공원 주변,65,19,46
2021,1,D,발달상권,1001257,서울 강북구 수유역_2,2284,1108,1176
2021,1,D,발달상권,1001256,서울 강북구 수유역_1,831,408,423
2021,1,D,발달상권,1001255,서울 은평구 연신내역_3,108,20,88
2021,1,D,발달상권,1001254,서울 은평구 연신내역_2,555,168,387
2021,1,D,발달상권,1001253,서울 은평구 연신내역_1,70,25,45
2021,1,D,발달상권,1001252,서울 성북구 미아삼거리역_2,322,144,178
2021,1,D,발달상권,1001251,서울 강북구 미아삼거리역_1,140,86,54
2021,1,D,발달상권,1001250,서울 은평구 불광역_3,67,24,43
2021,1,D,발달상권,1001249,서울 은평구 불광역_2,116,39,77
2021,1,D,발달상권,1001248,서울 은평구 불광역_1,180,73,107
2021,1,D,발달상권,1001247,미아사거리_2,102,47,55
2021,1,D,발달상권,1001246,미아사거리_1,210,68,142
2021,1,D,발달상권,1001245,서울 성북구 성신여대입구역,2865,1629,1236
2021,1,D,발달상권,1001244,경희대학교,70,24,46
2021,1,D,발달상권,1001243,서울 성북구 안암역,59,28,31
2021,1,D,발달상권,1001242,혜화역 대학로_3,477,210,267
2021,1,D,발달상권,1001241,혜화역 대학로_2,334,256,78
2021,1,D,발달상권,1001240,혜화역 대학로_1,1230,573,657
2021,1,D,발달상권,1001239,디지털미디어시티,6727,3880,2847
2021,1,D,발달상권,1001238,서울 동대문구 청량리역,776,413,363
2021,1,D,발달상권,1001237,서울 종로구 경복궁역_2,239,107,132
2021,1,D,발달상권,1001236,서울 종로구 안국역_2,810,409,401
2021,1,D,발달상권,1001235,서울 종로구 안국역_1,8804,7324,1480
2021,1,D,발달상권,1001234,서울 종로구 경복궁역_1,599,413,186
2021,1,D,발달상권,1001233,서울 종로구 종로3가역_3,2136,1442,694
2021,1,D,발달상권,1001232,서울 종로구 종로3가역_2,1823,948,875
2021,1,D,발달상권,1001231,서울 동대문구 신설동역_2,5440,2247,3193
2021,1,D,발달상권,1001230,인사동,26072,14829,11243
2021,1,D,발달상권,1001229,서울 종로구 종로5가역_4,1358,810,548
2021,1,D,발달상권,1001228,서울 종로구 종로5가역_3,1766,1160,606
2021,1,D,발달상권,1001227,종로구청,20709,10947,9762
2021,1,D,발달상권,1001226,서울 종로구 종로5가역_2,16173,10184,5989
2021,1,D,발달상권,1001225,신설동역,118,54,64
2021,1,D,발달상권,1001224,서울 동대문구 신설동역_1,1543,677,866
2021,1,D,발달상권,1001223,서울 종로구 광화문역_2,27999,17199,10800
2021,1,D,발달상권,1001222,동묘앞역,223,138,85
2021,1,D,발달상권,1001221,장안동사거리,1587,632,955
2021,1,D,발달상권,1001220,서울 종로구 동대문역_2,748,244,504
2021,1,D,발달상권,1001219,서울 종로구 동대문역_1,28,17,11
2021,1,D,발달상권,1001218,동대문시장_2,195,123,72
2021,1,D,발달상권,1001217,서울 종로구 종로5가역_1,22,9,13
2021,1,D,발달상권,1001216,서울 종로구 종로3가역_1,2657,1167,1490
2021,1,D,발달상권,1001215,서울 종로구 광화문역_1,12759,8498,4261
2021,1,D,발달상권,1001214,종각역,10396,8086,2310
2021,1,D,발달상권,1001213,종각역 젊음의 거리,13040,3576,9464
2021,1,D,발달상권,1001212,서대문구 서대문역_1,99,67,32
2021,1,D,발달상권,1001211,동대문시장_1,1663,493,1170
2021,1,D,발달상권,1001210,시청역_2,14646,9603,5043
2021,1,D,발달상권,1001209,서울시청,9257,4890,4367
2021,1,D,발달상권,1001208,서울 중구 을지로3가역_2,3181,2166,1015
2021,1,D,발달상권,1001207,서울 중구 신당역_2,939,534,405
2021,1,D,발달상권,1001206,서대문구 서대문역_2,1486,1018,468
2021,1,D,발달상권,1001205,동대문역사문화공원역,3166,2548,618
2021,1,D,발달상권,1001204,서울 중구 을지로3가역_1,4549,2258,2291
2021,1,D,발달상권,1001203,명동거리,8147,4244,3903
2021,1,D,발달상권,1001202,롯데백화점,27149,9657,17492
2021,1,D,발달상권,1001201,서울 중구 신당역_1,277,142,135
2021,1,D,발달상권,1001200,북창동,5197,3160,2037
2021,1,D,발달상권,1001199,서울 중구 충무로역_2,16329,7851,8478
2021,1,D,발달상권,1001198,서울 강서구 송정역,335,140,195
2021,1,D,발달상권,1001197,장한평역_2,1492,995,497
2021,1,D,발달상권,1001196,시청역_1,24904,15705,9199
2021,1,D,발달상권,1001195,왕십리역_2,233,102,131
2021,1,D,발달상권,1001194,서울 강서구 발산역,983,431,552
2021,1,D,발달상권,1001193,장한평역_1,1129,748,381
2021,1,D,발달상권,1001192,서울 중구 충무로역_1,3743,2160,1583
2021,1,D,발달상권,1001191,왕십리역_1,8,2,6
2021,1,D,발달상권,1001190,장한평역,3644,2178,1466
2021,1,D,발달상권,1001189,서울 중구 명동역,3595,1952,1643
2021,1,D,발달상권,1001188,장충동 족발거리,2100,985,1115
2021,1,D,발달상권,1001187,한양시장,55,30,25
2021,1,D,발달상권,1001186,서울 서대문구 이대역,380,160,220
2021,1,D,발달상권,1001185,서울 서대문구 신촌역,924,404,520
2021,1,D,발달상권,1001184,서울 마포구 홍대입구역_3,659,386,273
2021,1,D,발달상권,1001183,서울 마포구 홍대입구역_2,977,535,442
2021,1,D,발달상권,1001182,홍익대학교 주변,8725,5062,3663
2021,1,D,발달상권,1001181,서울 광진구 군자역,621,342,279
2021,1,D,발달상권,1001180,신촌역,4403,2012,2391
2021,1,D,발달상권,1001179,강서구청,4278,2468,1810
2021,1,D,발달상권,1001178,서울 마포구 홍대입구역_1,1618,826,792
2021,1,D,발달상권,1001177,서울 중구 약수역_2,210,91,119
2021,1,D,발달상권,1001176,서울 중구 약수역_1,24,6,18
2021,1,D,발달상권,1001175,서울 강동구 고덕역,1359,916,443
2021,1,D,발달상권,1001174,등촌역,64,37,27
2021,1,D,발달상권,1001173,서울 강동구 명일역,671,252,419
2021,1,D,발달상권,1001172,어린이대공원역,41,17,24
2021,1,D,발달상권,1001171,서울 마포구 공덕역_2,3697,2404,1293
2021,1,D,발달상권,1001170,공덕역,2092,1198,894
2021,1,D,발달상권,1001169,서울 용산구 숙대입구역,3807,1436,2371
2021,1,D,발달상권,1001168,남영역,4055,2796,1259
2021,1,D,발달상권,1001167,서울 마포구 공덕역_1,2420,796,1624
2021,1,D,발달상권,1001166,서울 마포구 마포역_2,10151,6130,4021
2021,1,D,발달상권,1001165,서울 광진구 건대입구역_2,529,268,261
2021,1,D,발달상권,1001164,서울 마포구 마포역_1,3369,2292,1077
2021,1,D,발달상권,1001163,서울 강동구 천호역_2,1208,565,643
2021,1,D,발달상권,1001162,서울 광진구 건대입구역_1,109,52,57
2021,1,D,발달상권,1001161,건대입구역,24,11,13
2021,1,D,발달상권,1001160,서울 광진구 구의역,928,584,344
2021,1,D,발달상권,1001159,서울 강동구 천호역,259,93,166
2021,1,D,발달상권,1001158,당산역_2,1429,1069,360
2021,1,D,발달상권,1001157,서울 강동구 천호역_1,138,57,81
2021,1,D,발달상권,1001156,서울 강동구 길동역,2628,1190,1438
2021,1,D,발달상권,1001155,용산 전자상가_5,1976,1461,515
2021,1,D,발달상권,1001154,용산 전자상가_4,248,182,66
2021,1,D,발달상권,1001153,당산역_1,310,186,124
2021,1,D,발달상권,1001152,서울 광진구 강변역,1337,859,478
2021,1,D,발달상권,1001151,용산 전자상가_3,1752,1311,441
2021,1,D,발달상권,1001150,서울 용산구 이태원역,452,292,160
2021,1,D,발달상권,1001149,한남오거리,823,524,299
2021,1,D,발달상권,1001148,목동사거리,41,13,28
2021,1,D,발달상권,1001147,용산 전자상가_2,392,317,75
2021,1,D,발달상권,1001146,용산구청,1526,755,771
2021,1,D,발달상권,1001145,용산 전자상가_1,3893,2851,1042
2021,1,D,발달상권,1001144,국회의사당역_2,19439,11619,7820
2021,1,D,발달상권,1001143,서울 용산구 신용산역,979,675,304
2021,1,D,발달상권,1001142,국회의사당역_1,4563,3517,1046
2021,1,D,발달상권,1001141,압구정 로데오거리_2,7107,2323,4784
2021,1,D,발달상권,1001140,서울 강남구 압구정역,9345,4345,5000
2021,1,D,발달상권,1001139,서울 영등포구 영등포구청역,449,275,174
2021,1,D,발달상권,1001138,압구정 로데오거리_1,14564,7168,7396
2021,1,D,발달상권,1001137,서울 강동구 둔촌동역,250,102,148
2021,1,D,발달상권,1001136,오목교역,125,72,53
2021,1,D,발달상권,1001135,신사동 가로수길,14671,7582,7089
2021,1,D,발달상권,1001134,서울 영등포구 여의도역_2,33585,23274,10311
2021,1,D,발달상권,1001133,청담사거리_3,1376,693,683
2021,1,D,발달상권,1001132,영등포유통상가,1504,962,542
2021,1,D,발달상권,1001131,청담역_2,4142,3212,930
2021,1,D,발달상권,1001130,청담역_1,4062,2913,1149
2021,1,D,발달상권,1001129,청담사거리_2,1289,759,530
2021,1,D,발달상권,1001128,청담사거리_1,529,295,234
2021,1,D,발달상권,1001127,서울 영등포구 여의도역_1,27015,17171,9844
2021,1,D,발달상권,1001126,서울 양천구 신정네거리역_2,28,18,10
2021,1,D,발달상권,1001125,학동사거리_2,2498,1332,1166
2021,1,D,발달상권,1001124,서울 영등포구 영등포시장역,411,246,165
2021,1,D,발달상권,1001123,학동사거리_1,4075,2555,1520
2021,1,D,발달상권,1001122,여의도 시범아파트앞,10435,6976,3459
2021,1,D,발달상권,1001121,영등포역_3,121,70,51
2021,1,D,발달상권,1001120,도산공원사거리_1,4075,1954,2121
2021,1,D,발달상권,1001119,영등포역_2,583,245,338
2021,1,D,발달상권,1001118,문래동 주민센터,6184,3312,2872
2021,1,D,발달상권,1001117,강남구 신사역_2,6953,3586,3367
2021,1,D,발달상권,1001116,영등포역_1,77,27,50
2021,1,D,발달상권,1001115,서울 강남구 강남구청역_2,3172,1916,1256
2021,1,D,발달상권,1001114,강남구 신사역_1,1108,570,538
2021,1,D,발달상권,1001113,서울 동작구 노량진1동_1,40,25,15
2021,1,D,발달상권,1001112,서울 강남구 학동역_3,3152,1780,1372
2021,1,D,발달상권,1001111,서울 강남구 강남구청역_1,3516,2335,1181
2021,1,D,발달상권,1001110,잠실역,42527,22605,19922
2021,1,D,발달상권,1001109,강남구 논현역_4,4927,2720,2207
2021,1,D,발달상권,1001108,학동역,1014,616,398
2021,1,D,발달상권,1001107,방이동 먹자골목,6881,4444,2437
2021,1,D,발달상권,1001106,서울 강남구 학동역_2,2510,1674,836
2021,1,D,발달상권,1001105,서울 동작구 노량진역,436,252,184
2021,1,D,발달상권,1001104,삼성역_3,52277,41226,11051
2021,1,D,발달상권,1001103,코엑스,15904,8904,7000
2021,1,D,발달상권,1001102,서울 강남구 학동역_1,1691,1037,654
2021,1,D,발달상권,1001101,선정릉역_2,3758,2684,1074
2021,1,D,발달상권,1001100,강남구 논현역_3,2466,700,1766
2021,1,D,발달상권,1001099,포스코사거리_2,16526,9641,6885
2021,1,D,발달상권,1001098,포스코사거리_1,22702,15610,7092
2021,1,D,발달상권,1001097,잠실역 롯데월드,2247,1185,1062
2021,1,D,발달상권,1001096,신도림역,1674,907,767
2021,1,D,발달상권,1001095,강남구 논현역_2,9009,5256,3753
2021,1,D,발달상권,1001094,선정릉역_1,2392,1492,900
2021,1,D,발달상권,1001093,신천역,4789,2992,1797
2021,1,D,발달상권,1001092,강남구 논현역_1,2284,1208,1076
2021,1,D,발달상권,1001091,삼성역_2,7062,3420,3642
2021,1,D,발달상권,1001090,삼정역_2,1162,721,441
2021,1,D,발달상권,1001089,삼정역_1,2277,1123,1154
2021,1,D,발달상권,1001088,삼성역_1,18695,12565,6130
2021,1,D,발달상권,1001087,서울 강남구 선릉역_2,40183,20392,19791
2021,1,D,발달상권,1001086,고속터미널역,2010,1612,398
2021,1,D,발달상권,1001085,서울 서초구 강남역,19954,10752,9202
2021,1,D,발달상권,1001084,서울 강남구 선릉역_1,21572,9107,12465
2021,1,D,발달상권,1001083,서울 송파구 석촌역_2,597,380,217
2021,1,D,발달상권,1001082,선릉역_2,26260,16412,9848
2021,1,D,발달상권,1001081,서울 강남구 역삼역_2,19179,15530,3649
2021,1,D,발달상권,1001080,서울 송파구 석촌역_1,168,96,72
2021,1,D,발달상권,1001079,석촌역,170,135,35
2021,1,D,발달상권,1001078,서울 강남구 강남역_2,9449,4629,4820
2021,1,D,발달상권,1001077,선릉역_1,16454,10830,5624
2021,1,D,발달상권,1001076,구로역,201,101,100
2021,1,D,발달상권,1001075,역삼역_2,10137,4381,5756
2021,1,D,발달상권,1001074,대림역_2,5179,3395,1784
2021,1,D,발달상권,1001073,서울 강남구 역삼역_1,22546,15049,7497
2021,1,D,발달상권,1001072,신대방삼거리역,259,129,130
2021,1,D,발달상권,1001071,서울 강남구 한티역,673,371,302
2021,1,D,발달상권,1001070,은마아파트입구사거리_4,570,252,318
2021,1,D,발달상권,1001069,은마아파트입구사거리_3,103,45,58
2021,1,D,발달상권,1001068,은마아파트입구사거리_2,15650,5160,10490
2021,1,D,발달상권,1001067,오류동역,2297,1736,561
2021,1,D,발달상권,1001066,서울 강남구 강남역,27566,14310,13256
2021,1,D,발달상권,1001065,은마아파트입구사거리_1,277,92,185
2021,1,D,발달상권,1001064,대림역_1,340,205,135
2021,1,D,발달상권,1001063,교대역_4,6267,3940,2327
2021,1,D,발달상권,1001062,서울 강남구 강남역_1,25938,14288,11650
2021,1,D,발달상권,1001061,방배동카페골목,374,218,156
2021,1,D,발달상권,1001059,교대역_3,1005,649,356
2021,1,D,발달상권,1001058,역삼역_1,10667,5507,5160
2021,1,D,발달상권,1001057,교대역_2,3971,2510,1461
2021,1,D,발달상권,1001056,서울 송파구 가락시장역,5421,3249,2172
2021,1,D,발달상권,1001055,서울 서초구 서초역,1858,988,870
2021,1,D,발달상권,1001054,서울 강남구 대치역_2,1139,629,510
2021,1,D,발달상권,1001053,서울 강남구 대치역_1,102,38,64
2021,1,D,발달상권,1001052,뱅뱅사거리_2,12301,8384,3917
2021,1,D,발달상권,1001051,보라매공원,2417,1455,962
2021,1,D,발달상권,1001050,교대역_1,17722,8352,9370
2021,1,D,발달상권,1001049,개봉동 현대아파트 인근,271,126,145
2021,1,D,발달상권,1001048,뱅뱅사거리,7114,4891,2223
2021,1,D,발달상권,1001047,뱅뱅사거리_1,4820,3658,1162
2021,1,D,발달상권,1001046,서울 관악구 신림역_4,332,165,167
2021,1,D,발달상권,1001045,동작구 총신대입구역_1,327,125,202
2021,1,D,발달상권,1001044,양재역_3,9025,5664,3361
2021,1,D,발달상권,1001043,동작구 총신대입구역_2,1633,741,892
2021,1,D,발달상권,1001042,서울 서초구 남부터미널역_3,3060,1217,1843
2021,1,D,발달상권,1001041,서울 강남구 수서역,12418,6339,6079
2021,1,D,발달상권,1001040,서울 관악구 신림역_3,77,20,57
2021,1,D,발달상권,1001039,서울 서초구 남부터미널역_2,3012,1965,1047
2021,1,D,발달상권,1001038,구로디지탈1단지,43655,28446,15209
2021,1,D,발달상권,1001037,양재역,904,474,430
2021,1,D,발달상권,1001036,문정역,88,52,36
2021,1,D,발달상권,1001035,매봉역,5760,4107,1653
2021,1,D,발달상권,1001034,서울 서초구 방배역,1690,910,780
2021,1,D,발달상권,1001033,서울 서초구 남부터미널역_1,2033,1323,710
2021,1,D,발달상권,1001032,서울 관악구 신림역_2,166,63,103
2021,1,D,발달상권,1001031,서울 관악구 신림역_1,615,316,299
2021,1,D,발달상권,1001030,양재역_2,2634,1725,909
2021,1,D,발달상권,1001029,양재역_1,515,305,210
2021,1,D,발달상권,1001028,서울 관악구 서울대입구역_2,57,28,29
2021,1,D,발달상권,1001027,가산디지털단지역_3,22935,14390,8545
2021,1,D,발달상권,1001026,구로디지털단지역,91,67,24
2021,1,D,발달상권,1001025,서울 관악구 서울대입구역_1,1502,797,705
2021,1,D,발달상권,1001024,관악구 사당역_1,5523,2253,3270
2021,1,D,발달상권,1001023,가산디지털단지역_2,25194,16241,8953
2021,1,D,발달상권,1001022,관악구 사당역_2,744,453,291
2021,1,D,발달상권,1001021,가산디지털단지역_1,18317,12138,6179
2021,1,D,발달상권,1001020,장지역,4411,3129,1282
2021,1,D,발달상권,1001019,포이사거리_1,192,141,51
2021,1,D,발달상권,1001018,포이사거리_2,7673,5359,2314
2021,1,D,발달상권,1001017,관악구 사당역_3,1538,1135,403
2021,1,D,발달상권,1001016,서울 관악구 대학동_1,662,558,104
2021,1,D,발달상권,1001015,서울 금천구 독산1동_1,716,485,231
2021,1,D,발달상권,1001014,양재동 꽃시장,1540,858,682
2021,1,D,발달상권,1001013,양재 화물트럭터미널앞_2,843,619,224
2021,1,D,발달상권,1001012,양재 화물트럭터미널앞_1,1944,1643,301
2021,1,D,발달상권,1001011,서울 금천구 시흥1동_4,486,164,322
2021,1,A,골목상권,1001010,풍성로37가길,128,57,71
2021,1,A,골목상권,1001009,천호옛길,420,288,132
2021,1,A,골목상권,1001008,천호옛14길,177,93,84
2021,1,A,골목상권,1001007,천호대로219길,486,338,148
2021,1,A,골목상권,1001006,천호대로197길,239,168,71
2021,1,A,골목상권,1001005,천호대로187길,371,200,171
2021,1,A,골목상권,1001004,천호대로170길,303,177,126
2021,1,A,골목상권,1001003,천호대로162길,286,149,137
2021,1,A,골목상권,1001002,천중로51길,761,536,225
2021,1,A,골목상권,1001001,천중로39길,574,375,199
2021,1,A,골목상권,1001000,진황도로47길,131,63,68
2021,1,A,골목상권,1000999,진황도로27길,298,174,124
2021,1,A,골목상권,1000998,올림픽로98길,257,169,88
2021,1,A,골목상권,1000997,올림픽로80길,152,54,98
2021,1,A,골목상권,1000996,올림픽로78길,115,58,57
2021,1,A,골목상권,1000995,올림픽로77길,210,114,96
2021,1,A,골목상권,1000994,올림픽로71길,184,101,83
2021,1,A,골목상권,1000993,올림픽로48길,1847,1272,575
2021,1,A,골목상권,1000992,양재대로96길,197,131,66
2021,1,A,골목상권,1000991,양재대로95길,602,324,278
2021,1,A,골목상권,1000990,양재대로91길,358,230,128
2021,1,A,골목상권,1000989,양재대로133길,189,122,67
2021,1,A,골목상권,1000988,양재대로124길,435,258,177
2021,1,A,골목상권,1000987,양재대로116길,75,41,34
2021,1,A,골목상권,1000986,양재대로101길,677,313,364
2021,1,A,골목상권,1000985,암사길,112,70,42
2021,1,A,골목상권,1000984,성안로3길,5508,4242,1266
2021,1,A,골목상권,1000983,성내로5길,1005,650,355
2021,1,A,골목상권,1000982,상일로5길,172,124,48
2021,1,A,골목상권,1000981,상암로5길,271,99,172
2021,1,A,골목상권,1000980,상암로51길,302,122,180
2021,1,A,골목상권,1000979,상암로4길,232,147,85
2021,1,A,골목상권,1000978,상암로14길,432,261,171
2021,1,A,골목상권,1000977,명일로13길,302,182,120
2021,1,A,골목상권,1000976,동남로85길,635,344,291
2021,1,A,골목상권,1000975,동남로82길,108,64,44
2021,1,A,골목상권,1000974,동남로65길,297,202,95
2021,1,A,골목상권,1000973,구천면로42길,87,52,35
2021,1,A,골목상권,1000972,구천면로41길,442,228,214
2021,1,A,골목상권,1000971,구천면로36길,32,14,18
2021,1,A,골목상권,1000970,고덕로61길,137,93,44
2021,1,A,골목상권,1000969,고덕로25길,143,91,52
2021,1,A,골목상권,1000968,고덕로10길,738,335,403
2021,1,A,골목상권,1000967,강동대로53길,1092,726,366
2021,1,A,골목상권,1000966,풍성로25길,84,43,41
2021,1,A,골목상권,1000965,오금로46길,711,359,352
2021,1,A,골목상권,1000964,오금로36길,1133,803,330
2021,1,A,골목상권,1000963,오금로11길,1427,884,543
2021,1,A,골목상권,1000962,양재대로72길,245,124,121
2021,1,A,골목상권,1000961,양재대로71길,1999,1458,541
2021,1,A,골목상권,1000960,양재대로64길,1212,705,507
2021,1,A,골목상권,1000959,양재대로62길,3230,2137,1093
2021,1,A,골목상권,1000958,송파대로30길,2240,1393,847
2021,1,A,골목상권,1000957,송이로36길,2096,1409,687
2021,1,A,골목상권,1000956,송이로32길,1295,733,562
2021,1,A,골목상권,1000955,송이로23길,1850,1269,581
2021,1,A,골목상권,1000954,삼전로13길,1420,916,504
2021,1,A,골목상권,1000953,백제고분로50길,1209,796,413
2021,1,A,골목상권,1000952,백제고분로46길,665,472,193
2021,1,A,골목상권,1000951,백제고분로45길,1349,869,480
2021,1,A,골목상권,1000950,백제고분로42길,590,289,301
2021,1,A,골목상권,1000949,백제고분로39길,566,393,173
2021,1,A,골목상권,1000948,백제고분로34길,1779,1368,411
2021,1,A,골목상권,1000947,백제고분로33길,921,574,347
2021,1,A,골목상권,1000946,백제고분로32길,725,407,318
2021,1,A,골목상권,1000945,백제고분로31길,1708,1370,338
2021,1,A,골목상권,1000944,백제고분로22길,1371,955,416
2021,1,A,골목상권,1000943,백제고분로21길,483,309,174
2021,1,A,골목상권,1000942,마천로51길,417,245,172
2021,1,A,골목상권,1000941,동남로20길,2463,1773,690
2021,1,A,골목상권,1000940,거마로20길,503,229,274
2021,1,A,골목상권,1000939,학동로77길,1851,1119,732
2021,1,A,골목상권,1000938,학동로6길,1447,977,470
2021,1,A,골목상권,1000937,학동로56길,2421,1533,888
2021,1,A,골목상권,1000936,학동로38길,1862,891,971
2021,1,A,골목상권,1000935,테헤란로81길,1637,791,846
2021,1,A,골목상권,1000934,일원로9길,590,334,256
2021,1,A,골목상권,1000933,일원로3길,513,237,276
2021,1,A,골목상권,1000932,영동대로65길,1175,692,483
2021,1,A,골목상권,1000931,영동대로112길,9367,7734,1633
2021,1,A,골목상권,1000930,언주로81길,5810,3989,1821
2021,1,A,골목상권,1000929,압구정로2길,1937,1352,585
2021,1,A,골목상권,1000928,선릉로18길,466,366,100
2021,1,A,골목상권,1000927,선릉로146길,1123,536,587
2021,1,A,골목상권,1000926,선릉로133길,739,434,305
2021,1,A,골목상권,1000925,선릉로132길,1305,645,660
2021,1,A,골목상권,1000924,선릉로121길,2263,1243,1020
2021,1,A,골목상권,1000923,삼성로75길,1814,1262,552
2021,1,A,골목상권,1000922,삼성로69길,2064,1086,978
2021,1,A,골목상권,1000921,삼성로64길,2957,1473,1484
2021,1,A,골목상권,1000920,삼성로63길,1079,554,525
2021,1,A,골목상권,1000919,삼성로57길,3231,1896,1335
2021,1,A,골목상권,1000918,삼성로147길,190,88,102
2021,1,A,골목상권,1000917,삼성로115길,839,429,410
2021,1,A,골목상권,1000916,봉은사로68길,1265,789,476
2021,1,A,골목상권,1000915,봉은사로57길,638,409,229
2021,1,A,골목상권,1000914,봉은사로43길,2978,1692,1286
2021,1,A,골목상권,1000913,봉은사로29길,1860,1203,657
2021,1,A,골목상권,1000912,봉은사로109길,2837,2093,744
2021,1,A,골목상권,1000911,도산대로89길,1284,730,554
2021,1,A,골목상권,1000910,도산대로81길,3094,1363,1731
2021,1,A,골목상권,1000909,도산대로50길,2685,1863,822
2021,1,A,골목상권,1000908,도산대로38길,1043,622,421
2021,1,A,골목상권,1000907,도산대로30길,3153,1611,1542
2021,1,A,골목상권,1000906,도산대로23길,425,176,249
2021,1,A,골목상권,1000905,도산대로15길,123,65,58
2021,1,A,골목상권,1000904,도곡로37길,7206,4518,2688
2021,1,A,골목상권,1000903,논현로8길,1081,701,380
2021,1,A,골목상권,1000902,논현로63길,2139,1352,787
2021,1,A,골목상권,1000901,논현로28길,2736,1826,910
2021,1,A,골목상권,1000900,논현로26길,17916,5148,12768
2021,1,A,골목상권,1000899,논현로159길,109,49,60
2021,1,A,골목상권,1000898,논현로139길,3565,2123,1442
2021,1,A,골목상권,1000897,논현로123길,162,106,56
2021,1,A,골목상권,1000896,논현로115길,2866,1752,1114
2021,1,A,골목상권,1000895,논현로10길,454,271,183
2021,1,A,골목상권,1000894,논현로106길,1488,1027,461
2021,1,A,골목상권,1000893,남부순환로365길,691,445,246
2021,1,A,골목상권,1000892,개포로82길,103,51,52
2021,1,A,골목상권,1000891,개포로28길,589,445,144
2021,1,A,골목상권,1000890,개포로20길,647,400,247
2021,1,A,골목상권,1000889,개포로17길,961,659,302
2021,1,A,골목상권,1000888,강남대로140길,1433,810,623
2021,1,A,골목상권,1000887,강남대로136길,5070,3655,1415
2021,1,A,골목상권,1000886,강남대로118길,218,91,127
2021,1,A,골목상권,1000885,서초중앙로8길,21671,11288,10383
2021,1,A,골목상권,1000884,방배중앙로21길,7153,2605,4548
2021,1,A,골목상권,1000883,효령로72길,3428,2690,738
2021,1,A,골목상권,1000882,효령로34길,1015,653,362
2021,1,A,골목상권,1000881,효령로31길,2710,2198,512
2021,1,A,골목상권,1000880,효령로23길,1492,964,528
2021,1,A,골목상권,1000879,청두곶길,1446,795,651
2021,1,A,골목상권,1000878,주흥길,164,111,53
2021,1,A,골목상권,1000877,주흥15길,834,539,295
2021,1,A,골목상권,1000876,언남길,1128,742,386
2021,1,A,골목상권,1000875,신반포로45길,1192,625,567
2021,1,A,골목상권,1000874,서초대로8길,2598,644,1954
2021,1,A,골목상권,1000873,서초대로64길,829,489,340
2021,1,A,골목상권,1000872,서초대로4길,847,478,369
2021,1,A,골목상권,1000871,서초대로25길,2073,1591,482
2021,1,A,골목상권,1000870,서초대로23길,2098,1239,859
2021,1,A,골목상권,1000869,서초대로15길,467,253,214
2021,1,A,골목상권,1000868,사평대로57길,65,33,32
2021,1,A,골목상권,1000867,사평대로26길,509,346,163
2021,1,A,골목상권,1000866,사평대로22길,1697,1052,645
2021,1,A,골목상권,1000865,사임당로17길,1939,1273,666
2021,1,A,골목상권,1000864,방배로42길,861,707,154
2021,1,A,골목상권,1000863,방배로35길,1137,711,426
2021,1,A,골목상권,1000862,방배로18길,873,535,338
2021,1,A,골목상권,1000861,반포대로9길,538,288,250
2021,1,A,골목상권,1000860,바우뫼로39길,2648,1935,713
2021,1,A,골목상권,1000859,마방로2길,3582,2570,1012
2021,1,A,골목상권,1000858,방배천로4안길,959,401,558
2021,1,A,골목상권,1000857,동산로19길,1276,633,643
2021,1,A,골목상권,1000856,동산로10길,2158,1493,665
2021,1,A,골목상권,1000855,동광로39길,1227,825,402
2021,1,A,골목상권,1000854,동광로1길,2565,1862,703
2021,1,A,골목상권,1000853,동광로12길,1237,610,627
2021,1,A,골목상권,1000852,논현로27길,2808,2146,662
2021,1,A,골목상권,1000851,논현로1길,1227,780,447
2021,1,A,골목상권,1000850,남부순환로339길,1451,978,473
2021,1,A,골목상권,1000849,남부순환로325길,1477,1061,416
2021,1,A,골목상권,1000848,남부순환로317길,2386,1532,854
2021,1,A,골목상권,1000847,고무래로8길,5479,3568,1911
2021,1,A,골목상권,1000846,강남대로8길,1850,1231,619
2021,1,A,골목상권,1000845,강남대로34길,1734,1204,530
2021,1,A,골목상권,1000844,강남대로23길,2897,1993,904
2021,1,A,골목상권,1000843,소담길,14,4,10
2021,1,A,골목상권,1000842,원신길,22,11,11
2021,1,A,골목상권,1000840,양산길,11,3,8
2021,1,A,골목상권,1000839,호암로24길,1218,1084,134
2021,1,A,골목상권,1000838,호암로20길,186,77,109
2021,1,A,골목상권,1000837,행운길,557,428,129
2021,1,A,골목상권,1000836,행운1길,250,151,99
2021,1,A,골목상권,1000835,청림3길,167,58,109
2021,1,A,골목상권,1000834,청룡길,404,224,180
2021,1,A,골목상권,1000833,청룡8길,222,53,169
2021,1,A,골목상권,1000832,중앙길,99,30,69
2021,1,A,골목상권,1000831,조원중앙로2길,921,694,227
2021,1,A,골목상권,1000830,조원로18길,179,92,87
2021,1,A,골목상권,1000829,조원로10길,397,215,182
2021,1,A,골목상권,1000828,장군봉2길,201,115,86
2021,1,A,골목상권,1000827,장군봉1길,326,166,160
2021,1,A,골목상권,1000826,인헌길,115,61,54
2021,1,A,골목상권,1000825,은천로25길,44,21,23
2021,1,A,골목상권,1000824,양녕로6길,205,124,81
2021,1,A,골목상권,1000823,신원로3길,180,103,77
2021,1,A,골목상권,1000822,신사로20길,121,93,28
2021,1,A,골목상권,1000821,신림로65길,228,175,53
2021,1,A,골목상권,1000820,신림로64길,113,45,68
2021,1,A,골목상권,1000819,신림로48길,75,49,26
2021,1,A,골목상권,1000818,신림로38길,147,90,57
2021,1,A,골목상권,1000817,신림로28길,442,283,159
2021,1,A,골목상권,1000816,신림로11길,284,183,101
2021,1,A,골목상권,1000815,신림동길,669,435,234
2021,1,A,골목상권,1000814,승방길,251,141,110
2021,1,A,골목상권,1000813,서림7길,116,58,58
2021,1,A,골목상권,1000812,봉천로33길,211,131,80
2021,1,A,골목상권,1000811,봉천로13길,241,86,155
2021,1,A,골목상권,1000810,복은길,405,229,176
2021,1,A,골목상권,1000809,법원단지길,16,5,11
2021,1,A,골목상권,1000808,법원단지9길,163,102,61
2021,1,A,골목상권,1000807,미성5길,309,154,155
2021,1,A,골목상권,1000806,대학길,80,45,35
2021,1,A,골목상권,1000805,대학14길,61,31,30
2021,1,A,골목상권,1000804,당곡길,227,117,110
2021,1,A,골목상권,1000803,남현길,117,28,89
2021,1,A,골목상권,1000802,남현3길,372,256,116
2021,1,A,골목상권,1000801,남현2길,568,398,170
2021,1,A,골목상권,1000800,남부순환로248길,404,213,191
2021,1,A,골목상권,1000799,남부순환로234길,126,81,45
2021,1,A,골목상권,1000798,남부순환로172길,450,316,134
2021,1,A,골목상권,1000797,남부순환로161길,347,223,124
2021,1,A,골목상권,1000796,남부순환로151길,788,369,419
2021,1,A,골목상권,1000795,남부순환로142길,418,252,166
2021,1,A,골목상권,1000794,난향길,206,89,117
2021,1,A,골목상권,1000793,난우길,217,121,96
2021,1,A,골목상권,1000792,난곡로74길,2179,1754,425
2021,1,A,골목상권,1000791,난곡로34길,47,19,28
2021,1,A,골목상권,1000790,난곡로26길,120,85,35
2021,1,A,골목상권,1000789,난곡로24길,89,34,55
2021,1,A,골목상권,1000788,낙성대역길,431,230,201
2021,1,A,골목상권,1000787,국회단지길,1430,396,1034
2021,1,A,골목상권,1000786,구암길,228,72,156
2021,1,A,골목상권,1000785,관천로22길,194,117,77
2021,1,A,골목상권,1000784,관천로15길,236,149,87
2021,1,A,골목상권,1000783,관악로30길,140,51,89
2021,1,A,골목상권,1000782,관악로28길,122,39,83
2021,1,A,골목상권,1000781,관악로14길,109,42,67
2021,1,A,골목상권,1000780,관악로10길,1482,1050,432
2021,1,A,골목상권,1000779,흑석로9길,110,76,34
2021,1,A,골목상권,1000778,흑석로13길,77,33,44
2021,1,A,골목상권,1000777,장승배기로27길,260,135,125
2021,1,A,골목상권,1000776,장승배기로19길,518,409,109
2021,1,A,골목상권,1000775,장승배기로10길,223,90,133
2021,1,A,골목상권,1000774,여의대방로46길,1238,733,505
2021,1,A,골목상권,1000773,여의대방로24길,16249,10586,5663
2021,1,A,골목상권,1000772,여의대방로22카길,346,202,144
2021,1,A,골목상권,1000771,여의대방로22나길,188,95,93
2021,1,A,골목상권,1000770,여의대방로22길,241,128,113
2021,1,A,골목상권,1000769,양녕로26길,92,49,43
2021,1,A,골목상권,1000768,신대방길,191,90,101
2021,1,A,골목상권,1000767,성대로29길,297,143,154
2021,1,A,골목상권,1000766,성대로1길,87,43,44
2021,1,A,골목상권,1000765,서달로8가길,83,34,49
2021,1,A,골목상권,1000764,서달로15길,42,14,28
2021,1,A,골목상권,1000763,서달로14길,21,7,14
2021,1,A,골목상권,1000762,서달로10길,51,28,23
2021,1,A,골목상권,1000761,상도로62길,332,179,153
2021,1,A,골목상권,1000760,상도로61길,187,67,120
2021,1,A,골목상권,1000759,상도로47길,601,288,313
2021,1,A,골목상권,1000758,상도로37길,128,65,63
2021,1,A,골목상권,1000757,상도로15길,320,121,199
2021,1,A,골목상권,1000756,사당로8길,131,70,61
2021,1,A,골목상권,1000755,사당로30길,514,180,334
2021,1,A,골목상권,1000754,사당로2차길,324,216,108
2021,1,A,골목상권,1000753,사당로29길,128,78,50
2021,1,A,골목상권,1000752,사당로26길,321,199,122
2021,1,A,골목상권,1000751,사당로23나길,36,21,15
2021,1,A,골목상권,1000749,사당로20길,103,53,50
2021,1,A,골목상권,1000748,사당로16길,116,36,80
2021,1,A,골목상권,1000747,사당로16가길,237,147,90
2021,1,A,골목상권,1000746,만양로8길,824,512,312
2021,1,A,골목상권,1000745,만양로14길,47,29,18
2021,1,A,골목상권,1000744,등용로14길,409,134,275
2021,1,A,골목상권,1000743,동작대로7길,182,84,98
2021,1,A,골목상권,1000742,동작대로35길,190,87,103
2021,1,A,골목상권,1000741,동작대로33길,170,88,82
2021,1,A,골목상권,1000740,동작대로29길,224,49,175
2021,1,A,골목상권,1000739,동작대로17길,806,386,420
2021,1,A,골목상권,1000738,대방동2길,281,134,147
2021,1,A,골목상권,1000737,대방동27길,465,223,242
2021,1,A,골목상권,1000736,노량진로6길,307,204,103
2021,1,A,골목상권,1000735,국사봉길,138,79,59
2021,1,A,골목상권,1000734,국사봉2길,55,34,21
2021,1,A,골목상권,1000733,국사봉1길,85,52,33
2021,1,A,골목상권,1000732,영신로9길,3221,1646,1575
2021,1,A,골목상권,1000731,영등포로84길,1933,673,1260
2021,1,A,골목상권,1000730,영등포로80길,96,48,48
2021,1,A,골목상권,1000729,영등포로62길,118,85,33
2021,1,A,골목상권,1000728,영등포로35길,340,192,148
2021,1,A,골목상권,1000727,영등포로27길,301,189,112
2021,1,A,골목상권,1000726,영등포로25길,493,363,130
2021,1,A,골목상권,1000725,여의대방로61길,514,400,114
2021,1,A,골목상권,1000724,여의대방로43나길,859,661,198
2021,1,A,골목상권,1000723,여의대방로39길,193,112,81
2021,1,A,골목상권,1000722,여의대방로35길,197,65,132
2021,1,A,골목상권,1000721,양평로28길,847,707,140
2021,1,A,골목상권,1000720,양평로22라길,555,299,256
2021,1,A,골목상권,1000719,양평로19길,748,436,312
2021,1,A,골목상권,1000718,신길로60길,260,196,64
2021,1,A,골목상권,1000717,신길로42길,501,270,231
2021,1,A,골목상권,1000716,신길로42가길,210,90,120
2021,1,A,골목상권,1000715,신길로39길,56,32,24
2021,1,A,골목상권,1000714,신길로17길,676,289,387
2021,1,A,골목상권,1000713,선유서로28길,208,110,98
2021,1,A,골목상권,1000712,선유서로25길,1697,1284,413
2021,1,A,골목상권,1000711,선유서로24길,114,70,44
2021,1,A,골목상권,1000710,선유로55길,416,273,143
2021,1,A,골목상권,1000709,디지털로74길,13,8,5
2021,1,A,골목상권,1000708,디지털로57길,1036,639,397
2021,1,A,골목상권,1000707,디지털로37길,172,55,117
2021,1,A,골목상권,1000706,도신로62길,227,173,54
2021,1,A,골목상권,1000705,도신로60길,124,51,73
2021,1,A,골목상권,1000704,도신로29길,108,49,59
2021,1,A,골목상권,1000703,도신로15길,437,238,199
2021,1,A,골목상권,1000702,도림천로21길,236,157,79
2021,1,A,골목상권,1000701,도림로63길,53,41,12
2021,1,A,골목상권,1000700,도림로147길,334,255,79
2021,1,A,골목상권,1000699,도림로112길,30,19,11
2021,1,A,골목상권,1000698,대림로8길,234,113,121
2021,1,A,골목상권,1000697,대림로7길,49,23,26
2021,1,A,골목상권,1000696,대림로44길,411,289,122
2021,1,A,골목상권,1000695,대림로34길,201,139,62
2021,1,A,골목상권,1000694,대림로31길,454,281,173
2021,1,A,골목상권,1000693,대림로29길,964,624,340
2021,1,A,골목상권,1000692,대림로22길,190,98,92
2021,1,A,골목상권,1000691,당산로46길,698,529,169
2021,1,A,골목상권,1000690,당산로38길,676,471,205
2021,1,A,골목상권,1000689,당산로37길,2439,1483,956
2021,1,A,골목상권,1000688,당산로31길,1481,749,732
2021,1,A,골목상권,1000687,국회대로56길,3275,1590,1685
2021,1,A,골목상권,1000686,경인로90길,282,210,72
2021,1,A,골목상권,1000685,경인로80길,1007,706,301
2021,1,A,골목상권,1000684,경인로77길,741,512,229
2021,1,A,골목상권,1000683,가마산로61길,47,35,12
2021,1,A,골목상권,1000682,시흥대로94길,446,164,282
2021,1,A,골목상권,1000681,시흥대로84길,178,103,75
2021,1,A,골목상권,1000680,시흥대로68길,549,219,330
2021,1,A,골목상권,1000679,시흥대로63길,1016,542,474
2021,1,A,골목상권,1000678,시흥대로62가길,86,59,27
2021,1,A,골목상권,1000677,시흥대로36길,288,173,115
2021,1,A,골목상권,1000676,시흥대로22길,259,143,116
2021,1,A,골목상권,1000675,시흥대로153길,92,55,37
2021,1,A,골목상권,1000674,시흥대로150길,421,278,143
2021,1,A,골목상권,1000673,시흥대로141길,214,142,72
2021,1,A,골목상권,1000672,시흥대로138길,341,246,95
2021,1,A,골목상권,1000671,시흥대로120길,192,117,75
2021,1,A,골목상권,1000670,벚꽃로56길,301,260,41
2021,1,A,골목상권,1000669,범안로17길,4567,2830,1737
2021,1,A,골목상권,1000668,범안로11길,1498,819,679
2021,1,A,골목상권,1000667,문성로5길,379,199,180
2021,1,A,골목상권,1000666,독산로85길,68,34,34
2021,1,A,골목상권,1000665,독산로78다길,195,124,71
2021,1,A,골목상권,1000664,독산로70길,74,31,43
2021,1,A,골목상권,1000663,독산로64길,186,152,34
2021,1,A,골목상권,1000662,독산로50길,27,6,21
2021,1,A,골목상권,1000661,독산로40길,219,75,144
2021,1,A,골목상권,1000660,독산로108길,1619,1443,176
2021,1,A,골목상권,1000659,남부순환로112길,96,66,30
2021,1,A,골목상권,1000658,금하로24길,132,72,60
2021,1,A,골목상권,1000657,금하로1길,227,175,52
2021,1,A,골목상권,1000656,금하로14길,96,65,31
2021,1,A,골목상권,1000655,가산로5길,499,350,149
2021,1,A,골목상권,1000654,가산로3길,999,756,243
2021,1,A,골목상권,1000653,중앙로1길,960,704,256
2021,1,A,골목상권,1000652,중앙로15길,171,106,65
2021,1,A,골목상권,1000651,우마길,43,19,24
2021,1,A,골목상권,1000650,오류로8길,442,219,223
2021,1,A,골목상권,1000649,신도림로13길,148,100,48
2021,1,A,골목상권,1000648,새말로18길,933,549,384
2021,1,A,골목상권,1000647,부일로1길,356,321,35
2021,1,A,골목상권,1000646,부일로15길,156,107,49
2021,1,A,골목상권,1000645,부일로11길,281,115,166
2021,1,A,골목상권,1000644,디지털로32길,815,435,380
2021,1,A,골목상권,1000643,디지털로32가길,2221,1322,899
2021,1,A,골목상권,1000642,디지털로27길,26,20,6
2021,1,A,골목상권,1000641,도림로6길,160,93,67
2021,1,A,골목상권,1000640,도림로12길,186,124,62
2021,1,A,골목상권,1000639,남부순환로97길,101,48,53
2021,1,A,골목상권,1000638,구로중앙로8길,107,41,66
2021,1,A,골목상권,1000637,구로중앙로7길,86,42,44
2021,1,A,골목상권,1000636,구로중앙로42길,403,284,119
2021,1,A,골목상권,1000635,구로중앙로34길,189,149,40
2021,1,A,골목상권,1000634,구로중앙로28길,470,226,244
2021,1,A,골목상권,1000633,구로중앙로19길,666,398,268
2021,1,A,골목상권,1000632,구로동로8길,298,153,145
2021,1,A,골목상권,1000631,구로동로7길,115,71,44
2021,1,A,골목상권,1000630,구로동로42길,131,75,56
2021,1,A,골목상권,1000629,구로동로41길,119,79,40
2021,1,A,골목상권,1000628,구로동로38길,625,240,385
2021,1,A,골목상권,1000627,구로동로28길,42,18,24
2021,1,A,골목상권,1000626,구로동로15길,88,50,38
2021,1,A,골목상권,1000625,공원로6가길,1158,755,403
2021,1,A,골목상권,1000624,고척로52길,40,27,13
2021,1,A,골목상권,1000623,고척로27다길,169,99,70
2021,1,A,골목상권,1000622,고척로27길,309,167,142
2021,1,A,골목상권,1000621,고척로21나길,369,197,172
2021,1,A,골목상권,1000620,경인로47길,657,264,393
2021,1,A,골목상권,1000619,경인로35길,364,232,132
2021,1,A,골목상권,1000618,경인로31길,130,61,69
2021,1,A,골목상권,1000617,경인로15길,259,93,166
2021,1,A,골목상권,1000616,개봉로3길,273,139,134
2021,1,A,골목상권,1000615,개봉로2길,186,99,87
2021,1,A,골목상권,1000614,개봉로23가길,826,590,236
2021,1,A,골목상권,1000613,개봉로20길,3082,1346,1736
2021,1,A,골목상권,1000612,개봉로1길,187,126,61
2021,1,A,골목상권,1000611,개봉로17다길,2362,1606,756
2021,1,A,골목상권,1000610,개봉로17길,1304,418,886
2021,1,A,골목상권,1000609,개봉로11길,181,97,84
2021,1,A,골목상권,1000608,화곡로64길,1128,686,442
2021,1,A,골목상권,1000607,화곡로59길,316,232,84
2021,1,A,골목상권,1000606,화곡로44나길,625,559,66
2021,1,A,골목상권,1000605,화곡로31길,618,375,243
2021,1,A,골목상권,1000604,화곡로20길,355,193,162
2021,1,A,골목상권,1000603,화곡로13길,368,249,119
2021,1,A,골목상권,1000602,초원로16길,523,369,154
2021,1,A,골목상권,1000601,초록마을로8길,116,68,48
2021,1,A,골목상권,1000600,초록마을로3길,439,355,84
2021,1,A,골목상권,1000599,월정로20길,135,31,104
2021,1,A,골목상권,1000598,우장산로6길,486,298,188
2021,1,A,골목상권,1000597,양천로73가길,468,360,108
2021,1,A,골목상권,1000596,양천로71길,1203,752,451
2021,1,A,골목상권,1000595,양천로49길,342,232,110
2021,1,A,골목상권,1000594,양천로26길,479,377,102
2021,1,A,골목상권,1000593,양천로24길,186,100,86
2021,1,A,골목상권,1000592,양천로24가길,207,113,94
2021,1,A,골목상권,1000591,양천로14길,257,143,114
2021,1,A,골목상권,1000590,방화대로6라길,653,413,240
2021,1,A,골목상권,1000589,방화대로21길,390,243,147
2021,1,A,골목상권,1000588,등촌로5길,1524,514,1010
2021,1,A,골목상권,1000587,등촌로55길,432,323,109
2021,1,A,골목상권,1000586,등촌로51길,239,137,102
2021,1,A,골목상권,1000585,등촌로39길,313,146,167
2021,1,A,골목상권,1000584,등촌로13길,183,128,55
2021,1,A,골목상권,1000583,남부순환로11길,307,201,106
2021,1,A,골목상권,1000582,까치산로4길,189,112,77
2021,1,A,골목상권,1000581,국회대로7길,215,101,114
2021,1,A,골목상권,1000580,공항대로8길,276,172,104
2021,1,A,골목상권,1000579,공항대로61길,547,415,132
2021,1,A,골목상권,1000578,공항대로59다길,1037,645,392
2021,1,A,골목상권,1000577,공항대로59길,654,454,200
2021,1,A,골목상권,1000576,공항대로55길,900,577,323
2021,1,A,골목상권,1000575,공항대로42길,514,323,191
2021,1,A,골목상권,1000574,공항대로38길,92,49,43
2021,1,A,골목상권,1000573,곰달래로60길,221,146,75
2021,1,A,골목상권,1000572,곰달래로53길,130,89,41
2021,1,A,골목상권,1000571,곰달래로47길,333,218,115
2021,1,A,골목상권,1000570,곰달래로31길,120,78,42
2021,1,A,골목상권,1000569,곰달래로25길,245,139,106
2021,1,A,골목상권,1000568,개화동로25길,351,201,150
2021,1,A,골목상권,1000567,개화동로23길,857,669,188
2021,1,A,골목상권,1000566,강서로8길,214,125,89
2021,1,A,골목상권,1000565,강서로5라길,245,176,69
2021,1,A,골목상권,1000564,강서로5나길,360,221,139
2021,1,A,골목상권,1000563,강서로5가길,182,98,84
2021,1,A,골목상권,1000562,강서로47라길,207,150,57
2021,1,A,골목상권,1000561,강서로47길,327,146,181
2021,1,A,골목상권,1000560,강서로45다길,243,178,65
2021,1,A,골목상권,1000559,강서로45길,101,43,58
2021,1,A,골목상권,1000558,강서로35길,280,120,160
2021,1,A,골목상권,1000557,강서로29길,384,230,154
2021,1,A,골목상권,1000556,강서로18길,676,545,131
2021,1,A,골목상권,1000555,강서로17가길,554,386,168
2021,1,A,골목상권,1000554,강서로15길,261,152,109
2021,1,A,골목상권,1000553,가로공원로80길,270,175,95
2021,1,A,골목상권,1000552,가로공원로76가길,168,91,77
2021,1,A,골목상권,1000551,화곡로4길,421,219,202
2021,1,A,골목상권,1000550,화곡로3길,351,177,174
2021,1,A,골목상권,1000549,지양로7길,245,105,140
2021,1,A,골목상권,1000548,중앙로55길,592,261,331
2021,1,A,골목상권,1000547,중앙로51길,283,178,105
2021,1,A,골목상권,1000546,중앙로47길,94,40,54
2021,1,A,골목상권,1000545,중앙로45길,1386,1342,44
2021,1,A,골목상권,1000544,중앙로36길,133,49,84
2021,1,A,골목상권,1000543,중앙로32길,145,87,58
2021,1,A,골목상권,1000542,중앙로25길,97,61,36
2021,1,A,골목상권,1000541,은행정로7길,472,183,289
2021,1,A,골목상권,1000540,은행정로5길,109,57,52
2021,1,A,골목상권,1000539,오목로5길,120,85,35
2021,1,A,골목상권,1000538,오목로3길,375,296,79
2021,1,A,골목상권,1000537,오목로30길,220,125,95
2021,1,A,골목상권,1000536,오목로23길,401,155,246
2021,1,A,골목상권,1000535,신월로20길,47,30,17
2021,1,A,골목상권,1000534,신월로15길,357,184,173
2021,1,A,골목상권,1000533,신목로6길,582,383,199
2021,1,A,골목상권,1000532,신목로5길,645,416,229
2021,1,A,골목상권,1000531,신목로2길,386,255,131
2021,1,A,골목상권,1000530,목동중앙서로8가길,317,200,117
2021,1,A,골목상권,1000529,목동중앙서로7길,75,52,23
2021,1,A,골목상권,1000528,목동중앙북로8길,171,102,69
2021,1,A,골목상권,1000527,목동중앙북로16길,488,190,298
2021,1,A,골목상권,1000526,목동중앙본로7길,131,70,61
2021,1,A,골목상권,1000525,목동중앙로3길,157,95,62
2021,1,A,골목상권,1000524,목동중앙로13나길,346,248,98
2021,1,A,골목상권,1000523,목동중앙남로3가길,190,108,82
2021,1,A,골목상권,1000522,목동로9길,768,479,289
2021,1,A,골목상권,1000521,목동로19길,351,190,161
2021,1,A,골목상권,1000520,목동동로8길,184,106,78
2021,1,A,골목상권,1000519,목동동로12길,335,228,107
2021,1,A,골목상권,1000518,목동남로4길,797,494,303
2021,1,A,골목상권,1000517,남부순환로88길,328,124,204
2021,1,A,골목상권,1000516,남부순환로79길,142,74,68
2021,1,A,골목상권,1000515,남부순환로70길,165,101,64
2021,1,A,골목상권,1000514,남부순환로58길,282,179,103
2021,1,A,골목상권,1000513,남부순환로40길,122,46,76
2021,1,A,골목상권,1000512,남부순환로33길,179,116,63
2021,1,A,골목상권,1000511,곰달래로5길,211,125,86
2021,1,A,골목상권,1000510,곰달래로3길,313,213,100
2021,1,A,골목상권,1000509,곰달래로2길,610,344,266
2021,1,A,골목상권,1000508,곰달래로10길,543,449,94
2021,1,A,골목상권,1000507,가로공원로58길,91,54,37
2021,1,A,골목상권,1000506,효창원로93길,243,99,144
2021,1,A,골목상권,1000505,토정로37길,431,166,265
2021,1,A,골목상권,1000504,월드컵로8길,939,462,477
2021,1,A,골목상권,1000503,월드컵로7길,759,308,451
2021,1,A,골목상권,1000502,월드컵로36길,461,286,175
2021,1,A,골목상권,1000501,월드컵로25길,309,125,184
2021,1,A,골목상권,1000500,월드컵로19길,284,181,103
2021,1,A,골목상권,1000499,월드컵로16길,1538,929,609
2021,1,A,골목상권,1000498,월드컵로11길,421,153,268
2021,1,A,골목상권,1000497,월드컵로10길,1102,654,448
2021,1,A,골목상권,1000496,와우산로3길,257,176,81
2021,1,A,골목상권,1000495,와우산로29길,78,30,48
2021,1,A,골목상권,1000494,와우산로29가길,989,653,336
2021,1,A,골목상권,1000493,양화진길,676,412,264
2021,1,A,골목상권,1000492,양화로1길,544,248,296
2021,1,A,골목상권,1000491,양화로11길,2761,1012,1749
2021,1,A,골목상권,1000490,신촌로30길,109,64,45
2021,1,A,골목상권,1000489,신촌로28가길,59,19,40
2021,1,A,골목상권,1000488,신촌로12길,197,95,102
2021,1,A,골목상권,1000487,숭문길,1467,1016,451
2021,1,A,골목상권,1000486,숭문8길,109,65,44
2021,1,A,골목상권,1000485,성지3길,338,228,110
2021,1,A,골목상권,1000484,성산로4길,855,546,309
2021,1,A,골목상권,1000483,성미산로32길,243,172,71
2021,1,A,골목상권,1000482,성미산로1길,554,299,255
2021,1,A,골목상권,1000481,성미산로11길,1114,807,307
2021,1,A,골목상권,1000480,백범로16길,1908,1298,610
2021,1,A,골목상권,1000479,방울내로9안길,619,351,268
2021,1,A,골목상권,1000478,모래내로7길,91,63,28
2021,1,A,골목상권,1000477,매봉산로2길,806,601,205
2021,1,A,골목상권,1000476,망원로2길,282,190,92
2021,1,A,골목상권,1000475,망원로11길,144,73,71
2021,1,A,골목상권,1000474,만리재옛길,1190,687,503
2021,1,A,골목상권,1000473,마포대로4길,674,365,309
2021,1,A,골목상권,1000472,마포대로20길,483,258,225
2021,1,A,골목상권,1000471,마포대로12길,78,39,39
2021,1,A,골목상권,1000470,동교로38길,464,247,217
2021,1,A,골목상권,1000469,동교로27길,1172,795,377
2021,1,A,골목상권,1000468,동교로25길,1378,581,797
2021,1,A,골목상권,1000467,동교로19길,1207,739,468
2021,1,A,골목상권,1000466,동교로17길,405,240,165
2021,1,A,골목상권,1000465,독막로8길,441,274,167
2021,1,A,골목상권,1000464,독막로32길,487,240,247
2021,1,A,골목상권,1000463,독막로22길,91,61,30
2021,1,A,골목상권,1000462,도화길,56,32,24
2021,1,A,골목상권,1000461,도화4길,825,292,533
2021,1,A,골목상권,1000460,대흥로28길,50,17,33
2021,1,A,골목상권,1000459,대흥로21길,372,188,184
2021,1,A,골목상권,1000458,광성로6길,295,169,126
2021,1,A,골목상권,1000457,홍제내길,565,201,364
2021,1,A,골목상권,1000456,홍연길,79,47,32
2021,1,A,골목상권,1000455,통일로39길,67,32,35
2021,1,A,골목상권,1000454,통일로37길,611,407,204
2021,1,A,골목상권,1000453,통일로11길,97,46,51
2021,1,A,골목상권,1000452,충정로6길,3185,1879,1306
2021,1,A,골목상권,1000451,충정로4길,2044,1298,746
2021,1,A,골목상권,1000450,증가로6길,326,277,49
2021,1,A,골목상권,1000449,증가로23나길,902,441,461
2021,1,A,골목상권,1000448,증가로20가길,336,99,237
2021,1,A,골목상권,1000447,증가로10길,1463,1123,340
2021,1,A,골목상권,1000446,응암로1길,621,380,241
2021,1,A,골목상권,1000445,연희로10길,3448,3135,313
2021,1,A,골목상권,1000444,신촌로37길,52,25,27
2021,1,A,골목상권,1000443,수색로8길,1090,905,185
2021,1,A,골목상권,1000442,세무서길,164,78,86
2021,1,A,골목상권,1000441,세무서2길,186,77,109
2021,1,A,골목상권,1000440,세검정로1길,109,37,72
2021,1,A,골목상권,1000439,북아현로4길,350,225,125
2021,1,A,골목상권,1000438,모래내로15길,74,54,20
2021,1,A,골목상권,1000437,명지대길,107,58,49
2021,1,A,골목상권,1000436,독립문로8길,679,422,257
2021,1,A,골목상권,1000435,가재울로6길,168,108,60
2021,1,A,골목상권,1000434,통일로92길,186,72,114
2021,1,A,골목상권,1000433,통일로87길,255,130,125
2021,1,A,골목상권,1000432,통일로78길,172,60,112
2021,1,A,골목상권,1000431,통일로69길,107,55,52
2021,1,A,골목상권,1000430,진흥로1길,310,165,145
2021,1,A,골목상권,1000429,진흥로12길,392,144,248
2021,1,A,골목상권,1000428,증산서길,334,189,145
2021,1,A,골목상권,1000427,증산로9길,606,525,81
2021,1,A,골목상권,1000426,증산로5길,508,308,200
2021,1,A,골목상권,1000425,증산로21길,237,122,115
2021,1,A,골목상권,1000424,증산로17길,161,110,51
2021,1,A,골목상권,1000423,증산로15길,398,297,101
2021,1,A,골목상권,1000422,증산로13길,79,42,37
2021,1,A,골목상권,1000421,응암로34길,231,118,113
2021,1,A,골목상권,1000420,응암로22길,130,53,77
2021,1,A,골목상권,1000419,응암로14길,99,50,49
2021,1,A,골목상권,1000418,응암로13길,156,44,112
2021,1,A,골목상권,1000417,응암로12길,67,32,35
2021,1,A,골목상권,1000416,은평로8길,275,194,81
2021,1,A,골목상권,1000415,은평로3길,242,110,132
2021,1,A,골목상권,1000414,은평로20길,9,2,7
2021,1,A,골목상권,1000413,은평로13길,655,283,372
2021,1,A,골목상권,1000412,은평로10길,246,148,98
2021,1,A,골목상권,1000411,연서로5길,647,303,344
2021,1,A,골목상권,1000410,연서로41길,64,33,31
2021,1,A,골목상권,1000409,연서로3길,119,51,68
2021,1,A,골목상권,1000408,연서로34길,1310,709,601
2021,1,A,골목상권,1000407,연서로33길,109,49,60
2021,1,A,골목상권,1000406,연서로29길,100,60,40
2021,1,A,골목상권,1000405,연서로28길,226,118,108
2021,1,A,골목상권,1000404,연서로27길,339,148,191
2021,1,A,골목상권,1000403,연서로21길,684,486,198
2021,1,A,골목상권,1000402,연서로17길,540,162,378
2021,1,A,골목상권,1000401,연서로16길,121,66,55
2021,1,A,골목상권,1000400,연서로13길,218,135,83
2021,1,A,골목상권,1000399,연서로11길,640,263,377
2021,1,A,골목상권,1000398,역말로9길,159,82,77
2021,1,A,골목상권,1000397,수색로18길,128,93,35
2021,1,A,골목상권,1000396,서오릉로8길,160,104,56
2021,1,A,골목상권,1000395,서오릉로21길,153,56,97
2021,1,A,골목상권,1000394,불광천길,192,95,97
2021,1,A,골목상권,1000393,갈현로7길,398,205,193
2021,1,A,골목상권,1000392,갈현로41길,171,78,93
2021,1,A,골목상권,1000391,갈현로33길,255,149,106
2021,1,A,골목상권,1000390,갈현로1길,66,36,30
2021,1,A,골목상권,1000389,가좌로7길,329,203,126
2021,1,A,골목상권,1000388,한글비석로44길,232,95,137
2021,1,A,골목상권,1000387,한글비석로24길,180,62,118
2021,1,A,골목상권,1000386,한글비석로22길,172,92,80
2021,1,A,골목상권,1000385,석계로1길,605,255,350
2021,1,A,골목상권,1000384,상계로9가길,151,82,69
2021,1,A,골목상권,1000383,상계로1길,334,244,90
2021,1,A,골목상권,1000382,상계로12길,144,90,54
2021,1,A,골목상권,1000381,동일로242길,302,142,160
2021,1,A,골목상권,1000380,동일로192길,429,326,103
2021,1,A,골목상권,1000379,동일로173가길,1230,946,284
2021,1,A,골목상권,1000378,공릉로58길,129,61,68
2021,1,A,골목상권,1000377,해등로16길,285,134,151
2021,1,A,골목상권,1000376,우이천로4다길,125,83,42
2021,1,A,골목상권,1000375,우이천로32길,206,83,123
2021,1,A,골목상권,1000374,시루봉로23길,267,128,139
2021,1,A,골목상권,1000373,삼양로144길,50,24,26
2021,1,A,골목상권,1000372,방학로6가길,167,67,100
2021,1,A,골목상권,1000371,방학로5길,124,87,37
2021,1,A,골목상권,1000370,방학로15길,687,454,233
2021,1,A,골목상권,1000369,방학로10길,67,51,16
2021,1,A,골목상권,1000368,도봉산길,135,64,71
2021,1,A,골목상권,1000367,도봉산4길,27,24,3
2021,1,A,골목상권,1000366,도봉로181길,93,30,63
2021,1,A,골목상권,1000365,도봉로169나길,244,184,60
2021,1,A,골목상권,1000364,도봉로156길,93,62,31
2021,1,A,골목상권,1000363,도봉로152가길,342,311,31
2021,1,A,골목상권,1000362,도봉로147길,161,81,80
2021,1,A,골목상권,1000361,도봉로143길,73,48,25
2021,1,A,골목상권,1000360,도봉로114길,380,143,237
2021,1,A,골목상권,1000359,도봉로109길,276,223,53
2021,1,A,골목상권,1000358,도당로29길,518,292,226
2021,1,A,골목상권,1000357,도당로19길,597,66,531
2021,1,A,골목상권,1000356,도당로13바길,74,35,39
2021,1,A,골목상권,1000355,도당로13가길,36,21,15
2021,1,A,골목상권,1000354,덕릉로60길,177,126,51
2021,1,A,골목상권,1000353,노해로63다길,43,19,24
2021,1,A,골목상권,1000352,노해로60길,136,85,51
2021,1,A,골목상권,1000351,한천로140길,36,25,11
2021,1,A,골목상권,1000350,한천로139가길,108,47,61
2021,1,A,골목상권,1000349,한천로132길,56,31,25
2021,1,A,골목상권,1000348,한천로130길,91,69,22
2021,1,A,골목상권,1000347,한천로124나길,54,23,31
2021,1,A,골목상권,1000346,한천로109길,439,280,159
2021,1,A,골목상권,1000345,인수봉로79길,242,153,89
2021,1,A,골목상권,1000344,인수봉로72길,54,18,36
2021,1,A,골목상권,1000343,인수봉로56길,44,25,19
2021,1,A,골목상권,1000342,오패산로67길,238,89,149
2021,1,A,골목상권,1000341,오패산로52길,105,47,58
2021,1,A,골목상권,1000340,오패산로30길,13,5,8
2021,1,A,골목상권,1000339,수유로12길,281,199,82
2021,1,A,골목상권,1000338,솔샘로65길,284,66,218
2021,1,A,골목상권,1000337,솔매로50길,442,162,280
2021,1,A,골목상권,1000336,솔매로45길,65,32,33
2021,1,A,골목상권,1000335,솔매로41길,67,38,29
2021,1,A,골목상권,1000334,삼양로93길,209,94,115
2021,1,A,골목상권,1000333,삼양로77길,131,58,73
2021,1,A,골목상권,1000332,삼양로54길,295,66,229
2021,1,A,골목상권,1000331,삼양로41길,338,275,63
2021,1,A,골목상권,1000330,삼양로27길,7,4,3
2021,1,A,골목상권,1000329,삼양로24길,26,16,10
2021,1,A,골목상권,1000328,삼양로20길,179,168,11
2021,1,A,골목상권,1000327,삼각산로28길,70,33,37
2021,1,A,골목상권,1000326,도봉로99길,250,155,95
2021,1,A,골목상권,1000325,도봉로8길,6,4,2
2021,1,A,골목상권,1000324,도봉로76길,311,138,173
2021,1,A,골목상권,1000323,도봉로67길,116,57,59
2021,1,A,골목상권,1000322,도봉로45길,112,54,58
2021,1,A,골목상권,1000321,도봉로18길,225,182,43
2021,1,A,골목상권,1000320,도봉로13길,13,8,5
2021,1,A,골목상권,1000319,덕릉로41길,185,105,80
2021,1,A,골목상권,1000318,덕릉로40길,187,95,92
2021,1,A,골목상권,1000317,노해로33길,84,30,54
2021,1,A,골목상권,1000316,노해로23길,70,47,23
2021,1,A,골목상권,1000315,노해로17길,103,56,47
2021,1,A,골목상권,1000314,화랑로40길,71,46,25
2021,1,A,골목상권,1000313,화랑로32길,395,292,103
2021,1,A,골목상권,1000312,화랑로1길,1112,811,301
2021,1,A,골목상권,1000311,화랑로19길,43,19,24
2021,1,A,골목상권,1000310,화랑로14길,99,73,26
2021,1,A,골목상권,1000309,화랑로13길,267,95,172
2021,1,A,골목상권,1000308,한천로76길,132,100,32
2021,1,A,골목상권,1000307,한천로101가길,15,9,6
2021,1,A,골목상권,1000306,창경궁로43길,917,434,483
2021,1,A,골목상권,1000305,지봉로20길,3780,3162,618
2021,1,A,골목상권,1000304,종암로5길,404,201,203
2021,1,A,골목상권,1000303,종암로24가길,81,18,63
2021,1,A,골목상권,1000302,종암로21길,550,344,206
2021,1,A,골목상권,1000301,종암로19길,18269,9427,8842
2021,1,A,골목상권,1000300,종암로16길,140,61,79
2021,1,A,골목상권,1000299,정릉로8길,1407,1165,242
2021,1,A,골목상권,1000298,정릉로27길,75,30,45
2021,1,A,골목상권,1000297,정릉로26길,214,103,111
2021,1,A,골목상권,1000296,장위로50길,343,160,183
2021,1,A,골목상권,1000295,장월로1길,74,19,55
2021,1,A,골목상권,1000294,인촌로6길,195,131,64
2021,1,A,골목상권,1000293,인촌로5길,63,31,32
2021,1,A,골목상권,1000292,인촌로24길,1580,1010,570
2021,1,A,골목상권,1000291,개운사길,150,83,67
2021,1,A,골목상권,1000290,인촌로1길,127,78,49
2021,1,A,골목상권,1000289,인촌로17가길,90,48,42
2021,1,A,골목상권,1000288,오패산로4길,841,540,301
2021,1,A,골목상권,1000287,오패산로3길,310,187,123
2021,1,A,골목상권,1000286,오패산로19길,101,36,65
2021,1,A,골목상권,1000285,안암로5길,960,743,217
2021,1,A,골목상권,1000284,아리랑로4길,595,281,314
2021,1,A,골목상권,1000283,솔샘로6길,74,48,26
2021,1,A,골목상권,1000282,성북로8길,143,88,55
2021,1,A,골목상권,1000281,삼양로8길,147,70,77
2021,1,A,골목상권,1000280,삼선교로16가길,99,42,57
2021,1,A,골목상권,1000279,삼선교로10다길,38,17,21
2021,1,A,골목상권,1000278,삼선교로10길,186,110,76
2021,1,A,골목상권,1000277,보문로32길,267,128,139
2021,1,A,골목상권,1000276,보문로31길,253,128,125
2021,1,A,골목상권,1000275,보문로26길,134,62,72
2021,1,A,골목상권,1000274,보문로13길,1048,741,307
2021,1,A,골목상권,1000273,보국문로16길,181,97,84
2021,1,A,골목상권,1000272,동소문로6길,62,28,34
2021,1,A,골목상권,1000271,동소문로2길,53,21,32
2021,1,A,골목상권,1000270,동소문로26가길,219,122,97
2021,1,A,골목상권,1000269,동소문로15길,209,152,57
2021,1,A,골목상권,1000268,동소문로13길,572,285,287
2021,1,A,골목상권,1000267,돌곶이로8길,117,75,42
2021,1,A,골목상권,1000266,돌곶이로41길,40,13,27
2021,1,A,골목상권,1000265,돌곶이로28길,222,96,126
2021,1,A,골목상권,1000264,돌곶이로27길,103,59,44
2021,1,A,골목상권,1000263,돌곶이로22길,61,34,27
2021,1,A,골목상권,1000262,돌곶이로14길,77,58,19
2021,1,A,골목상권,1000261,길음로7길,14,5,9
2021,1,A,골목상권,1000260,중랑천로10길,207,109,98
2021,1,A,골목상권,1000259,용마산로94길,304,259,45
2021,1,A,골목상권,1000258,용마산로118길,108,63,45
2021,1,A,골목상권,1000257,용마산로112길,114,69,45
2021,1,A,골목상권,1000256,용마산로100길,122,52,70
2021,1,A,골목상권,1000255,신내로7가길,276,115,161
2021,1,A,골목상권,1000254,사가정로54길,122,47,75
2021,1,A,골목상권,1000253,사가정로42길,183,89,94
2021,1,A,골목상권,1000252,봉화산로56길,649,289,360
2021,1,A,골목상권,1000251,봉화산로4길,58,30,28
2021,1,A,골목상권,1000250,봉화산로30길,139,38,101
2021,1,A,골목상권,1000249,봉우재로33길,150,59,91
2021,1,A,골목상권,1000248,면목로78길,93,44,49
2021,1,A,골목상권,1000247,면목로56길,91,53,38
2021,1,A,골목상권,1000246,면목로55길,473,306,167
2021,1,A,골목상권,1000245,면목로49길,109,67,42
2021,1,A,골목상권,1000244,면목로48길,873,544,329
2021,1,A,골목상권,1000243,면목로45길,454,364,90
2021,1,A,골목상권,1000242,면목로33길,86,28,58
2021,1,A,골목상권,1000241,면목로21길,54,37,17
2021,1,A,골목상권,1000240,망우로73길,51,34,17
2021,1,A,골목상권,1000239,망우로68길,107,44,63
2021,1,A,골목상권,1000238,동일로163길,112,67,45
2021,1,A,골목상권,1000237,동일로157길,443,270,173
2021,1,A,골목상권,1000236,동일로149길,870,749,121
2021,1,A,골목상권,1000235,동일로140길,432,314,118
2021,1,A,골목상권,1000234,동일로139길,77,53,24
2021,1,A,골목상권,1000233,동일로139가길,187,81,106
2021,1,A,골목상권,1000232,동일로130길,130,99,31
2021,1,A,골목상권,1000231,동일로123길,145,74,71
2021,1,A,골목상권,1000230,동일로112길,193,120,73
2021,1,A,골목상권,1000229,동일로101길,202,58,144
2021,1,A,골목상권,1000228,동일로100길,328,240,88
2021,1,A,골목상권,1000227,답십리로75길,57,33,24
2021,1,A,골목상권,1000226,공릉로2길,148,69,79
2021,1,A,골목상권,1000225,공릉로12가길,75,50,25
2021,1,A,골목상권,1000224,겸재로54길,131,79,52
2021,1,A,골목상권,1000223,겸재로36길,134,60,74
2021,1,A,골목상권,1000222,겸재로29길,126,74,52
2021,1,A,골목상권,1000221,휘경로3길,127,69,58
2021,1,A,골목상권,1000220,휘경로2길,138,88,50
2021,1,A,골목상권,1000219,휘경로23길,89,56,33
2021,1,A,골목상권,1000218,휘경로14길,113,41,72
2021,1,A,골목상권,1000217,한천로46길,257,101,156
2021,1,A,골목상권,1000216,한천로40길,90,57,33
2021,1,A,골목상권,1000215,한천로33길,203,76,127
2021,1,A,골목상권,1000214,한천로14길,696,440,256
2021,1,A,골목상권,1000213,천호대로97길,878,590,288
2021,1,A,골목상권,1000212,천호대로77길,169,111,58
2021,1,A,골목상권,1000211,천호대로45길,47,38,9
2021,1,A,골목상권,1000210,천호대로17길,2512,1893,619
2021,1,A,골목상권,1000209,천호대로12길,55,35,20
2021,1,A,골목상권,1000208,천장산로7길,74,32,42
2021,1,A,골목상권,1000207,제기로5길,45,39,6
2021,1,A,골목상권,1000206,제기로21길,101,62,39
2021,1,A,골목상권,1000205,전농로4길,274,210,64
2021,1,A,골목상권,1000204,전농로3길,170,120,50
2021,1,A,골목상권,1000203,전농로29길,461,336,125
2021,1,A,골목상권,1000202,장한로8길,438,295,143
2021,1,A,골목상권,1000201,장한로5길,314,189,125
2021,1,A,골목상권,1000200,장한로27길,167,119,48
2021,1,A,골목상권,1000199,장한로27가길,148,81,67
2021,1,A,골목상권,1000198,장한로26길,2436,1696,740
2021,1,A,골목상권,1000197,장한로26가길,122,87,35
2021,1,A,골목상권,1000196,장한로25길,408,210,198
2021,1,A,골목상권,1000195,장한로14길,179,98,81
2021,1,A,골목상권,1000194,이문로42길,48,29,19
2021,1,A,골목상권,1000193,왕산로43길,560,199,361
2021,1,A,골목상권,1000192,왕산로33길,72,30,42
2021,1,A,골목상권,1000191,왕산로32길,129,64,65
2021,1,A,골목상권,1000190,약령시로17길,109,77,32
2021,1,A,골목상권,1000189,서울시립대로4길,404,264,140
2021,1,A,골목상권,1000188,서울시립대로29길,368,263,105
2021,1,A,골목상권,1000187,서울시립대로16길,42,14,28
2021,1,A,골목상권,1000186,사가정로2길,268,177,91
2021,1,A,골목상권,1000185,사가정로23가길,84,46,38
2021,1,A,골목상권,1000184,사가정로13길,180,65,115
2021,1,A,골목상권,1000183,무학로45길,227,141,86
2021,1,A,골목상권,1000182,무학로16길,574,441,133
2021,1,A,골목상권,1000181,망우로21길,96,67,29
2021,1,A,골목상권,1000180,망우로18길,52,17,35
2021,1,A,골목상권,1000179,망우로18가길,114,75,39
2021,1,A,골목상권,1000178,답십리로72길,54,20,34
2021,1,A,골목상권,1000177,답십리로69길,533,270,263
2021,1,A,골목상권,1000176,답십리로68길,287,158,129
2021,1,A,골목상권,1000175,답십리로64길,103,73,30
2021,1,A,골목상권,1000174,답십리로63길,1747,1051,696
2021,1,A,골목상권,1000173,답십리로60길,341,213,128
2021,1,A,골목상권,1000172,답십리로56길,78,39,39
2021,1,A,골목상권,1000171,답십리로23길,47,22,25
2021,1,A,골목상권,1000170,난계로30길,4980,2233,2747
2021,1,A,골목상권,1000169,경희대로4길,41,18,23
2021,1,A,골목상권,1000168,경희대로3길,28,16,12
2021,1,A,골목상권,1000167,천호대로129길,344,207,137
2021,1,A,골목상권,1000166,천호대로123길,625,282,343
2021,1,A,골목상권,1000165,천호대로109길,915,504,411
2021,1,A,골목상권,1000164,자양번영로3길,587,462,125
2021,1,A,골목상권,1000163,자양로53길,170,120,50
2021,1,A,골목상권,1000162,자양로50길,218,121,97
2021,1,A,골목상권,1000161,자양로45길,448,184,264
2021,1,A,골목상권,1000160,자양로26길,141,91,50
2021,1,A,골목상권,1000159,자양로15길,106,45,61
2021,1,A,골목상권,1000158,자양로11길,646,250,396
2021,1,A,골목상권,1000157,용마산로3길,541,431,110
2021,1,A,골목상권,1000156,용마산로21길,396,253,143
2021,1,A,골목상권,1000155,아차산로78길,575,421,154
2021,1,A,골목상권,1000154,아차산로65길,357,214,143
2021,1,A,골목상권,1000153,아차산로55길,243,150,93
2021,1,A,골목상권,1000152,아차산로51길,432,110,322
2021,1,A,골목상권,1000151,아차산로40길,357,207,150
2021,1,A,골목상권,1000150,면목로17길,230,138,92
2021,1,A,골목상권,1000149,뚝섬로64길,239,127,112
2021,1,A,골목상권,1000148,뚝섬로58길,278,141,137
2021,1,A,골목상권,1000147,뚝섬로54길,948,798,150
2021,1,A,골목상권,1000146,뚝섬로48길,228,134,94
2021,1,A,골목상권,1000145,뚝섬로24길,111,66,45
2021,1,A,골목상권,1000144,뚝섬로23길,209,148,61
2021,1,A,골목상권,1000143,동일로24길,42,32,10
2021,1,A,골목상권,1000142,동일로18길,79,54,25
2021,1,A,골목상권,1000141,능동로4길,947,834,113
2021,1,A,골목상권,1000140,능동로3길,71,45,26
2021,1,A,골목상권,1000139,능동로34길,1018,676,342
2021,1,A,골목상권,1000138,능동로19길,133,77,56
2021,1,A,골목상권,1000137,능동로13길,221,109,112
2021,1,A,골목상권,1000136,긴고랑로9길,138,51,87
2021,1,A,골목상권,1000135,긴고랑로8길,947,573,374
2021,1,A,골목상권,1000134,긴고랑로7길,460,353,107
2021,1,A,골목상권,1000133,긴고랑로20길,174,98,76
2021,1,A,골목상권,1000132,광나루로52길,649,395,254
2021,1,A,골목상권,1000131,광나루로40길,242,128,114
2021,1,A,골목상권,1000130,광나루로37길,60,29,31
2021,1,A,골목상권,1000129,광나루로36길,412,169,243
2021,1,A,골목상권,1000128,광나루로24길,25,12,13
2021,1,A,골목상권,1000127,광나루로12길,60,19,41
2021,1,A,골목상권,1000126,한림말길,355,174,181
2021,1,A,골목상권,1000125,한림말3길,3329,1128,2201
2021,1,A,골목상권,1000124,청계천로10나길,4951,3728,1223
2021,1,A,골목상권,1000123,장터길,90,46,44
2021,1,A,골목상권,1000122,용답중앙길,93,66,27
2021,1,A,골목상권,1000121,용답29길,537,360,177
2021,1,A,골목상권,1000120,왕십리로6길,538,350,188
2021,1,A,골목상권,1000119,왕십리로31길,208,95,113
2021,1,A,골목상권,1000118,왕십리로26길,2076,1357,719
2021,1,A,골목상권,1000117,왕십리로21길,164,77,87
2021,1,A,골목상권,1000116,왕십리로14길,997,776,221
2021,1,A,골목상권,1000115,아차산로5길,1871,1041,830
2021,1,A,골목상권,1000114,아차산로15길,3361,2374,987
2021,1,A,골목상권,1000113,아차산로11길,3213,2213,1000
2021,1,A,골목상권,1000112,송정4가길,291,123,168
2021,1,A,골목상권,1000111,송정12라길,94,48,46
2021,1,A,골목상권,1000110,성수일로6길,1342,928,414
2021,1,A,골목상권,1000109,성수이로7길,1442,895,547
2021,1,A,골목상권,1000108,성수이로18길,2988,1968,1020
2021,1,A,골목상권,1000107,성덕정길,227,152,75
2021,1,A,골목상권,1000106,성덕정17길,393,244,149
2021,1,A,골목상권,1000105,서울숲2길,335,196,139
2021,1,A,골목상권,1000104,상원길,1919,1334,585
2021,1,A,골목상권,1000103,상원12길,398,238,160
2021,1,A,골목상권,1000102,사근동길,78,48,30
2021,1,A,골목상권,1000101,무학봉길,22,11,11
2021,1,A,골목상권,1000100,무학봉28길,143,69,74
2021,1,A,골목상권,1000099,무학로6길,1897,382,1515
2021,1,A,골목상권,1000098,무수막길,164,122,42
2021,1,A,골목상권,1000097,매봉길,60,30,30
2021,1,A,골목상권,1000096,마조로1길,30,14,16
2021,1,A,골목상권,1000095,마조로16길,155,93,62
2021,1,A,골목상권,1000094,마장로39길,443,258,185
2021,1,A,골목상권,1000093,마장로27길,197,92,105
2021,1,A,골목상권,1000092,뚝섬로5길,2136,1426,710
2021,1,A,골목상권,1000091,둘레9길,419,255,164
2021,1,A,골목상권,1000090,금호산길,159,83,76
2021,1,A,골목상권,1000089,금호산2길,22,12,10
2021,1,A,골목상권,1000088,고산자로6길,704,495,209
2021,1,A,골목상권,1000087,후암로28길,582,313,269
2021,1,A,골목상권,1000086,효창원로39길,163,87,76
2021,1,A,골목상권,1000085,회나무로13길,90,45,45
2021,1,A,골목상권,1000084,한남대로20길,231,131,100
2021,1,A,골목상권,1000083,한강대로88길,224,138,86
2021,1,A,골목상권,1000082,한강대로7길,722,462,260
2021,1,A,골목상권,1000081,한강대로62길,1047,535,512
2021,1,A,골목상권,1000080,한강대로52길,8713,2847,5866
2021,1,A,골목상권,1000079,한강대로43길,1841,1074,767
2021,1,A,골목상권,1000078,한강대로15길,774,417,357
2021,1,A,골목상권,1000077,한강대로104길,8152,1754,6398
2021,1,A,골목상권,1000076,청파로73길,248,128,120
2021,1,A,골목상권,1000075,청파로71길,1317,727,590
2021,1,A,골목상권,1000074,청파로47나길,259,176,83
2021,1,A,골목상권,1000073,청파로47길,192,87,105
2021,1,A,골목상권,1000072,장문로45길,242,106,136
2021,1,A,골목상권,1000071,이태원로54길,812,552,260
2021,1,A,골목상권,1000070,이태원로27길,567,430,137
2021,1,A,골목상권,1000069,이촌로22길,385,307,78
2021,1,A,골목상권,1000068,원효로89길,1387,969,418
2021,1,A,골목상권,1000067,원효로53길,341,222,119
2021,1,A,골목상권,1000066,원효로41길,243,153,90
2021,1,A,골목상권,1000065,원효로19길,609,435,174
2021,1,A,골목상권,1000064,우사단로4길,308,143,165
2021,1,A,골목상권,1000063,우사단로14길,1987,984,1003
2021,1,A,골목상권,1000062,우사단로10길,570,508,62
2021,1,A,골목상권,1000061,신흥로20길,178,118,60
2021,1,A,골목상권,1000060,소월로20길,151,76,75
2021,1,A,골목상권,1000059,서빙고로71길,432,265,167
2021,1,A,골목상권,1000058,백범로90길,535,288,247
2021,1,A,골목상권,1000057,백범로79길,899,560,339
2021,1,A,골목상권,1000056,두텁바위로1길,1111,483,628
2021,1,A,골목상권,1000055,대사관로34길,606,393,213
2021,1,A,골목상권,1000054,녹사평대로46길,43,19,24
2021,1,A,골목상권,1000053,녹사평대로40나길,46,21,25
2021,1,A,골목상권,1000052,녹사평대로32길,56,31,25
2021,1,A,골목상권,1000051,녹사평대로26길,494,230,264
2021,1,A,골목상권,1000050,녹사평대로11길,107,78,29
2021,1,A,골목상권,1000049,퇴계로90길,463,225,238
2021,1,A,골목상권,1000048,퇴계로8길,438,246,192
2021,1,A,골목상권,1000047,퇴계로56길,569,424,145
2021,1,A,골목상권,1000046,퇴계로46길,1098,613,485
2021,1,A,골목상권,1000045,퇴계로18길,967,435,532
2021,1,A,골목상권,1000044,퇴계로12길,180,103,77
2021,1,A,골목상권,1000043,청구로1길,108,72,36
2021,1,A,골목상권,1000042,청구로17길,485,306,179
2021,1,A,골목상권,1000041,장충단로8길,3778,1997,1781
2021,1,A,골목상권,1000040,삼일대로4길,1571,1113,458
2021,1,A,골목상권,1000039,명동길,7830,4550,3280
2021,1,A,골목상권,1000038,동호로8길,386,160,226
2021,1,A,골목상권,1000037,동호로20길,2429,1304,1125
2021,1,A,골목상권,1000036,동호로15길,1161,835,326
2021,1,A,골목상권,1000035,동호로11길,337,208,129
2021,1,A,골목상권,1000034,동호로10길,1553,857,696
2021,1,A,골목상권,1000033,다산로39길,39,19,20
2021,1,A,골목상권,1000032,다산로38길,674,311,363
2021,1,A,골목상권,1000031,다산로36길,91,55,36
2021,1,A,골목상권,1000030,다산로33길,320,201,119
2021,1,A,골목상권,1000029,난계로21길,128,93,35
2021,1,A,골목상권,1000028,난계로11길,255,170,85
2021,1,A,골목상권,1000027,필운대로1길,202,62,140
2021,1,A,골목상권,1000026,평창길,6654,2605,4049
2021,1,A,골목상권,1000025,통일로12길,13,6,7
2021,1,A,골목상권,1000024,창신길,146,29,117
2021,1,A,골목상권,1000023,창신5길,15,7,8
2021,1,A,골목상권,1000022,창신2길,56,26,30
2021,1,A,골목상권,1000021,창경궁로35길,787,171,616
2021,1,A,골목상권,1000020,지봉로8길,183,90,93
2021,1,A,골목상권,1000019,종로65길,275,157,118
2021,1,A,골목상권,1000018,종로58가길,137,71,66
2021,1,A,골목상권,1000017,종로24길,1011,716,295
2021,1,A,골목상권,1000016,자하문로7길,214,83,131
2021,1,A,골목상권,1000015,이화장길,497,221,276
2021,1,A,골목상권,1000014,율곡로16길,235,143,92
2021,1,A,골목상권,1000013,율곡로10길,313,206,107
2021,1,A,골목상권,1000012,옥인길,58,32,26
2021,1,A,골목상권,1000011,숭인동길,329,133,196
2021,1,A,골목상권,1000010,성균관로5길,148,84,64
2021,1,A,골목상권,1000009,삼청로5길,2703,2626,77
2021,1,A,골목상권,1000008,북촌로5나길,234,113,121
2021,1,A,골목상권,1000007,북촌로5길,503,419,84
2021,1,A,골목상권,1000006,북촌로11길,671,232,439
2021,1,A,골목상권,1000005,백석동길,1797,1066,731
2021,1,A,골목상권,1000004,명륜길,56,32,24
2021,1,A,골목상권,1000003,돈화문로11가길,3686,2700,986
2021,1,A,골목상권,1000002,난계로27길,201,114,87
2021,1,A,골목상권,1000001,계동길,842,388,454
2020,4,U,관광특구,1001496,강남 마이스 관광특구,15904,8904,7000
2020,4,U,관광특구,1001495,잠실 관광특구,24375,14199,10176
2020,4,U,관광특구,1001494,종로?청계 관광특구,32935,17150,15785
2020,4,U,관광특구,1001493,동대문패션타운 관광특구,6054,2958,3096
2020,4,U,관광특구,1001492,명동 남대문 북창동 다동 무교동 관광특구,104830,53674,51156
2020,4,U,관광특구,1001491,이태원 관광특구,5839,3064,2775
2020,4,R,전통시장,1001490,길동복조리시장,430,242,188
2020,4,R,전통시장,1001489,둔촌역전통시장,224,108,116
2020,4,R,전통시장,1001488,성내골목시장,30,18,12
2020,4,R,전통시장,1001487,천호시장,35,19,16
2020,4,R,전통시장,1001486,동서울시장,5,3,2
2020,4,R,전통시장,1001484,양지골목시장,60,36,24
2020,4,R,전통시장,1001483,암사종합시장,95,53,42
2020,4,R,전통시장,1001482,고덕전통시장,935,850,85
2020,4,R,전통시장,1001481,명일골목시장,89,30,59
2020,4,R,전통시장,1001480,새마을시장,208,122,86
2020,4,R,전통시장,1001479,석촌시장,286,99,187
2020,4,R,전통시장,1001478,방이시장,3469,1526,1943
2020,4,R,전통시장,1001477,마천시장,102,70,32
2020,4,R,전통시장,1001476,풍납시장,51,20,31
2020,4,R,전통시장,1001475,강남개포시장,138,84,54
2020,4,R,전통시장,1001474,도곡시장,57,25,32
2020,4,R,전통시장,1001473,청담삼익시장,48,30,18
2020,4,R,전통시장,1001472,논현종합시장,85,43,42
2020,4,R,전통시장,1001471,영동전통시장,242,95,147
2020,4,R,전통시장,1001470,강남시장_강남,58,33,25
2020,4,R,전통시장,1001469,양재시장,35,22,13
2020,4,R,전통시장,1001468,남부종합시장,85,63,22
2020,4,R,전통시장,1001467,우림시장,1,0,1
2020,4,R,전통시장,1001466,미성동도깨비시장,75,16,59
2020,4,R,전통시장,1001463,신림중앙시장,43,27,16
2020,4,R,전통시장,1001462,강남골목시장,168,124,44
2020,4,R,전통시장,1001461,신림종합시장,8,7,1
2020,4,R,전통시장,1001460,관악신사시장,120,63,57
2020,4,R,전통시장,1001459,신원시장,42,21,21
2020,4,R,전통시장,1001458,인헌시장,122,46,76
2020,4,R,전통시장,1001457,봉천중앙시장,154,42,112
2020,4,R,전통시장,1001455,봉일시장,44,23,21
2020,4,R,전통시장,1001454,봉천제일종합시장,6,1,5
2020,4,R,전통시장,1001453,낙성대시장,10,6,4
2020,4,R,전통시장,1001452,중부시장,102,40,62
2020,4,R,전통시장,1001451,사당시장,45,20,25
2020,4,R,전통시장,1001450,남성역골목시장,467,268,199
2020,4,R,전통시장,1001449,남성사계시장,136,59,77
2020,4,R,전통시장,1001448,흑석시장,78,31,47
2020,4,R,전통시장,1001447,상도4동도깨비골목시장,95,49,46
2020,4,R,전통시장,1001446,성대시장,141,55,86
2020,4,R,전통시장,1001445,영도시장,73,6,67
2020,4,R,전통시장,1001444,상도전통시장,239,104,135
2020,4,R,전통시장,1001442,신노량진시장,11,3,8
2020,4,R,전통시장,1001441,본동인정시장,59,41,18
2020,4,R,전통시장,1001440,노량진중앙시장,244,157,87
2020,4,R,전통시장,1001439,대림중앙시장,42,29,13
2020,4,R,전통시장,1001438,우리시장,6,5,1
2020,4,R,전통시장,1001436,사러가시장,57,35,22
2020,4,R,전통시장,1001435,대신시장,12,9,3
2020,4,R,전통시장,1001433,영일시장,155,115,40
2020,4,R,전통시장,1001432,도림시장,6,4,2
2020,4,R,전통시장,1001431,영등포청과시장,23,17,6
2020,4,R,전통시장,1001430,영등포전통시장,2127,1061,1066
2020,4,R,전통시장,1001429,은행나무시장,67,40,27
2020,4,R,전통시장,1001428,박미시장,39,26,13
2020,4,R,전통시장,1001427,현대시장,139,42,97
2020,4,R,전통시장,1001426,대명시장,28,11,17
2020,4,R,전통시장,1001425,푸른터시장,3,2,1
2020,4,R,전통시장,1001424,남문시장,76,47,29
2020,4,R,전통시장,1001423,독산동 우시장,611,476,135
2020,4,R,전통시장,1001422,오류시장,132,21,111
2020,4,R,전통시장,1001421,개봉중앙시장,10,7,3
2020,4,R,전통시장,1001420,고척근린시장,55,19,36
2020,4,R,전통시장,1001418,남구로시장,236,135,101
2020,4,R,전통시장,1001417,구로시장,10,5,5
2020,4,R,전통시장,1001415,방신전통시장,116,81,35
2020,4,R,전통시장,1001414,송화골목시장,119,44,75
2020,4,R,전통시장,1001413,까치산시장,114,35,79
2020,4,R,전통시장,1001412,화곡본동시장,36,16,20
2020,4,R,전통시장,1001411,남부골목시장,156,58,98
2020,4,R,전통시장,1001410,대원종합시장,9,7,2
2020,4,R,전통시장,1001409,화곡중앙골목시장,75,32,43
2020,4,R,전통시장,1001408,신월중앙시장,118,53,65
2020,4,R,전통시장,1001406,신정3동골목시장,123,81,42
2020,4,R,전통시장,1001405,신정2동골목시장,41,13,28
2020,4,R,전통시장,1001404,신정제일시장,38,21,17
2020,4,R,전통시장,1001403,신월7동골목시장,24,16,8
2020,4,R,전통시장,1001402,신월6동골목시장,141,103,38
2020,4,R,전통시장,1001400,신월3동골목시장,12,7,5
2020,4,R,전통시장,1001399,경창시장,53,23,30
2020,4,R,전통시장,1001398,월정로시장,61,42,19
2020,4,R,전통시장,1001397,신영시장,40,13,27
2020,4,R,전통시장,1001396,목4동시장,52,35,17
2020,4,R,전통시장,1001395,목3동시장,148,67,81
2020,4,R,전통시장,1001394,목2동시장,432,251,181
2020,4,R,전통시장,1001393,마포농수산물시장,77,40,37
2020,4,R,전통시장,1001392,동진시장,10,6,4
2020,4,R,전통시장,1001391,망원월드컵시장,190,123,67
2020,4,R,전통시장,1001390,망원시장,173,81,92
2020,4,R,전통시장,1001388,영진시장,29,14,15
2020,4,R,전통시장,1001387,서교시장,24,10,14
2020,4,R,전통시장,1001386,신수시장,34,19,15
2020,4,R,전통시장,1001385,아현시장,803,430,373
2020,4,R,전통시장,1001384,마포시장,11,3,8
2020,4,R,전통시장,1001383,공덕시장,3948,2001,1947
2020,4,R,전통시장,1001382,백련시장,5,3,2
2020,4,R,전통시장,1001381,모래내시장,14,9,5
2020,4,R,전통시장,1001380,포방터시장,35,23,12
2020,4,R,전통시장,1001379,인왕시장,44,7,37
2020,4,R,전통시장,1001378,아현가구거리상점가,45,22,23
2020,4,R,전통시장,1001377,영천시장,35,19,16
2020,4,R,전통시장,1001376,수일시장,7,2,5
2020,4,R,전통시장,1001375,증산종합시장,8,5,3
2020,4,R,전통시장,1001374,대림골목시장,237,46,191
2020,4,R,전통시장,1001373,신응암시장,17,10,7
2020,4,R,전통시장,1001372,녹번시장,22,9,13
2020,4,R,전통시장,1001371,대조시장,15,7,8
2020,4,R,전통시장,1001370,역촌중앙시장,9,3,6
2020,4,R,전통시장,1001369,갈현시장,287,186,101
2020,4,R,전통시장,1001368,연서시장,206,144,62
2020,4,R,전통시장,1001367,상계중앙시장,105,59,46
2020,4,R,전통시장,1001366,상계시장,8,2,6
2020,4,R,전통시장,1001365,공릉동도깨비시장,98,47,51
2020,4,R,전통시장,1001364,방학동도깨비시장,39,16,23
2020,4,R,전통시장,1001363,쌍문역골목시장,61,14,47
2020,4,R,전통시장,1001362,백운시장,33,14,19
2020,4,R,전통시장,1001361,신도봉시장,5,5,0
2020,4,R,전통시장,1001360,창동골목시장,84,47,37
2020,4,R,전통시장,1001359,창동신창시장,104,40,64
2020,4,R,전통시장,1001358,수유북부시장,20,14,6
2020,4,R,전통시장,1001357,장미원골목시장,911,571,340
2020,4,R,전통시장,1001356,수유중앙시장,13,8,5
2020,4,R,전통시장,1001355,강북종합시장,23,9,14
2020,4,R,전통시장,1001354,우이시장,69,61,8
2020,4,R,전통시장,1001353,수유전통시장,231,55,176
2020,4,R,전통시장,1001352,번동북부골목시장,50,25,25
2020,4,R,전통시장,1001351,솔샘시장,73,30,43
2020,4,R,전통시장,1001350,숭인시장,62,27,35
2020,4,R,전통시장,1001349,방천골목시장,92,55,37
2020,4,R,전통시장,1001348,동북시장,121,49,72
2020,4,R,전통시장,1001347,석관황금시장,191,157,34
2020,4,R,전통시장,1001345,새석관시장,3,1,2
2020,4,R,전통시장,1001343,장위전통시장,40,20,20
2020,4,R,전통시장,1001342,밤나무골시장,17,5,12
2020,4,R,전통시장,1001341,길음시장,91,19,72
2020,4,R,전통시장,1001340,정릉시장,131,72,59
2020,4,R,전통시장,1001339,정릉아리랑시장,22,7,15
2020,4,R,전통시장,1001338,돈암제일시장,97,22,75
2020,4,R,전통시장,1001337,유영시장,31,20,11
2020,4,R,전통시장,1001336,우림골목시장,344,118,226
2020,4,R,전통시장,1001335,묵1동도깨비시장,35,24,11
2020,4,R,전통시장,1001334,태능시장,81,34,47
2020,4,R,전통시장,1001333,중화제일시장,69,30,39
2020,4,R,전통시장,1001332,사가정시장,86,28,58
2020,4,R,전통시장,1001331,면목골목시장,45,21,24
2020,4,R,전통시장,1001330,동원시장,224,109,115
2020,4,R,전통시장,1001329,동부골목시장,179,59,120
2020,4,R,전통시장,1001327,이경시장,16,8,8
2020,4,R,전통시장,1001326,회기시장,55,17,38
2020,4,R,전통시장,1001325,청량리청과물시장,12,9,3
2020,4,R,전통시장,1001324,전곡시장,77,42,35
2020,4,R,전통시장,1001323,답십리시장,93,40,53
2020,4,R,전통시장,1001322,동부시장,14,9,5
2020,4,R,전통시장,1001321,답십리현대시장,36,31,5
2020,4,R,전통시장,1001320,전농로터리시장,7,3,4
2020,4,R,전통시장,1001319,청량리종합시장,13,8,5
2020,4,R,전통시장,1001318,청량리전통시장,9,7,2
2020,4,R,전통시장,1001316,서울약령시장,1171,642,529
2020,4,R,전통시장,1001315,동서시장,5,3,2
2020,4,R,전통시장,1001314,경동시장,130,61,69
2020,4,R,전통시장,1001313,청량리수산시장,20,11,9
2020,4,R,전통시장,1001312,용두시장,4,2,2
2020,4,R,전통시장,1001309,조양시장,31,19,12
2020,4,R,전통시장,1001308,영동교골목시장,41,30,11
2020,4,R,전통시장,1001307,능동로골목시장,56,42,14
2020,4,R,전통시장,1001306,노룬산골목시장,23,13,10
2020,4,R,전통시장,1001305,자양종합시장,14,10,4
2020,4,R,전통시장,1001304,자양골목시장,54,36,18
2020,4,R,전통시장,1001303,신성골목시장,19,6,13
2020,4,R,전통시장,1001302,면곡골목시장,49,35,14
2020,4,R,전통시장,1001301,중곡제일시장,111,68,43
2020,4,R,전통시장,1001300,화양제일골목시장,43,11,32
2020,4,R,전통시장,1001299,한아름시장,40,29,11
2020,4,R,전통시장,1001298,성동용답상가시장,66,33,33
2020,4,R,전통시장,1001297,뚝도시장,45,17,28
2020,4,R,전통시장,1001296,금남시장,36,13,23
2020,4,R,전통시장,1001295,행당시장,314,140,174
2020,4,R,전통시장,1001294,마장축산물시장,532,358,174
2020,4,R,전통시장,1001293,보광시장,31,12,19
2020,4,R,전통시장,1001292,이태원제일시장,2,1,1
2020,4,R,전통시장,1001291,이태원시장,32,20,12
2020,4,R,전통시장,1001290,이촌종합시장,109,78,31
2020,4,R,전통시장,1001289,용문전통시장,19,10,9
2020,4,R,전통시장,1001288,만리시장,12,9,3
2020,4,R,전통시장,1001287,신흥시장,4,1,3
2020,4,R,전통시장,1001286,후암시장,15,14,1
2020,4,R,전통시장,1001285,합동(새벽)시장,365,209,156
2020,4,R,전통시장,1001284,서울중앙시장,451,320,131
2020,4,R,전통시장,1001283,백학시장,95,43,52
2020,4,R,전통시장,1001282,약수시장,271,105,166
2020,4,R,전통시장,1001281,청평화시장,120,50,70
2020,4,R,전통시장,1001280,제일평화시장,53,29,24
2020,4,R,전통시장,1001279,동평화시장,178,121,57
2020,4,R,전통시장,1001278,남평화시장,5,3,2
2020,4,R,전통시장,1001277,방산종합시장,1190,736,454
2020,4,R,전통시장,1001276,평화시장,906,614,292
2020,4,R,전통시장,1001275,인현시장,167,123,44
2020,4,R,전통시장,1001274,신중부시장,3089,921,2168
2020,4,R,전통시장,1001273,남대문시장,8186,3966,4220
2020,4,R,전통시장,1001272,신설종합시장,50,37,13
2020,4,R,전통시장,1001271,동묘시장,474,223,251
2020,4,R,전통시장,1001270,창신골목시장,13,7,6
2020,4,R,전통시장,1001269,동문시장,3,1,2
2020,4,R,전통시장,1001268,충신시장,77,40,37
2020,4,R,전통시장,1001267,종로신진시장,158,89,69
2020,4,R,전통시장,1001266,동대문종합시장,1319,965,354
2020,4,R,전통시장,1001265,광장시장,444,301,143
2020,4,R,전통시장,1001264,통인시장,59,29,30
2020,4,D,발달상권,1001263,서울 노원구 노원역_3,418,159,259
2020,4,D,발달상권,1001262,서울 노원구 노원역_2,274,126,148
2020,4,D,발달상권,1001261,서울 노원구 노원역_1,336,86,250
2020,4,D,발달상권,1001260,창동역,1003,570,433
2020,4,D,발달상권,1001259,서울 강북구 수유역_3,70,36,34
2020,4,D,발달상권,1001258,등나무근린공원 주변,65,19,46
2020,4,D,발달상권,1001257,서울 강북구 수유역_2,2284,1108,1176
2020,4,D,발달상권,1001256,서울 강북구 수유역_1,831,408,423
2020,4,D,발달상권,1001255,서울 은평구 연신내역_3,108,20,88
2020,4,D,발달상권,1001254,서울 은평구 연신내역_2,555,168,387
2020,4,D,발달상권,1001253,서울 은평구 연신내역_1,70,25,45
2020,4,D,발달상권,1001252,서울 성북구 미아삼거리역_2,322,144,178
2020,4,D,발달상권,1001251,서울 강북구 미아삼거리역_1,140,86,54
2020,4,D,발달상권,1001250,서울 은평구 불광역_3,67,24,43
2020,4,D,발달상권,1001249,서울 은평구 불광역_2,116,39,77
2020,4,D,발달상권,1001248,서울 은평구 불광역_1,180,73,107
2020,4,D,발달상권,1001247,미아사거리_2,102,47,55
2020,4,D,발달상권,1001246,미아사거리_1,210,68,142
2020,4,D,발달상권,1001245,서울 성북구 성신여대입구역,2865,1629,1236
2020,4,D,발달상권,1001244,경희대학교,70,24,46
2020,4,D,발달상권,1001243,서울 성북구 안암역,59,28,31
2020,4,D,발달상권,1001242,혜화역 대학로_3,477,210,267
2020,4,D,발달상권,1001241,혜화역 대학로_2,334,256,78
2020,4,D,발달상권,1001240,혜화역 대학로_1,1230,573,657
2020,4,D,발달상권,1001239,디지털미디어시티,6727,3880,2847
2020,4,D,발달상권,1001238,서울 동대문구 청량리역,776,413,363
2020,4,D,발달상권,1001237,서울 종로구 경복궁역_2,239,107,132
2020,4,D,발달상권,1001236,서울 종로구 안국역_2,810,409,401
2020,4,D,발달상권,1001235,서울 종로구 안국역_1,8804,7324,1480
2020,4,D,발달상권,1001234,서울 종로구 경복궁역_1,599,413,186
2020,4,D,발달상권,1001233,서울 종로구 종로3가역_3,2136,1442,694
2020,4,D,발달상권,1001232,서울 종로구 종로3가역_2,1823,948,875
2020,4,D,발달상권,1001231,서울 동대문구 신설동역_2,5440,2247,3193
2020,4,D,발달상권,1001230,인사동,26072,14829,11243
2020,4,D,발달상권,1001229,서울 종로구 종로5가역_4,1358,810,548
2020,4,D,발달상권,1001228,서울 종로구 종로5가역_3,1766,1160,606
2020,4,D,발달상권,1001227,종로구청,20709,10947,9762
2020,4,D,발달상권,1001226,서울 종로구 종로5가역_2,16173,10184,5989
2020,4,D,발달상권,1001225,신설동역,118,54,64
2020,4,D,발달상권,1001224,서울 동대문구 신설동역_1,1543,677,866
2020,4,D,발달상권,1001223,서울 종로구 광화문역_2,27999,17199,10800
2020,4,D,발달상권,1001222,동묘앞역,223,138,85
2020,4,D,발달상권,1001221,장안동사거리,1587,632,955
2020,4,D,발달상권,1001220,서울 종로구 동대문역_2,748,244,504
2020,4,D,발달상권,1001219,서울 종로구 동대문역_1,28,17,11
2020,4,D,발달상권,1001218,동대문시장_2,195,123,72
2020,4,D,발달상권,1001217,서울 종로구 종로5가역_1,22,9,13
2020,4,D,발달상권,1001216,서울 종로구 종로3가역_1,2657,1167,1490
2020,4,D,발달상권,1001215,서울 종로구 광화문역_1,12759,8498,4261
2020,4,D,발달상권,1001214,종각역,10396,8086,2310
2020,4,D,발달상권,1001213,종각역 젊음의 거리,13040,3576,9464
2020,4,D,발달상권,1001212,서대문구 서대문역_1,99,67,32
2020,4,D,발달상권,1001211,동대문시장_1,1663,493,1170
2020,4,D,발달상권,1001210,시청역_2,14646,9603,5043
2020,4,D,발달상권,1001209,서울시청,9257,4890,4367
2020,4,D,발달상권,1001208,서울 중구 을지로3가역_2,3181,2166,1015
2020,4,D,발달상권,1001207,서울 중구 신당역_2,939,534,405
2020,4,D,발달상권,1001206,서대문구 서대문역_2,1486,1018,468
2020,4,D,발달상권,1001205,동대문역사문화공원역,3166,2548,618
2020,4,D,발달상권,1001204,서울 중구 을지로3가역_1,4549,2258,2291
2020,4,D,발달상권,1001203,명동거리,8147,4244,3903
2020,4,D,발달상권,1001202,롯데백화점,27149,9657,17492
2020,4,D,발달상권,1001201,서울 중구 신당역_1,277,142,135
2020,4,D,발달상권,1001200,북창동,5197,3160,2037
2020,4,D,발달상권,1001199,서울 중구 충무로역_2,16329,7851,8478
2020,4,D,발달상권,1001198,서울 강서구 송정역,335,140,195
2020,4,D,발달상권,1001197,장한평역_2,1492,995,497
2020,4,D,발달상권,1001196,시청역_1,24904,15705,9199
2020,4,D,발달상권,1001195,왕십리역_2,233,102,131
2020,4,D,발달상권,1001194,서울 강서구 발산역,983,431,552
2020,4,D,발달상권,1001193,장한평역_1,1129,748,381
2020,4,D,발달상권,1001192,서울 중구 충무로역_1,3743,2160,1583
2020,4,D,발달상권,1001191,왕십리역_1,8,2,6
2020,4,D,발달상권,1001190,장한평역,3644,2178,1466
2020,4,D,발달상권,1001189,서울 중구 명동역,3595,1952,1643
2020,4,D,발달상권,1001188,장충동 족발거리,2100,985,1115
2020,4,D,발달상권,1001187,한양시장,55,30,25
2020,4,D,발달상권,1001186,서울 서대문구 이대역,380,160,220
2020,4,D,발달상권,1001185,서울 서대문구 신촌역,924,404,520
2020,4,D,발달상권,1001184,서울 마포구 홍대입구역_3,659,386,273
2020,4,D,발달상권,1001183,서울 마포구 홍대입구역_2,977,535,442
2020,4,D,발달상권,1001182,홍익대학교 주변,8725,5062,3663
2020,4,D,발달상권,1001181,서울 광진구 군자역,621,342,279
2020,4,D,발달상권,1001180,신촌역,4403,2012,2391
2020,4,D,발달상권,1001179,강서구청,4278,2468,1810
2020,4,D,발달상권,1001178,서울 마포구 홍대입구역_1,1618,826,792
2020,4,D,발달상권,1001177,서울 중구 약수역_2,210,91,119
2020,4,D,발달상권,1001176,서울 중구 약수역_1,24,6,18
2020,4,D,발달상권,1001175,서울 강동구 고덕역,1359,916,443
2020,4,D,발달상권,1001174,등촌역,64,37,27
2020,4,D,발달상권,1001173,서울 강동구 명일역,671,252,419
2020,4,D,발달상권,1001172,어린이대공원역,41,17,24
2020,4,D,발달상권,1001171,서울 마포구 공덕역_2,3697,2404,1293
2020,4,D,발달상권,1001170,공덕역,2092,1198,894
2020,4,D,발달상권,1001169,서울 용산구 숙대입구역,3807,1436,2371
2020,4,D,발달상권,1001168,남영역,4055,2796,1259
2020,4,D,발달상권,1001167,서울 마포구 공덕역_1,2420,796,1624
2020,4,D,발달상권,1001166,서울 마포구 마포역_2,10151,6130,4021
2020,4,D,발달상권,1001165,서울 광진구 건대입구역_2,529,268,261
2020,4,D,발달상권,1001164,서울 마포구 마포역_1,3369,2292,1077
2020,4,D,발달상권,1001163,서울 강동구 천호역_2,1208,565,643
2020,4,D,발달상권,1001162,서울 광진구 건대입구역_1,109,52,57
2020,4,D,발달상권,1001161,건대입구역,24,11,13
2020,4,D,발달상권,1001160,서울 광진구 구의역,928,584,344
2020,4,D,발달상권,1001159,서울 강동구 천호역,259,93,166
2020,4,D,발달상권,1001158,당산역_2,1429,1069,360
2020,4,D,발달상권,1001157,서울 강동구 천호역_1,138,57,81
2020,4,D,발달상권,1001156,서울 강동구 길동역,2628,1190,1438
2020,4,D,발달상권,1001155,용산 전자상가_5,1976,1461,515
2020,4,D,발달상권,1001154,용산 전자상가_4,248,182,66
2020,4,D,발달상권,1001153,당산역_1,310,186,124
2020,4,D,발달상권,1001152,서울 광진구 강변역,1337,859,478
2020,4,D,발달상권,1001151,용산 전자상가_3,1752,1311,441
2020,4,D,발달상권,1001150,서울 용산구 이태원역,452,292,160
2020,4,D,발달상권,1001149,한남오거리,823,524,299
2020,4,D,발달상권,1001148,목동사거리,41,13,28
2020,4,D,발달상권,1001147,용산 전자상가_2,392,317,75
2020,4,D,발달상권,1001146,용산구청,1526,755,771
2020,4,D,발달상권,1001145,용산 전자상가_1,3893,2851,1042
2020,4,D,발달상권,1001144,국회의사당역_2,19439,11619,7820
2020,4,D,발달상권,1001143,서울 용산구 신용산역,979,675,304
2020,4,D,발달상권,1001142,국회의사당역_1,4563,3517,1046
2020,4,D,발달상권,1001141,압구정 로데오거리_2,7107,2323,4784
2020,4,D,발달상권,1001140,서울 강남구 압구정역,9345,4345,5000
2020,4,D,발달상권,1001139,서울 영등포구 영등포구청역,449,275,174
2020,4,D,발달상권,1001138,압구정 로데오거리_1,14564,7168,7396
2020,4,D,발달상권,1001137,서울 강동구 둔촌동역,250,102,148
2020,4,D,발달상권,1001136,오목교역,125,72,53
2020,4,D,발달상권,1001135,신사동 가로수길,14671,7582,7089
2020,4,D,발달상권,1001134,서울 영등포구 여의도역_2,33585,23274,10311
2020,4,D,발달상권,1001133,청담사거리_3,1376,693,683
2020,4,D,발달상권,1001132,영등포유통상가,1504,962,542
2020,4,D,발달상권,1001131,청담역_2,4142,3212,930
2020,4,D,발달상권,1001130,청담역_1,4062,2913,1149
2020,4,D,발달상권,1001129,청담사거리_2,1289,759,530
2020,4,D,발달상권,1001128,청담사거리_1,529,295,234
2020,4,D,발달상권,1001127,서울 영등포구 여의도역_1,27015,17171,9844
2020,4,D,발달상권,1001126,서울 양천구 신정네거리역_2,28,18,10
2020,4,D,발달상권,1001125,학동사거리_2,2498,1332,1166
2020,4,D,발달상권,1001124,서울 영등포구 영등포시장역,411,246,165
2020,4,D,발달상권,1001123,학동사거리_1,4075,2555,1520
2020,4,D,발달상권,1001122,여의도 시범아파트앞,10435,6976,3459
2020,4,D,발달상권,1001121,영등포역_3,121,70,51
2020,4,D,발달상권,1001120,도산공원사거리_1,4075,1954,2121
2020,4,D,발달상권,1001119,영등포역_2,583,245,338
2020,4,D,발달상권,1001118,문래동 주민센터,6184,3312,2872
2020,4,D,발달상권,1001117,강남구 신사역_2,6953,3586,3367
2020,4,D,발달상권,1001116,영등포역_1,77,27,50
2020,4,D,발달상권,1001115,서울 강남구 강남구청역_2,3172,1916,1256
2020,4,D,발달상권,1001114,강남구 신사역_1,1108,570,538
2020,4,D,발달상권,1001113,서울 동작구 노량진1동_1,40,25,15
2020,4,D,발달상권,1001112,서울 강남구 학동역_3,3152,1780,1372
2020,4,D,발달상권,1001111,서울 강남구 강남구청역_1,3516,2335,1181
2020,4,D,발달상권,1001110,잠실역,42527,22605,19922
2020,4,D,발달상권,1001109,강남구 논현역_4,4927,2720,2207
2020,4,D,발달상권,1001108,학동역,1014,616,398
2020,4,D,발달상권,1001107,방이동 먹자골목,6881,4444,2437
2020,4,D,발달상권,1001106,서울 강남구 학동역_2,2510,1674,836
2020,4,D,발달상권,1001105,서울 동작구 노량진역,436,252,184
2020,4,D,발달상권,1001104,삼성역_3,52277,41226,11051
2020,4,D,발달상권,1001103,코엑스,15904,8904,7000
2020,4,D,발달상권,1001102,서울 강남구 학동역_1,1691,1037,654
2020,4,D,발달상권,1001101,선정릉역_2,3758,2684,1074
2020,4,D,발달상권,1001100,강남구 논현역_3,2466,700,1766
2020,4,D,발달상권,1001099,포스코사거리_2,16526,9641,6885
2020,4,D,발달상권,1001098,포스코사거리_1,22702,15610,7092
2020,4,D,발달상권,1001097,잠실역 롯데월드,2247,1185,1062
2020,4,D,발달상권,1001096,신도림역,1674,907,767
2020,4,D,발달상권,1001095,강남구 논현역_2,9009,5256,3753
2020,4,D,발달상권,1001094,선정릉역_1,2392,1492,900
2020,4,D,발달상권,1001093,신천역,4789,2992,1797
2020,4,D,발달상권,1001092,강남구 논현역_1,2284,1208,1076
2020,4,D,발달상권,1001091,삼성역_2,7062,3420,3642
2020,4,D,발달상권,1001090,삼정역_2,1162,721,441
2020,4,D,발달상권,1001089,삼정역_1,2277,1123,1154
2020,4,D,발달상권,1001088,삼성역_1,18695,12565,6130
2020,4,D,발달상권,1001087,서울 강남구 선릉역_2,40183,20392,19791
2020,4,D,발달상권,1001086,고속터미널역,2010,1612,398
2020,4,D,발달상권,1001085,서울 서초구 강남역,19954,10752,9202
2020,4,D,발달상권,1001084,서울 강남구 선릉역_1,21572,9107,12465
2020,4,D,발달상권,1001083,서울 송파구 석촌역_2,597,380,217
2020,4,D,발달상권,1001082,선릉역_2,26260,16412,9848
2020,4,D,발달상권,1001081,서울 강남구 역삼역_2,19179,15530,3649
2020,4,D,발달상권,1001080,서울 송파구 석촌역_1,168,96,72
2020,4,D,발달상권,1001079,석촌역,170,135,35
2020,4,D,발달상권,1001078,서울 강남구 강남역_2,9449,4629,4820
2020,4,D,발달상권,1001077,선릉역_1,16454,10830,5624
2020,4,D,발달상권,1001076,구로역,201,101,100
2020,4,D,발달상권,1001075,역삼역_2,10137,4381,5756
2020,4,D,발달상권,1001074,대림역_2,5179,3395,1784
2020,4,D,발달상권,1001073,서울 강남구 역삼역_1,22546,15049,7497
2020,4,D,발달상권,1001072,신대방삼거리역,259,129,130
2020,4,D,발달상권,1001071,서울 강남구 한티역,673,371,302
2020,4,D,발달상권,1001070,은마아파트입구사거리_4,570,252,318
2020,4,D,발달상권,1001069,은마아파트입구사거리_3,103,45,58
2020,4,D,발달상권,1001068,은마아파트입구사거리_2,15650,5160,10490
2020,4,D,발달상권,1001067,오류동역,2297,1736,561
2020,4,D,발달상권,1001066,서울 강남구 강남역,27566,14310,13256
2020,4,D,발달상권,1001065,은마아파트입구사거리_1,277,92,185
2020,4,D,발달상권,1001064,대림역_1,340,205,135
2020,4,D,발달상권,1001063,교대역_4,6267,3940,2327
2020,4,D,발달상권,1001062,서울 강남구 강남역_1,25938,14288,11650
2020,4,D,발달상권,1001061,방배동카페골목,374,218,156
2020,4,D,발달상권,1001059,교대역_3,1005,649,356
2020,4,D,발달상권,1001058,역삼역_1,10667,5507,5160
2020,4,D,발달상권,1001057,교대역_2,3971,2510,1461
2020,4,D,발달상권,1001056,서울 송파구 가락시장역,5421,3249,2172
2020,4,D,발달상권,1001055,서울 서초구 서초역,1858,988,870
2020,4,D,발달상권,1001054,서울 강남구 대치역_2,1139,629,510
2020,4,D,발달상권,1001053,서울 강남구 대치역_1,102,38,64
2020,4,D,발달상권,1001052,뱅뱅사거리_2,12301,8384,3917
2020,4,D,발달상권,1001051,보라매공원,2417,1455,962
2020,4,D,발달상권,1001050,교대역_1,17722,8352,9370
2020,4,D,발달상권,1001049,개봉동 현대아파트 인근,271,126,145
2020,4,D,발달상권,1001048,뱅뱅사거리,7114,4891,2223
2020,4,D,발달상권,1001047,뱅뱅사거리_1,4820,3658,1162
2020,4,D,발달상권,1001046,서울 관악구 신림역_4,332,165,167
2020,4,D,발달상권,1001045,동작구 총신대입구역_1,327,125,202
2020,4,D,발달상권,1001044,양재역_3,9025,5664,3361
2020,4,D,발달상권,1001043,동작구 총신대입구역_2,1633,741,892
2020,4,D,발달상권,1001042,서울 서초구 남부터미널역_3,3060,1217,1843
2020,4,D,발달상권,1001041,서울 강남구 수서역,12418,6339,6079
2020,4,D,발달상권,1001040,서울 관악구 신림역_3,77,20,57
2020,4,D,발달상권,1001039,서울 서초구 남부터미널역_2,3012,1965,1047
2020,4,D,발달상권,1001038,구로디지탈1단지,43655,28446,15209
2020,4,D,발달상권,1001037,양재역,904,474,430
2020,4,D,발달상권,1001036,문정역,88,52,36
2020,4,D,발달상권,1001035,매봉역,5760,4107,1653
2020,4,D,발달상권,1001034,서울 서초구 방배역,1690,910,780
2020,4,D,발달상권,1001033,서울 서초구 남부터미널역_1,2033,1323,710
2020,4,D,발달상권,1001032,서울 관악구 신림역_2,166,63,103
2020,4,D,발달상권,1001031,서울 관악구 신림역_1,615,316,299
2020,4,D,발달상권,1001030,양재역_2,2634,1725,909
2020,4,D,발달상권,1001029,양재역_1,515,305,210
2020,4,D,발달상권,1001028,서울 관악구 서울대입구역_2,57,28,29
2020,4,D,발달상권,1001027,가산디지털단지역_3,22935,14390,8545
2020,4,D,발달상권,1001026,구로디지털단지역,91,67,24
2020,4,D,발달상권,1001025,서울 관악구 서울대입구역_1,1502,797,705
2020,4,D,발달상권,1001024,관악구 사당역_1,5523,2253,3270
2020,4,D,발달상권,1001023,가산디지털단지역_2,25194,16241,8953
2020,4,D,발달상권,1001022,관악구 사당역_2,744,453,291
2020,4,D,발달상권,1001021,가산디지털단지역_1,18317,12138,6179
2020,4,D,발달상권,1001020,장지역,4411,3129,1282
2020,4,D,발달상권,1001019,포이사거리_1,192,141,51
2020,4,D,발달상권,1001018,포이사거리_2,7673,5359,2314
2020,4,D,발달상권,1001017,관악구 사당역_3,1538,1135,403
2020,4,D,발달상권,1001016,서울 관악구 대학동_1,662,558,104
2020,4,D,발달상권,1001015,서울 금천구 독산1동_1,716,485,231
2020,4,D,발달상권,1001014,양재동 꽃시장,1540,858,682
2020,4,D,발달상권,1001013,양재 화물트럭터미널앞_2,843,619,224
2020,4,D,발달상권,1001012,양재 화물트럭터미널앞_1,1944,1643,301
2020,4,D,발달상권,1001011,서울 금천구 시흥1동_4,486,164,322
2020,4,A,골목상권,1001010,풍성로37가길,128,57,71
2020,4,A,골목상권,1001009,천호옛길,420,288,132
2020,4,A,골목상권,1001008,천호옛14길,177,93,84
2020,4,A,골목상권,1001007,천호대로219길,486,338,148
2020,4,A,골목상권,1001006,천호대로197길,239,168,71
2020,4,A,골목상권,1001005,천호대로187길,371,200,171
2020,4,A,골목상권,1001004,천호대로170길,303,177,126
2020,4,A,골목상권,1001003,천호대로162길,286,149,137
2020,4,A,골목상권,1001002,천중로51길,761,536,225
2020,4,A,골목상권,1001001,천중로39길,574,375,199
2020,4,A,골목상권,1001000,진황도로47길,131,63,68
2020,4,A,골목상권,1000999,진황도로27길,298,174,124
2020,4,A,골목상권,1000998,올림픽로98길,257,169,88
2020,4,A,골목상권,1000997,올림픽로80길,152,54,98
2020,4,A,골목상권,1000996,올림픽로78길,115,58,57
2020,4,A,골목상권,1000995,올림픽로77길,210,114,96
2020,4,A,골목상권,1000994,올림픽로71길,184,101,83
2020,4,A,골목상권,1000993,올림픽로48길,1847,1272,575
2020,4,A,골목상권,1000992,양재대로96길,197,131,66
2020,4,A,골목상권,1000991,양재대로95길,602,324,278
2020,4,A,골목상권,1000990,양재대로91길,358,230,128
2020,4,A,골목상권,1000989,양재대로133길,189,122,67
2020,4,A,골목상권,1000988,양재대로124길,435,258,177
2020,4,A,골목상권,1000987,양재대로116길,75,41,34
2020,4,A,골목상권,1000986,양재대로101길,677,313,364
2020,4,A,골목상권,1000985,암사길,112,70,42
2020,4,A,골목상권,1000984,성안로3길,5508,4242,1266
2020,4,A,골목상권,1000983,성내로5길,1005,650,355
2020,4,A,골목상권,1000982,상일로5길,172,124,48
2020,4,A,골목상권,1000981,상암로5길,271,99,172
2020,4,A,골목상권,1000980,상암로51길,302,122,180
2020,4,A,골목상권,1000979,상암로4길,232,147,85
2020,4,A,골목상권,1000978,상암로14길,432,261,171
2020,4,A,골목상권,1000977,명일로13길,302,182,120
2020,4,A,골목상권,1000976,동남로85길,635,344,291
2020,4,A,골목상권,1000975,동남로82길,108,64,44
2020,4,A,골목상권,1000974,동남로65길,297,202,95
2020,4,A,골목상권,1000973,구천면로42길,87,52,35
2020,4,A,골목상권,1000972,구천면로41길,442,228,214
2020,4,A,골목상권,1000971,구천면로36길,32,14,18
2020,4,A,골목상권,1000970,고덕로61길,137,93,44
2020,4,A,골목상권,1000969,고덕로25길,143,91,52
2020,4,A,골목상권,1000968,고덕로10길,738,335,403
2020,4,A,골목상권,1000967,강동대로53길,1092,726,366
2020,4,A,골목상권,1000966,풍성로25길,84,43,41
2020,4,A,골목상권,1000965,오금로46길,711,359,352
2020,4,A,골목상권,1000964,오금로36길,1133,803,330
2020,4,A,골목상권,1000963,오금로11길,1427,884,543
2020,4,A,골목상권,1000962,양재대로72길,245,124,121
2020,4,A,골목상권,1000961,양재대로71길,1999,1458,541
2020,4,A,골목상권,1000960,양재대로64길,1212,705,507
2020,4,A,골목상권,1000959,양재대로62길,3230,2137,1093
2020,4,A,골목상권,1000958,송파대로30길,2240,1393,847
2020,4,A,골목상권,1000957,송이로36길,2096,1409,687
2020,4,A,골목상권,1000956,송이로32길,1295,733,562
2020,4,A,골목상권,1000955,송이로23길,1850,1269,581
2020,4,A,골목상권,1000954,삼전로13길,1420,916,504
2020,4,A,골목상권,1000953,백제고분로50길,1209,796,413
2020,4,A,골목상권,1000952,백제고분로46길,665,472,193
2020,4,A,골목상권,1000951,백제고분로45길,1349,869,480
2020,4,A,골목상권,1000950,백제고분로42길,590,289,301
2020,4,A,골목상권,1000949,백제고분로39길,566,393,173
2020,4,A,골목상권,1000948,백제고분로34길,1779,1368,411
2020,4,A,골목상권,1000947,백제고분로33길,921,574,347
2020,4,A,골목상권,1000946,백제고분로32길,725,407,318
2020,4,A,골목상권,1000945,백제고분로31길,1708,1370,338
2020,4,A,골목상권,1000944,백제고분로22길,1371,955,416
2020,4,A,골목상권,1000943,백제고분로21길,483,309,174
2020,4,A,골목상권,1000942,마천로51길,417,245,172
2020,4,A,골목상권,1000941,동남로20길,2463,1773,690
2020,4,A,골목상권,1000940,거마로20길,503,229,274
2020,4,A,골목상권,1000939,학동로77길,1851,1119,732
2020,4,A,골목상권,1000938,학동로6길,1447,977,470
2020,4,A,골목상권,1000937,학동로56길,2421,1533,888
2020,4,A,골목상권,1000936,학동로38길,1862,891,971
2020,4,A,골목상권,1000935,테헤란로81길,1637,791,846
2020,4,A,골목상권,1000934,일원로9길,590,334,256
2020,4,A,골목상권,1000933,일원로3길,513,237,276
2020,4,A,골목상권,1000932,영동대로65길,1175,692,483
2020,4,A,골목상권,1000931,영동대로112길,9367,7734,1633
2020,4,A,골목상권,1000930,언주로81길,5810,3989,1821
2020,4,A,골목상권,1000929,압구정로2길,1937,1352,585
2020,4,A,골목상권,1000928,선릉로18길,466,366,100
2020,4,A,골목상권,1000927,선릉로146길,1123,536,587
2020,4,A,골목상권,1000926,선릉로133길,739,434,305
2020,4,A,골목상권,1000925,선릉로132길,1305,645,660
2020,4,A,골목상권,1000924,선릉로121길,2263,1243,1020
2020,4,A,골목상권,1000923,삼성로75길,1814,1262,552
2020,4,A,골목상권,1000922,삼성로69길,2064,1086,978
2020,4,A,골목상권,1000921,삼성로64길,2957,1473,1484
2020,4,A,골목상권,1000920,삼성로63길,1079,554,525
2020,4,A,골목상권,1000919,삼성로57길,3231,1896,1335
2020,4,A,골목상권,1000918,삼성로147길,190,88,102
2020,4,A,골목상권,1000917,삼성로115길,839,429,410
2020,4,A,골목상권,1000916,봉은사로68길,1265,789,476
2020,4,A,골목상권,1000915,봉은사로57길,638,409,229
2020,4,A,골목상권,1000914,봉은사로43길,2978,1692,1286
2020,4,A,골목상권,1000913,봉은사로29길,1860,1203,657
2020,4,A,골목상권,1000912,봉은사로109길,2837,2093,744
2020,4,A,골목상권,1000911,도산대로89길,1284,730,554
2020,4,A,골목상권,1000910,도산대로81길,3094,1363,1731
2020,4,A,골목상권,1000909,도산대로50길,2685,1863,822
2020,4,A,골목상권,1000908,도산대로38길,1043,622,421
2020,4,A,골목상권,1000907,도산대로30길,3153,1611,1542
2020,4,A,골목상권,1000906,도산대로23길,425,176,249
2020,4,A,골목상권,1000905,도산대로15길,123,65,58
2020,4,A,골목상권,1000904,도곡로37길,7206,4518,2688
2020,4,A,골목상권,1000903,논현로8길,1081,701,380
2020,4,A,골목상권,1000902,논현로63길,2139,1352,787
2020,4,A,골목상권,1000901,논현로28길,2736,1826,910
2020,4,A,골목상권,1000900,논현로26길,17916,5148,12768
2020,4,A,골목상권,1000899,논현로159길,109,49,60
2020,4,A,골목상권,1000898,논현로139길,3565,2123,1442
2020,4,A,골목상권,1000897,논현로123길,162,106,56
2020,4,A,골목상권,1000896,논현로115길,2866,1752,1114
2020,4,A,골목상권,1000895,논현로10길,454,271,183
2020,4,A,골목상권,1000894,논현로106길,1488,1027,461
2020,4,A,골목상권,1000893,남부순환로365길,691,445,246
2020,4,A,골목상권,1000892,개포로82길,103,51,52
2020,4,A,골목상권,1000891,개포로28길,589,445,144
2020,4,A,골목상권,1000890,개포로20길,647,400,247
2020,4,A,골목상권,1000889,개포로17길,961,659,302
2020,4,A,골목상권,1000888,강남대로140길,1433,810,623
2020,4,A,골목상권,1000887,강남대로136길,5070,3655,1415
2020,4,A,골목상권,1000886,강남대로118길,218,91,127
2020,4,A,골목상권,1000885,서초중앙로8길,21671,11288,10383
2020,4,A,골목상권,1000884,방배중앙로21길,7153,2605,4548
2020,4,A,골목상권,1000883,효령로72길,3428,2690,738
2020,4,A,골목상권,1000882,효령로34길,1015,653,362
2020,4,A,골목상권,1000881,효령로31길,2710,2198,512
2020,4,A,골목상권,1000880,효령로23길,1492,964,528
2020,4,A,골목상권,1000879,청두곶길,1446,795,651
2020,4,A,골목상권,1000878,주흥길,164,111,53
2020,4,A,골목상권,1000877,주흥15길,834,539,295
2020,4,A,골목상권,1000876,언남길,1128,742,386
2020,4,A,골목상권,1000875,신반포로45길,1192,625,567
2020,4,A,골목상권,1000874,서초대로8길,2598,644,1954
2020,4,A,골목상권,1000873,서초대로64길,829,489,340
2020,4,A,골목상권,1000872,서초대로4길,847,478,369
2020,4,A,골목상권,1000871,서초대로25길,2073,1591,482
2020,4,A,골목상권,1000870,서초대로23길,2098,1239,859
2020,4,A,골목상권,1000869,서초대로15길,467,253,214
2020,4,A,골목상권,1000868,사평대로57길,65,33,32
2020,4,A,골목상권,1000867,사평대로26길,509,346,163
2020,4,A,골목상권,1000866,사평대로22길,1697,1052,645
2020,4,A,골목상권,1000865,사임당로17길,1939,1273,666
2020,4,A,골목상권,1000864,방배로42길,861,707,154
2020,4,A,골목상권,1000863,방배로35길,1137,711,426
2020,4,A,골목상권,1000862,방배로18길,873,535,338
2020,4,A,골목상권,1000861,반포대로9길,538,288,250
2020,4,A,골목상권,1000860,바우뫼로39길,2648,1935,713
2020,4,A,골목상권,1000859,마방로2길,3582,2570,1012
2020,4,A,골목상권,1000858,방배천로4안길,959,401,558
2020,4,A,골목상권,1000857,동산로19길,1276,633,643
2020,4,A,골목상권,1000856,동산로10길,2158,1493,665
2020,4,A,골목상권,1000855,동광로39길,1227,825,402
2020,4,A,골목상권,1000854,동광로1길,2565,1862,703
2020,4,A,골목상권,1000853,동광로12길,1237,610,627
2020,4,A,골목상권,1000852,논현로27길,2808,2146,662
2020,4,A,골목상권,1000851,논현로1길,1227,780,447
2020,4,A,골목상권,1000850,남부순환로339길,1451,978,473
2020,4,A,골목상권,1000849,남부순환로325길,1477,1061,416
2020,4,A,골목상권,1000848,남부순환로317길,2386,1532,854
2020,4,A,골목상권,1000847,고무래로8길,5479,3568,1911
2020,4,A,골목상권,1000846,강남대로8길,1850,1231,619
2020,4,A,골목상권,1000845,강남대로34길,1734,1204,530
2020,4,A,골목상권,1000844,강남대로23길,2897,1993,904
2020,4,A,골목상권,1000843,소담길,14,4,10
2020,4,A,골목상권,1000842,원신길,22,11,11
2020,4,A,골목상권,1000840,양산길,11,3,8
2020,4,A,골목상권,1000839,호암로24길,1218,1084,134
2020,4,A,골목상권,1000838,호암로20길,186,77,109
2020,4,A,골목상권,1000837,행운길,557,428,129
2020,4,A,골목상권,1000836,행운1길,250,151,99
2020,4,A,골목상권,1000835,청림3길,167,58,109
2020,4,A,골목상권,1000834,청룡길,404,224,180
2020,4,A,골목상권,1000833,청룡8길,222,53,169
2020,4,A,골목상권,1000832,중앙길,99,30,69
2020,4,A,골목상권,1000831,조원중앙로2길,921,694,227
2020,4,A,골목상권,1000830,조원로18길,179,92,87
2020,4,A,골목상권,1000829,조원로10길,397,215,182
2020,4,A,골목상권,1000828,장군봉2길,201,115,86
2020,4,A,골목상권,1000827,장군봉1길,326,166,160
2020,4,A,골목상권,1000826,인헌길,115,61,54
2020,4,A,골목상권,1000825,은천로25길,44,21,23
2020,4,A,골목상권,1000824,양녕로6길,205,124,81
2020,4,A,골목상권,1000823,신원로3길,180,103,77
2020,4,A,골목상권,1000822,신사로20길,121,93,28
2020,4,A,골목상권,1000821,신림로65길,228,175,53
2020,4,A,골목상권,1000820,신림로64길,113,45,68
2020,4,A,골목상권,1000819,신림로48길,75,49,26
2020,4,A,골목상권,1000818,신림로38길,147,90,57
2020,4,A,골목상권,1000817,신림로28길,442,283,159
2020,4,A,골목상권,1000816,신림로11길,284,183,101
2020,4,A,골목상권,1000815,신림동길,669,435,234
2020,4,A,골목상권,1000814,승방길,251,141,110
2020,4,A,골목상권,1000813,서림7길,116,58,58
2020,4,A,골목상권,1000812,봉천로33길,211,131,80
2020,4,A,골목상권,1000811,봉천로13길,241,86,155
2020,4,A,골목상권,1000810,복은길,405,229,176
2020,4,A,골목상권,1000809,법원단지길,16,5,11
2020,4,A,골목상권,1000808,법원단지9길,163,102,61
2020,4,A,골목상권,1000807,미성5길,309,154,155
2020,4,A,골목상권,1000806,대학길,80,45,35
2020,4,A,골목상권,1000805,대학14길,61,31,30
2020,4,A,골목상권,1000804,당곡길,227,117,110
2020,4,A,골목상권,1000803,남현길,117,28,89
2020,4,A,골목상권,1000802,남현3길,372,256,116
2020,4,A,골목상권,1000801,남현2길,568,398,170
2020,4,A,골목상권,1000800,남부순환로248길,404,213,191
2020,4,A,골목상권,1000799,남부순환로234길,126,81,45
2020,4,A,골목상권,1000798,남부순환로172길,450,316,134
2020,4,A,골목상권,1000797,남부순환로161길,347,223,124
2020,4,A,골목상권,1000796,남부순환로151길,788,369,419
2020,4,A,골목상권,1000795,남부순환로142길,418,252,166
2020,4,A,골목상권,1000794,난향길,206,89,117
2020,4,A,골목상권,1000793,난우길,217,121,96
2020,4,A,골목상권,1000792,난곡로74길,2179,1754,425
2020,4,A,골목상권,1000791,난곡로34길,47,19,28
2020,4,A,골목상권,1000790,난곡로26길,120,85,35
2020,4,A,골목상권,1000789,난곡로24길,89,34,55
2020,4,A,골목상권,1000788,낙성대역길,431,230,201
2020,4,A,골목상권,1000787,국회단지길,1430,396,1034
2020,4,A,골목상권,1000786,구암길,228,72,156
2020,4,A,골목상권,1000785,관천로22길,194,117,77
2020,4,A,골목상권,1000784,관천로15길,236,149,87
2020,4,A,골목상권,1000783,관악로30길,140,51,89
2020,4,A,골목상권,1000782,관악로28길,122,39,83
2020,4,A,골목상권,1000781,관악로14길,109,42,67
2020,4,A,골목상권,1000780,관악로10길,1482,1050,432
2020,4,A,골목상권,1000779,흑석로9길,110,76,34
2020,4,A,골목상권,1000778,흑석로13길,77,33,44
2020,4,A,골목상권,1000777,장승배기로27길,260,135,125
2020,4,A,골목상권,1000776,장승배기로19길,518,409,109
2020,4,A,골목상권,1000775,장승배기로10길,223,90,133
2020,4,A,골목상권,1000774,여의대방로46길,1238,733,505
2020,4,A,골목상권,1000773,여의대방로24길,16249,10586,5663
2020,4,A,골목상권,1000772,여의대방로22카길,346,202,144
2020,4,A,골목상권,1000771,여의대방로22나길,188,95,93
2020,4,A,골목상권,1000770,여의대방로22길,241,128,113
2020,4,A,골목상권,1000769,양녕로26길,92,49,43
2020,4,A,골목상권,1000768,신대방길,191,90,101
2020,4,A,골목상권,1000767,성대로29길,297,143,154
2020,4,A,골목상권,1000766,성대로1길,87,43,44
2020,4,A,골목상권,1000765,서달로8가길,83,34,49
2020,4,A,골목상권,1000764,서달로15길,42,14,28
2020,4,A,골목상권,1000763,서달로14길,21,7,14
2020,4,A,골목상권,1000762,서달로10길,51,28,23
2020,4,A,골목상권,1000761,상도로62길,332,179,153
2020,4,A,골목상권,1000760,상도로61길,187,67,120
2020,4,A,골목상권,1000759,상도로47길,601,288,313
2020,4,A,골목상권,1000758,상도로37길,128,65,63
2020,4,A,골목상권,1000757,상도로15길,320,121,199
2020,4,A,골목상권,1000756,사당로8길,131,70,61
2020,4,A,골목상권,1000755,사당로30길,514,180,334
2020,4,A,골목상권,1000754,사당로2차길,324,216,108
2020,4,A,골목상권,1000753,사당로29길,128,78,50
2020,4,A,골목상권,1000752,사당로26길,321,199,122
2020,4,A,골목상권,1000751,사당로23나길,36,21,15
2020,4,A,골목상권,1000749,사당로20길,103,53,50
2020,4,A,골목상권,1000748,사당로16길,116,36,80
2020,4,A,골목상권,1000747,사당로16가길,237,147,90
2020,4,A,골목상권,1000746,만양로8길,824,512,312
2020,4,A,골목상권,1000745,만양로14길,47,29,18
2020,4,A,골목상권,1000744,등용로14길,409,134,275
2020,4,A,골목상권,1000743,동작대로7길,182,84,98
2020,4,A,골목상권,1000742,동작대로35길,190,87,103
2020,4,A,골목상권,1000741,동작대로33길,170,88,82
2020,4,A,골목상권,1000740,동작대로29길,224,49,175
2020,4,A,골목상권,1000739,동작대로17길,806,386,420
2020,4,A,골목상권,1000738,대방동2길,281,134,147
2020,4,A,골목상권,1000737,대방동27길,465,223,242
2020,4,A,골목상권,1000736,노량진로6길,307,204,103
2020,4,A,골목상권,1000735,국사봉길,138,79,59
2020,4,A,골목상권,1000734,국사봉2길,55,34,21
2020,4,A,골목상권,1000733,국사봉1길,85,52,33
2020,4,A,골목상권,1000732,영신로9길,3221,1646,1575
2020,4,A,골목상권,1000731,영등포로84길,1933,673,1260
2020,4,A,골목상권,1000730,영등포로80길,96,48,48
2020,4,A,골목상권,1000729,영등포로62길,118,85,33
2020,4,A,골목상권,1000728,영등포로35길,340,192,148
2020,4,A,골목상권,1000727,영등포로27길,301,189,112
2020,4,A,골목상권,1000726,영등포로25길,493,363,130
2020,4,A,골목상권,1000725,여의대방로61길,514,400,114
2020,4,A,골목상권,1000724,여의대방로43나길,859,661,198
2020,4,A,골목상권,1000723,여의대방로39길,193,112,81
2020,4,A,골목상권,1000722,여의대방로35길,197,65,132
2020,4,A,골목상권,1000721,양평로28길,847,707,140
2020,4,A,골목상권,1000720,양평로22라길,555,299,256
2020,4,A,골목상권,1000719,양평로19길,748,436,312
2020,4,A,골목상권,1000718,신길로60길,260,196,64
2020,4,A,골목상권,1000717,신길로42길,501,270,231
2020,4,A,골목상권,1000716,신길로42가길,210,90,120
2020,4,A,골목상권,1000715,신길로39길,56,32,24
2020,4,A,골목상권,1000714,신길로17길,676,289,387
2020,4,A,골목상권,1000713,선유서로28길,208,110,98
2020,4,A,골목상권,1000712,선유서로25길,1697,1284,413
2020,4,A,골목상권,1000711,선유서로24길,114,70,44
2020,4,A,골목상권,1000710,선유로55길,416,273,143
2020,4,A,골목상권,1000709,디지털로74길,13,8,5
2020,4,A,골목상권,1000708,디지털로57길,1036,639,397
2020,4,A,골목상권,1000707,디지털로37길,172,55,117
2020,4,A,골목상권,1000706,도신로62길,227,173,54
2020,4,A,골목상권,1000705,도신로60길,124,51,73
2020,4,A,골목상권,1000704,도신로29길,108,49,59
2020,4,A,골목상권,1000703,도신로15길,437,238,199
2020,4,A,골목상권,1000702,도림천로21길,236,157,79
2020,4,A,골목상권,1000701,도림로63길,53,41,12
2020,4,A,골목상권,1000700,도림로147길,334,255,79
2020,4,A,골목상권,1000699,도림로112길,30,19,11
2020,4,A,골목상권,1000698,대림로8길,234,113,121
2020,4,A,골목상권,1000697,대림로7길,49,23,26
2020,4,A,골목상권,1000696,대림로44길,411,289,122
2020,4,A,골목상권,1000695,대림로34길,201,139,62
2020,4,A,골목상권,1000694,대림로31길,454,281,173
2020,4,A,골목상권,1000693,대림로29길,964,624,340
2020,4,A,골목상권,1000692,대림로22길,190,98,92
2020,4,A,골목상권,1000691,당산로46길,698,529,169
2020,4,A,골목상권,1000690,당산로38길,676,471,205
2020,4,A,골목상권,1000689,당산로37길,2439,1483,956
2020,4,A,골목상권,1000688,당산로31길,1481,749,732
2020,4,A,골목상권,1000687,국회대로56길,3275,1590,1685
2020,4,A,골목상권,1000686,경인로90길,282,210,72
2020,4,A,골목상권,1000685,경인로80길,1007,706,301
2020,4,A,골목상권,1000684,경인로77길,741,512,229
2020,4,A,골목상권,1000683,가마산로61길,47,35,12
2020,4,A,골목상권,1000682,시흥대로94길,446,164,282
2020,4,A,골목상권,1000681,시흥대로84길,178,103,75
2020,4,A,골목상권,1000680,시흥대로68길,549,219,330
2020,4,A,골목상권,1000679,시흥대로63길,1016,542,474
2020,4,A,골목상권,1000678,시흥대로62가길,86,59,27
2020,4,A,골목상권,1000677,시흥대로36길,288,173,115
2020,4,A,골목상권,1000676,시흥대로22길,259,143,116
2020,4,A,골목상권,1000675,시흥대로153길,92,55,37
2020,4,A,골목상권,1000674,시흥대로150길,421,278,143
2020,4,A,골목상권,1000673,시흥대로141길,214,142,72
2020,4,A,골목상권,1000672,시흥대로138길,341,246,95
2020,4,A,골목상권,1000671,시흥대로120길,192,117,75
2020,4,A,골목상권,1000670,벚꽃로56길,301,260,41
2020,4,A,골목상권,1000669,범안로17길,4567,2830,1737
2020,4,A,골목상권,1000668,범안로11길,1498,819,679
2020,4,A,골목상권,1000667,문성로5길,379,199,180
2020,4,A,골목상권,1000666,독산로85길,68,34,34
2020,4,A,골목상권,1000665,독산로78다길,195,124,71
2020,4,A,골목상권,1000664,독산로70길,74,31,43
2020,4,A,골목상권,1000663,독산로64길,186,152,34
2020,4,A,골목상권,1000662,독산로50길,27,6,21
2020,4,A,골목상권,1000661,독산로40길,219,75,144
2020,4,A,골목상권,1000660,독산로108길,1619,1443,176
2020,4,A,골목상권,1000659,남부순환로112길,96,66,30
2020,4,A,골목상권,1000658,금하로24길,132,72,60
2020,4,A,골목상권,1000657,금하로1길,227,175,52
2020,4,A,골목상권,1000656,금하로14길,96,65,31
2020,4,A,골목상권,1000655,가산로5길,499,350,149
2020,4,A,골목상권,1000654,가산로3길,999,756,243
2020,4,A,골목상권,1000653,중앙로1길,960,704,256
2020,4,A,골목상권,1000652,중앙로15길,171,106,65
2020,4,A,골목상권,1000651,우마길,43,19,24
2020,4,A,골목상권,1000650,오류로8길,442,219,223
2020,4,A,골목상권,1000649,신도림로13길,148,100,48
2020,4,A,골목상권,1000648,새말로18길,933,549,384
2020,4,A,골목상권,1000647,부일로1길,356,321,35
2020,4,A,골목상권,1000646,부일로15길,156,107,49
2020,4,A,골목상권,1000645,부일로11길,281,115,166
2020,4,A,골목상권,1000644,디지털로32길,815,435,380
2020,4,A,골목상권,1000643,디지털로32가길,2221,1322,899
2020,4,A,골목상권,1000642,디지털로27길,26,20,6
2020,4,A,골목상권,1000641,도림로6길,160,93,67
2020,4,A,골목상권,1000640,도림로12길,186,124,62
2020,4,A,골목상권,1000639,남부순환로97길,101,48,53
2020,4,A,골목상권,1000638,구로중앙로8길,107,41,66
2020,4,A,골목상권,1000637,구로중앙로7길,86,42,44
2020,4,A,골목상권,1000636,구로중앙로42길,403,284,119
2020,4,A,골목상권,1000635,구로중앙로34길,189,149,40
2020,4,A,골목상권,1000634,구로중앙로28길,470,226,244
2020,4,A,골목상권,1000633,구로중앙로19길,666,398,268
2020,4,A,골목상권,1000632,구로동로8길,298,153,145
2020,4,A,골목상권,1000631,구로동로7길,115,71,44
2020,4,A,골목상권,1000630,구로동로42길,131,75,56
2020,4,A,골목상권,1000629,구로동로41길,119,79,40
2020,4,A,골목상권,1000628,구로동로38길,625,240,385
2020,4,A,골목상권,1000627,구로동로28길,42,18,24
2020,4,A,골목상권,1000626,구로동로15길,88,50,38
2020,4,A,골목상권,1000625,공원로6가길,1158,755,403
2020,4,A,골목상권,1000624,고척로52길,40,27,13
2020,4,A,골목상권,1000623,고척로27다길,169,99,70
2020,4,A,골목상권,1000622,고척로27길,309,167,142
2020,4,A,골목상권,1000621,고척로21나길,369,197,172
2020,4,A,골목상권,1000620,경인로47길,657,264,393
2020,4,A,골목상권,1000619,경인로35길,364,232,132
2020,4,A,골목상권,1000618,경인로31길,130,61,69
2020,4,A,골목상권,1000617,경인로15길,259,93,166
2020,4,A,골목상권,1000616,개봉로3길,273,139,134
2020,4,A,골목상권,1000615,개봉로2길,186,99,87
2020,4,A,골목상권,1000614,개봉로23가길,826,590,236
2020,4,A,골목상권,1000613,개봉로20길,3082,1346,1736
2020,4,A,골목상권,1000612,개봉로1길,187,126,61
2020,4,A,골목상권,1000611,개봉로17다길,2362,1606,756
2020,4,A,골목상권,1000610,개봉로17길,1304,418,886
2020,4,A,골목상권,1000609,개봉로11길,181,97,84
2020,4,A,골목상권,1000608,화곡로64길,1128,686,442
2020,4,A,골목상권,1000607,화곡로59길,316,232,84
2020,4,A,골목상권,1000606,화곡로44나길,625,559,66
2020,4,A,골목상권,1000605,화곡로31길,618,375,243
2020,4,A,골목상권,1000604,화곡로20길,355,193,162
2020,4,A,골목상권,1000603,화곡로13길,368,249,119
2020,4,A,골목상권,1000602,초원로16길,523,369,154
2020,4,A,골목상권,1000601,초록마을로8길,116,68,48
2020,4,A,골목상권,1000600,초록마을로3길,439,355,84
2020,4,A,골목상권,1000599,월정로20길,135,31,104
2020,4,A,골목상권,1000598,우장산로6길,486,298,188
2020,4,A,골목상권,1000597,양천로73가길,468,360,108
2020,4,A,골목상권,1000596,양천로71길,1203,752,451
2020,4,A,골목상권,1000595,양천로49길,342,232,110
2020,4,A,골목상권,1000594,양천로26길,479,377,102
2020,4,A,골목상권,1000593,양천로24길,186,100,86
2020,4,A,골목상권,1000592,양천로24가길,207,113,94
2020,4,A,골목상권,1000591,양천로14길,257,143,114
2020,4,A,골목상권,1000590,방화대로6라길,653,413,240
2020,4,A,골목상권,1000589,방화대로21길,390,243,147
2020,4,A,골목상권,1000588,등촌로5길,1524,514,1010
2020,4,A,골목상권,1000587,등촌로55길,432,323,109
2020,4,A,골목상권,1000586,등촌로51길,239,137,102
2020,4,A,골목상권,1000585,등촌로39길,313,146,167
2020,4,A,골목상권,1000584,등촌로13길,183,128,55
2020,4,A,골목상권,1000583,남부순환로11길,307,201,106
2020,4,A,골목상권,1000582,까치산로4길,189,112,77
2020,4,A,골목상권,1000581,국회대로7길,215,101,114
2020,4,A,골목상권,1000580,공항대로8길,276,172,104
2020,4,A,골목상권,1000579,공항대로61길,547,415,132
2020,4,A,골목상권,1000578,공항대로59다길,1037,645,392
2020,4,A,골목상권,1000577,공항대로59길,654,454,200
2020,4,A,골목상권,1000576,공항대로55길,900,577,323
2020,4,A,골목상권,1000575,공항대로42길,514,323,191
2020,4,A,골목상권,1000574,공항대로38길,92,49,43
2020,4,A,골목상권,1000573,곰달래로60길,221,146,75
2020,4,A,골목상권,1000572,곰달래로53길,130,89,41
2020,4,A,골목상권,1000571,곰달래로47길,333,218,115
2020,4,A,골목상권,1000570,곰달래로31길,120,78,42
2020,4,A,골목상권,1000569,곰달래로25길,245,139,106
2020,4,A,골목상권,1000568,개화동로25길,351,201,150
2020,4,A,골목상권,1000567,개화동로23길,857,669,188
2020,4,A,골목상권,1000566,강서로8길,214,125,89
2020,4,A,골목상권,1000565,강서로5라길,245,176,69
2020,4,A,골목상권,1000564,강서로5나길,360,221,139
2020,4,A,골목상권,1000563,강서로5가길,182,98,84
2020,4,A,골목상권,1000562,강서로47라길,207,150,57
2020,4,A,골목상권,1000561,강서로47길,327,146,181
2020,4,A,골목상권,1000560,강서로45다길,243,178,65
2020,4,A,골목상권,1000559,강서로45길,101,43,58
2020,4,A,골목상권,1000558,강서로35길,280,120,160
2020,4,A,골목상권,1000557,강서로29길,384,230,154
2020,4,A,골목상권,1000556,강서로18길,676,545,131
2020,4,A,골목상권,1000555,강서로17가길,554,386,168
2020,4,A,골목상권,1000554,강서로15길,261,152,109
2020,4,A,골목상권,1000553,가로공원로80길,270,175,95
2020,4,A,골목상권,1000552,가로공원로76가길,168,91,77
2020,4,A,골목상권,1000551,화곡로4길,421,219,202
2020,4,A,골목상권,1000550,화곡로3길,351,177,174
2020,4,A,골목상권,1000549,지양로7길,245,105,140
2020,4,A,골목상권,1000548,중앙로55길,592,261,331
2020,4,A,골목상권,1000547,중앙로51길,283,178,105
2020,4,A,골목상권,1000546,중앙로47길,94,40,54
2020,4,A,골목상권,1000545,중앙로45길,1386,1342,44
2020,4,A,골목상권,1000544,중앙로36길,133,49,84
2020,4,A,골목상권,1000543,중앙로32길,145,87,58
2020,4,A,골목상권,1000542,중앙로25길,97,61,36
2020,4,A,골목상권,1000541,은행정로7길,472,183,289
2020,4,A,골목상권,1000540,은행정로5길,109,57,52
2020,4,A,골목상권,1000539,오목로5길,120,85,35
2020,4,A,골목상권,1000538,오목로3길,375,296,79
2020,4,A,골목상권,1000537,오목로30길,220,125,95
2020,4,A,골목상권,1000536,오목로23길,401,155,246
2020,4,A,골목상권,1000535,신월로20길,47,30,17
2020,4,A,골목상권,1000534,신월로15길,357,184,173
2020,4,A,골목상권,1000533,신목로6길,582,383,199
2020,4,A,골목상권,1000532,신목로5길,645,416,229
2020,4,A,골목상권,1000531,신목로2길,386,255,131
2020,4,A,골목상권,1000530,목동중앙서로8가길,317,200,117
2020,4,A,골목상권,1000529,목동중앙서로7길,75,52,23
2020,4,A,골목상권,1000528,목동중앙북로8길,171,102,69
2020,4,A,골목상권,1000527,목동중앙북로16길,488,190,298
2020,4,A,골목상권,1000526,목동중앙본로7길,131,70,61
2020,4,A,골목상권,1000525,목동중앙로3길,157,95,62
2020,4,A,골목상권,1000524,목동중앙로13나길,346,248,98
2020,4,A,골목상권,1000523,목동중앙남로3가길,190,108,82
2020,4,A,골목상권,1000522,목동로9길,768,479,289
2020,4,A,골목상권,1000521,목동로19길,351,190,161
2020,4,A,골목상권,1000520,목동동로8길,184,106,78
2020,4,A,골목상권,1000519,목동동로12길,335,228,107
2020,4,A,골목상권,1000518,목동남로4길,797,494,303
2020,4,A,골목상권,1000517,남부순환로88길,328,124,204
2020,4,A,골목상권,1000516,남부순환로79길,142,74,68
2020,4,A,골목상권,1000515,남부순환로70길,165,101,64
2020,4,A,골목상권,1000514,남부순환로58길,282,179,103
2020,4,A,골목상권,1000513,남부순환로40길,122,46,76
2020,4,A,골목상권,1000512,남부순환로33길,179,116,63
2020,4,A,골목상권,1000511,곰달래로5길,211,125,86
2020,4,A,골목상권,1000510,곰달래로3길,313,213,100
2020,4,A,골목상권,1000509,곰달래로2길,610,344,266
2020,4,A,골목상권,1000508,곰달래로10길,543,449,94
2020,4,A,골목상권,1000507,가로공원로58길,91,54,37
2020,4,A,골목상권,1000506,효창원로93길,243,99,144
2020,4,A,골목상권,1000505,토정로37길,431,166,265
2020,4,A,골목상권,1000504,월드컵로8길,939,462,477
2020,4,A,골목상권,1000503,월드컵로7길,759,308,451
2020,4,A,골목상권,1000502,월드컵로36길,461,286,175
2020,4,A,골목상권,1000501,월드컵로25길,309,125,184
2020,4,A,골목상권,1000500,월드컵로19길,284,181,103
2020,4,A,골목상권,1000499,월드컵로16길,1538,929,609
2020,4,A,골목상권,1000498,월드컵로11길,421,153,268
2020,4,A,골목상권,1000497,월드컵로10길,1102,654,448
2020,4,A,골목상권,1000496,와우산로3길,257,176,81
2020,4,A,골목상권,1000495,와우산로29길,78,30,48
2020,4,A,골목상권,1000494,와우산로29가길,989,653,336
2020,4,A,골목상권,1000493,양화진길,676,412,264
2020,4,A,골목상권,1000492,양화로1길,544,248,296
2020,4,A,골목상권,1000491,양화로11길,2761,1012,1749
2020,4,A,골목상권,1000490,신촌로30길,109,64,45
2020,4,A,골목상권,1000489,신촌로28가길,59,19,40
2020,4,A,골목상권,1000488,신촌로12길,197,95,102
2020,4,A,골목상권,1000487,숭문길,1467,1016,451
2020,4,A,골목상권,1000486,숭문8길,109,65,44
2020,4,A,골목상권,1000485,성지3길,338,228,110
2020,4,A,골목상권,1000484,성산로4길,855,546,309
2020,4,A,골목상권,1000483,성미산로32길,243,172,71
2020,4,A,골목상권,1000482,성미산로1길,554,299,255
2020,4,A,골목상권,1000481,성미산로11길,1114,807,307
2020,4,A,골목상권,1000480,백범로16길,1908,1298,610
2020,4,A,골목상권,1000479,방울내로9안길,619,351,268
2020,4,A,골목상권,1000478,모래내로7길,91,63,28
2020,4,A,골목상권,1000477,매봉산로2길,806,601,205
2020,4,A,골목상권,1000476,망원로2길,282,190,92
2020,4,A,골목상권,1000475,망원로11길,144,73,71
2020,4,A,골목상권,1000474,만리재옛길,1190,687,503
2020,4,A,골목상권,1000473,마포대로4길,674,365,309
2020,4,A,골목상권,1000472,마포대로20길,483,258,225
2020,4,A,골목상권,1000471,마포대로12길,78,39,39
2020,4,A,골목상권,1000470,동교로38길,464,247,217
2020,4,A,골목상권,1000469,동교로27길,1172,795,377
2020,4,A,골목상권,1000468,동교로25길,1378,581,797
2020,4,A,골목상권,1000467,동교로19길,1207,739,468
2020,4,A,골목상권,1000466,동교로17길,405,240,165
2020,4,A,골목상권,1000465,독막로8길,441,274,167
2020,4,A,골목상권,1000464,독막로32길,487,240,247
2020,4,A,골목상권,1000463,독막로22길,91,61,30
2020,4,A,골목상권,1000462,도화길,56,32,24
2020,4,A,골목상권,1000461,도화4길,825,292,533
2020,4,A,골목상권,1000460,대흥로28길,50,17,33
2020,4,A,골목상권,1000459,대흥로21길,372,188,184
2020,4,A,골목상권,1000458,광성로6길,295,169,126
2020,4,A,골목상권,1000457,홍제내길,565,201,364
2020,4,A,골목상권,1000456,홍연길,79,47,32
2020,4,A,골목상권,1000455,통일로39길,67,32,35
2020,4,A,골목상권,1000454,통일로37길,611,407,204
2020,4,A,골목상권,1000453,통일로11길,97,46,51
2020,4,A,골목상권,1000452,충정로6길,3185,1879,1306
2020,4,A,골목상권,1000451,충정로4길,2044,1298,746
2020,4,A,골목상권,1000450,증가로6길,326,277,49
2020,4,A,골목상권,1000449,증가로23나길,902,441,461
2020,4,A,골목상권,1000448,증가로20가길,336,99,237
2020,4,A,골목상권,1000447,증가로10길,1463,1123,340
2020,4,A,골목상권,1000446,응암로1길,621,380,241
2020,4,A,골목상권,1000445,연희로10길,3448,3135,313
2020,4,A,골목상권,1000444,신촌로37길,52,25,27
2020,4,A,골목상권,1000443,수색로8길,1090,905,185
2020,4,A,골목상권,1000442,세무서길,164,78,86
2020,4,A,골목상권,1000441,세무서2길,186,77,109
2020,4,A,골목상권,1000440,세검정로1길,109,37,72
2020,4,A,골목상권,1000439,북아현로4길,350,225,125
2020,4,A,골목상권,1000438,모래내로15길,74,54,20
2020,4,A,골목상권,1000437,명지대길,107,58,49
2020,4,A,골목상권,1000436,독립문로8길,679,422,257
2020,4,A,골목상권,1000435,가재울로6길,168,108,60
2020,4,A,골목상권,1000434,통일로92길,186,72,114
2020,4,A,골목상권,1000433,통일로87길,255,130,125
2020,4,A,골목상권,1000432,통일로78길,172,60,112
2020,4,A,골목상권,1000431,통일로69길,107,55,52
2020,4,A,골목상권,1000430,진흥로1길,310,165,145
2020,4,A,골목상권,1000429,진흥로12길,392,144,248
2020,4,A,골목상권,1000428,증산서길,334,189,145
2020,4,A,골목상권,1000427,증산로9길,606,525,81
2020,4,A,골목상권,1000426,증산로5길,508,308,200
2020,4,A,골목상권,1000425,증산로21길,237,122,115
2020,4,A,골목상권,1000424,증산로17길,161,110,51
2020,4,A,골목상권,1000423,증산로15길,398,297,101
2020,4,A,골목상권,1000422,증산로13길,79,42,37
2020,4,A,골목상권,1000421,응암로34길,231,118,113
2020,4,A,골목상권,1000420,응암로22길,130,53,77
2020,4,A,골목상권,1000419,응암로14길,99,50,49
2020,4,A,골목상권,1000418,응암로13길,156,44,112
2020,4,A,골목상권,1000417,응암로12길,67,32,35
2020,4,A,골목상권,1000416,은평로8길,275,194,81
2020,4,A,골목상권,1000415,은평로3길,242,110,132
2020,4,A,골목상권,1000414,은평로20길,9,2,7
2020,4,A,골목상권,1000413,은평로13길,655,283,372
2020,4,A,골목상권,1000412,은평로10길,246,148,98
2020,4,A,골목상권,1000411,연서로5길,647,303,344
2020,4,A,골목상권,1000410,연서로41길,64,33,31
2020,4,A,골목상권,1000409,연서로3길,119,51,68
2020,4,A,골목상권,1000408,연서로34길,1310,709,601
2020,4,A,골목상권,1000407,연서로33길,109,49,60
2020,4,A,골목상권,1000406,연서로29길,100,60,40
2020,4,A,골목상권,1000405,연서로28길,226,118,108
2020,4,A,골목상권,1000404,연서로27길,339,148,191
2020,4,A,골목상권,1000403,연서로21길,684,486,198
2020,4,A,골목상권,1000402,연서로17길,540,162,378
2020,4,A,골목상권,1000401,연서로16길,121,66,55
2020,4,A,골목상권,1000400,연서로13길,218,135,83
2020,4,A,골목상권,1000399,연서로11길,640,263,377
2020,4,A,골목상권,1000398,역말로9길,159,82,77
2020,4,A,골목상권,1000397,수색로18길,128,93,35
2020,4,A,골목상권,1000396,서오릉로8길,160,104,56
2020,4,A,골목상권,1000395,서오릉로21길,153,56,97
2020,4,A,골목상권,1000394,불광천길,192,95,97
2020,4,A,골목상권,1000393,갈현로7길,398,205,193
2020,4,A,골목상권,1000392,갈현로41길,171,78,93
2020,4,A,골목상권,1000391,갈현로33길,255,149,106
2020,4,A,골목상권,1000390,갈현로1길,66,36,30
2020,4,A,골목상권,1000389,가좌로7길,329,203,126
2020,4,A,골목상권,1000388,한글비석로44길,232,95,137
2020,4,A,골목상권,1000387,한글비석로24길,180,62,118
2020,4,A,골목상권,1000386,한글비석로22길,172,92,80
2020,4,A,골목상권,1000385,석계로1길,605,255,350
2020,4,A,골목상권,1000384,상계로9가길,151,82,69
2020,4,A,골목상권,1000383,상계로1길,334,244,90
2020,4,A,골목상권,1000382,상계로12길,144,90,54
2020,4,A,골목상권,1000381,동일로242길,302,142,160
2020,4,A,골목상권,1000380,동일로192길,429,326,103
2020,4,A,골목상권,1000379,동일로173가길,1230,946,284
2020,4,A,골목상권,1000378,공릉로58길,129,61,68
2020,4,A,골목상권,1000377,해등로16길,285,134,151
2020,4,A,골목상권,1000376,우이천로4다길,125,83,42
2020,4,A,골목상권,1000375,우이천로32길,206,83,123
2020,4,A,골목상권,1000374,시루봉로23길,267,128,139
2020,4,A,골목상권,1000373,삼양로144길,50,24,26
2020,4,A,골목상권,1000372,방학로6가길,167,67,100
2020,4,A,골목상권,1000371,방학로5길,124,87,37
2020,4,A,골목상권,1000370,방학로15길,687,454,233
2020,4,A,골목상권,1000369,방학로10길,67,51,16
2020,4,A,골목상권,1000368,도봉산길,135,64,71
2020,4,A,골목상권,1000367,도봉산4길,27,24,3
2020,4,A,골목상권,1000366,도봉로181길,93,30,63
2020,4,A,골목상권,1000365,도봉로169나길,244,184,60
2020,4,A,골목상권,1000364,도봉로156길,93,62,31
2020,4,A,골목상권,1000363,도봉로152가길,342,311,31
2020,4,A,골목상권,1000362,도봉로147길,161,81,80
2020,4,A,골목상권,1000361,도봉로143길,73,48,25
2020,4,A,골목상권,1000360,도봉로114길,380,143,237
2020,4,A,골목상권,1000359,도봉로109길,276,223,53
2020,4,A,골목상권,1000358,도당로29길,518,292,226
2020,4,A,골목상권,1000357,도당로19길,597,66,531
2020,4,A,골목상권,1000356,도당로13바길,74,35,39
2020,4,A,골목상권,1000355,도당로13가길,36,21,15
2020,4,A,골목상권,1000354,덕릉로60길,177,126,51
2020,4,A,골목상권,1000353,노해로63다길,43,19,24
2020,4,A,골목상권,1000352,노해로60길,136,85,51
2020,4,A,골목상권,1000351,한천로140길,36,25,11
2020,4,A,골목상권,1000350,한천로139가길,108,47,61
2020,4,A,골목상권,1000349,한천로132길,56,31,25
2020,4,A,골목상권,1000348,한천로130길,91,69,22
2020,4,A,골목상권,1000347,한천로124나길,54,23,31
2020,4,A,골목상권,1000346,한천로109길,439,280,159
2020,4,A,골목상권,1000345,인수봉로79길,242,153,89
2020,4,A,골목상권,1000344,인수봉로72길,54,18,36
2020,4,A,골목상권,1000343,인수봉로56길,44,25,19
2020,4,A,골목상권,1000342,오패산로67길,238,89,149
2020,4,A,골목상권,1000341,오패산로52길,105,47,58
2020,4,A,골목상권,1000340,오패산로30길,13,5,8
2020,4,A,골목상권,1000339,수유로12길,281,199,82
2020,4,A,골목상권,1000338,솔샘로65길,284,66,218
2020,4,A,골목상권,1000337,솔매로50길,442,162,280
2020,4,A,골목상권,1000336,솔매로45길,65,32,33
2020,4,A,골목상권,1000335,솔매로41길,67,38,29
2020,4,A,골목상권,1000334,삼양로93길,209,94,115
2020,4,A,골목상권,1000333,삼양로77길,131,58,73
2020,4,A,골목상권,1000332,삼양로54길,295,66,229
2020,4,A,골목상권,1000331,삼양로41길,338,275,63
2020,4,A,골목상권,1000330,삼양로27길,7,4,3
2020,4,A,골목상권,1000329,삼양로24길,26,16,10
2020,4,A,골목상권,1000328,삼양로20길,179,168,11
2020,4,A,골목상권,1000327,삼각산로28길,70,33,37
2020,4,A,골목상권,1000326,도봉로99길,250,155,95
2020,4,A,골목상권,1000325,도봉로8길,6,4,2
2020,4,A,골목상권,1000324,도봉로76길,311,138,173
2020,4,A,골목상권,1000323,도봉로67길,116,57,59
2020,4,A,골목상권,1000322,도봉로45길,112,54,58
2020,4,A,골목상권,1000321,도봉로18길,225,182,43
2020,4,A,골목상권,1000320,도봉로13길,13,8,5
2020,4,A,골목상권,1000319,덕릉로41길,185,105,80
2020,4,A,골목상권,1000318,덕릉로40길,187,95,92
2020,4,A,골목상권,1000317,노해로33길,84,30,54
2020,4,A,골목상권,1000316,노해로23길,70,47,23
2020,4,A,골목상권,1000315,노해로17길,103,56,47
2020,4,A,골목상권,1000314,화랑로40길,71,46,25
2020,4,A,골목상권,1000313,화랑로32길,395,292,103
2020,4,A,골목상권,1000312,화랑로1길,1112,811,301
2020,4,A,골목상권,1000311,화랑로19길,43,19,24
2020,4,A,골목상권,1000310,화랑로14길,99,73,26
2020,4,A,골목상권,1000309,화랑로13길,267,95,172
2020,4,A,골목상권,1000308,한천로76길,132,100,32
2020,4,A,골목상권,1000307,한천로101가길,15,9,6
2020,4,A,골목상권,1000306,창경궁로43길,917,434,483
2020,4,A,골목상권,1000305,지봉로20길,3780,3162,618
2020,4,A,골목상권,1000304,종암로5길,404,201,203
2020,4,A,골목상권,1000303,종암로24가길,81,18,63
2020,4,A,골목상권,1000302,종암로21길,550,344,206
2020,4,A,골목상권,1000301,종암로19길,18269,9427,8842
2020,4,A,골목상권,1000300,종암로16길,140,61,79
2020,4,A,골목상권,1000299,정릉로8길,1407,1165,242
2020,4,A,골목상권,1000298,정릉로27길,75,30,45
2020,4,A,골목상권,1000297,정릉로26길,214,103,111
2020,4,A,골목상권,1000296,장위로50길,343,160,183
2020,4,A,골목상권,1000295,장월로1길,74,19,55
2020,4,A,골목상권,1000294,인촌로6길,195,131,64
2020,4,A,골목상권,1000293,인촌로5길,63,31,32
2020,4,A,골목상권,1000292,인촌로24길,1580,1010,570
2020,4,A,골목상권,1000291,개운사길,150,83,67
2020,4,A,골목상권,1000290,인촌로1길,127,78,49
2020,4,A,골목상권,1000289,인촌로17가길,90,48,42
2020,4,A,골목상권,1000288,오패산로4길,841,540,301
2020,4,A,골목상권,1000287,오패산로3길,310,187,123
2020,4,A,골목상권,1000286,오패산로19길,101,36,65
2020,4,A,골목상권,1000285,안암로5길,960,743,217
2020,4,A,골목상권,1000284,아리랑로4길,595,281,314
2020,4,A,골목상권,1000283,솔샘로6길,74,48,26
2020,4,A,골목상권,1000282,성북로8길,143,88,55
2020,4,A,골목상권,1000281,삼양로8길,147,70,77
2020,4,A,골목상권,1000280,삼선교로16가길,99,42,57
2020,4,A,골목상권,1000279,삼선교로10다길,38,17,21
2020,4,A,골목상권,1000278,삼선교로10길,186,110,76
2020,4,A,골목상권,1000277,보문로32길,267,128,139
2020,4,A,골목상권,1000276,보문로31길,253,128,125
2020,4,A,골목상권,1000275,보문로26길,134,62,72
2020,4,A,골목상권,1000274,보문로13길,1048,741,307
2020,4,A,골목상권,1000273,보국문로16길,181,97,84
2020,4,A,골목상권,1000272,동소문로6길,62,28,34
2020,4,A,골목상권,1000271,동소문로2길,53,21,32
2020,4,A,골목상권,1000270,동소문로26가길,219,122,97
2020,4,A,골목상권,1000269,동소문로15길,209,152,57
2020,4,A,골목상권,1000268,동소문로13길,572,285,287
2020,4,A,골목상권,1000267,돌곶이로8길,117,75,42
2020,4,A,골목상권,1000266,돌곶이로41길,40,13,27
2020,4,A,골목상권,1000265,돌곶이로28길,222,96,126
2020,4,A,골목상권,1000264,돌곶이로27길,103,59,44
2020,4,A,골목상권,1000263,돌곶이로22길,61,34,27
2020,4,A,골목상권,1000262,돌곶이로14길,77,58,19
2020,4,A,골목상권,1000261,길음로7길,14,5,9
2020,4,A,골목상권,1000260,중랑천로10길,207,109,98
2020,4,A,골목상권,1000259,용마산로94길,304,259,45
2020,4,A,골목상권,1000258,용마산로118길,108,63,45
2020,4,A,골목상권,1000257,용마산로112길,114,69,45
2020,4,A,골목상권,1000256,용마산로100길,122,52,70
2020,4,A,골목상권,1000255,신내로7가길,276,115,161
2020,4,A,골목상권,1000254,사가정로54길,122,47,75
2020,4,A,골목상권,1000253,사가정로42길,183,89,94
2020,4,A,골목상권,1000252,봉화산로56길,649,289,360
2020,4,A,골목상권,1000251,봉화산로4길,58,30,28
2020,4,A,골목상권,1000250,봉화산로30길,139,38,101
2020,4,A,골목상권,1000249,봉우재로33길,150,59,91
2020,4,A,골목상권,1000248,면목로78길,93,44,49
2020,4,A,골목상권,1000247,면목로56길,91,53,38
2020,4,A,골목상권,1000246,면목로55길,473,306,167
2020,4,A,골목상권,1000245,면목로49길,109,67,42
2020,4,A,골목상권,1000244,면목로48길,873,544,329
2020,4,A,골목상권,1000243,면목로45길,454,364,90
2020,4,A,골목상권,1000242,면목로33길,86,28,58
2020,4,A,골목상권,1000241,면목로21길,54,37,17
2020,4,A,골목상권,1000240,망우로73길,51,34,17
2020,4,A,골목상권,1000239,망우로68길,107,44,63
2020,4,A,골목상권,1000238,동일로163길,112,67,45
2020,4,A,골목상권,1000237,동일로157길,443,270,173
2020,4,A,골목상권,1000236,동일로149길,870,749,121
2020,4,A,골목상권,1000235,동일로140길,432,314,118
2020,4,A,골목상권,1000234,동일로139길,77,53,24
2020,4,A,골목상권,1000233,동일로139가길,187,81,106
2020,4,A,골목상권,1000232,동일로130길,130,99,31
2020,4,A,골목상권,1000231,동일로123길,145,74,71
2020,4,A,골목상권,1000230,동일로112길,193,120,73
2020,4,A,골목상권,1000229,동일로101길,202,58,144
2020,4,A,골목상권,1000228,동일로100길,328,240,88
2020,4,A,골목상권,1000227,답십리로75길,57,33,24
2020,4,A,골목상권,1000226,공릉로2길,148,69,79
2020,4,A,골목상권,1000225,공릉로12가길,75,50,25
2020,4,A,골목상권,1000224,겸재로54길,131,79,52
2020,4,A,골목상권,1000223,겸재로36길,134,60,74
2020,4,A,골목상권,1000222,겸재로29길,126,74,52
2020,4,A,골목상권,1000221,휘경로3길,127,69,58
2020,4,A,골목상권,1000220,휘경로2길,138,88,50
2020,4,A,골목상권,1000219,휘경로23길,89,56,33
2020,4,A,골목상권,1000218,휘경로14길,113,41,72
2020,4,A,골목상권,1000217,한천로46길,257,101,156
2020,4,A,골목상권,1000216,한천로40길,90,57,33
2020,4,A,골목상권,1000215,한천로33길,203,76,127
2020,4,A,골목상권,1000214,한천로14길,696,440,256
2020,4,A,골목상권,1000213,천호대로97길,878,590,288
2020,4,A,골목상권,1000212,천호대로77길,169,111,58
2020,4,A,골목상권,1000211,천호대로45길,47,38,9
2020,4,A,골목상권,1000210,천호대로17길,2512,1893,619
2020,4,A,골목상권,1000209,천호대로12길,55,35,20
2020,4,A,골목상권,1000208,천장산로7길,74,32,42
2020,4,A,골목상권,1000207,제기로5길,45,39,6
2020,4,A,골목상권,1000206,제기로21길,101,62,39
2020,4,A,골목상권,1000205,전농로4길,274,210,64
2020,4,A,골목상권,1000204,전농로3길,170,120,50
2020,4,A,골목상권,1000203,전농로29길,461,336,125
2020,4,A,골목상권,1000202,장한로8길,438,295,143
2020,4,A,골목상권,1000201,장한로5길,314,189,125
2020,4,A,골목상권,1000200,장한로27길,167,119,48
2020,4,A,골목상권,1000199,장한로27가길,148,81,67
2020,4,A,골목상권,1000198,장한로26길,2436,1696,740
2020,4,A,골목상권,1000197,장한로26가길,122,87,35
2020,4,A,골목상권,1000196,장한로25길,408,210,198
2020,4,A,골목상권,1000195,장한로14길,179,98,81
2020,4,A,골목상권,1000194,이문로42길,48,29,19
2020,4,A,골목상권,1000193,왕산로43길,560,199,361
2020,4,A,골목상권,1000192,왕산로33길,72,30,42
2020,4,A,골목상권,1000191,왕산로32길,129,64,65
2020,4,A,골목상권,1000190,약령시로17길,109,77,32
2020,4,A,골목상권,1000189,서울시립대로4길,404,264,140
2020,4,A,골목상권,1000188,서울시립대로29길,368,263,105
2020,4,A,골목상권,1000187,서울시립대로16길,42,14,28
2020,4,A,골목상권,1000186,사가정로2길,268,177,91
2020,4,A,골목상권,1000185,사가정로23가길,84,46,38
2020,4,A,골목상권,1000184,사가정로13길,180,65,115
2020,4,A,골목상권,1000183,무학로45길,227,141,86
2020,4,A,골목상권,1000182,무학로16길,574,441,133
2020,4,A,골목상권,1000181,망우로21길,96,67,29
2020,4,A,골목상권,1000180,망우로18길,52,17,35
2020,4,A,골목상권,1000179,망우로18가길,114,75,39
2020,4,A,골목상권,1000178,답십리로72길,54,20,34
2020,4,A,골목상권,1000177,답십리로69길,533,270,263
2020,4,A,골목상권,1000176,답십리로68길,287,158,129
2020,4,A,골목상권,1000175,답십리로64길,103,73,30
2020,4,A,골목상권,1000174,답십리로63길,1747,1051,696
2020,4,A,골목상권,1000173,답십리로60길,341,213,128
2020,4,A,골목상권,1000172,답십리로56길,78,39,39
2020,4,A,골목상권,1000171,답십리로23길,47,22,25
2020,4,A,골목상권,1000170,난계로30길,4980,2233,2747
2020,4,A,골목상권,1000169,경희대로4길,41,18,23
2020,4,A,골목상권,1000168,경희대로3길,28,16,12
2020,4,A,골목상권,1000167,천호대로129길,344,207,137
2020,4,A,골목상권,1000166,천호대로123길,625,282,343
2020,4,A,골목상권,1000165,천호대로109길,915,504,411
2020,4,A,골목상권,1000164,자양번영로3길,587,462,125
2020,4,A,골목상권,1000163,자양로53길,170,120,50
2020,4,A,골목상권,1000162,자양로50길,218,121,97
2020,4,A,골목상권,1000161,자양로45길,448,184,264
2020,4,A,골목상권,1000160,자양로26길,141,91,50
2020,4,A,골목상권,1000159,자양로15길,106,45,61
2020,4,A,골목상권,1000158,자양로11길,646,250,396
2020,4,A,골목상권,1000157,용마산로3길,541,431,110
2020,4,A,골목상권,1000156,용마산로21길,396,253,143
2020,4,A,골목상권,1000155,아차산로78길,575,421,154
2020,4,A,골목상권,1000154,아차산로65길,357,214,143
2020,4,A,골목상권,1000153,아차산로55길,243,150,93
2020,4,A,골목상권,1000152,아차산로51길,432,110,322
2020,4,A,골목상권,1000151,아차산로40길,357,207,150
2020,4,A,골목상권,1000150,면목로17길,230,138,92
2020,4,A,골목상권,1000149,뚝섬로64길,239,127,112
2020,4,A,골목상권,1000148,뚝섬로58길,278,141,137
2020,4,A,골목상권,1000147,뚝섬로54길,948,798,150
2020,4,A,골목상권,1000146,뚝섬로48길,228,134,94
2020,4,A,골목상권,1000145,뚝섬로24길,111,66,45
2020,4,A,골목상권,1000144,뚝섬로23길,209,148,61
2020,4,A,골목상권,1000143,동일로24길,42,32,10
2020,4,A,골목상권,1000142,동일로18길,79,54,25
2020,4,A,골목상권,1000141,능동로4길,947,834,113
2020,4,A,골목상권,1000140,능동로3길,71,45,26
2020,4,A,골목상권,1000139,능동로34길,1018,676,342
2020,4,A,골목상권,1000138,능동로19길,133,77,56
2020,4,A,골목상권,1000137,능동로13길,221,109,112
2020,4,A,골목상권,1000136,긴고랑로9길,138,51,87
2020,4,A,골목상권,1000135,긴고랑로8길,947,573,374
2020,4,A,골목상권,1000134,긴고랑로7길,460,353,107
2020,4,A,골목상권,1000133,긴고랑로20길,174,98,76
2020,4,A,골목상권,1000132,광나루로52길,649,395,254
2020,4,A,골목상권,1000131,광나루로40길,242,128,114
2020,4,A,골목상권,1000130,광나루로37길,60,29,31
2020,4,A,골목상권,1000129,광나루로36길,412,169,243
2020,4,A,골목상권,1000128,광나루로24길,25,12,13
2020,4,A,골목상권,1000127,광나루로12길,60,19,41
2020,4,A,골목상권,1000126,한림말길,355,174,181
2020,4,A,골목상권,1000125,한림말3길,3329,1128,2201
2020,4,A,골목상권,1000124,청계천로10나길,4951,3728,1223
2020,4,A,골목상권,1000123,장터길,90,46,44
2020,4,A,골목상권,1000122,용답중앙길,93,66,27
2020,4,A,골목상권,1000121,용답29길,537,360,177
2020,4,A,골목상권,1000120,왕십리로6길,538,350,188
2020,4,A,골목상권,1000119,왕십리로31길,208,95,113
2020,4,A,골목상권,1000118,왕십리로26길,2076,1357,719
2020,4,A,골목상권,1000117,왕십리로21길,164,77,87
2020,4,A,골목상권,1000116,왕십리로14길,997,776,221
2020,4,A,골목상권,1000115,아차산로5길,1871,1041,830
2020,4,A,골목상권,1000114,아차산로15길,3361,2374,987
2020,4,A,골목상권,1000113,아차산로11길,3213,2213,1000
2020,4,A,골목상권,1000112,송정4가길,291,123,168
2020,4,A,골목상권,1000111,송정12라길,94,48,46
2020,4,A,골목상권,1000110,성수일로6길,1342,928,414
2020,4,A,골목상권,1000109,성수이로7길,1442,895,547
2020,4,A,골목상권,1000108,성수이로18길,2988,1968,1020
2020,4,A,골목상권,1000107,성덕정길,227,152,75
2020,4,A,골목상권,1000106,성덕정17길,393,244,149
2020,4,A,골목상권,1000105,서울숲2길,335,196,139
2020,4,A,골목상권,1000104,상원길,1919,1334,585
2020,4,A,골목상권,1000103,상원12길,398,238,160
2020,4,A,골목상권,1000102,사근동길,78,48,30
2020,4,A,골목상권,1000101,무학봉길,22,11,11
2020,4,A,골목상권,1000100,무학봉28길,143,69,74
2020,4,A,골목상권,1000099,무학로6길,1897,382,1515
2020,4,A,골목상권,1000098,무수막길,164,122,42
2020,4,A,골목상권,1000097,매봉길,60,30,30
2020,4,A,골목상권,1000096,마조로1길,30,14,16
2020,4,A,골목상권,1000095,마조로16길,155,93,62
2020,4,A,골목상권,1000094,마장로39길,443,258,185
2020,4,A,골목상권,1000093,마장로27길,197,92,105
2020,4,A,골목상권,1000092,뚝섬로5길,2136,1426,710
2020,4,A,골목상권,1000091,둘레9길,419,255,164
2020,4,A,골목상권,1000090,금호산길,159,83,76
2020,4,A,골목상권,1000089,금호산2길,22,12,10
2020,4,A,골목상권,1000088,고산자로6길,704,495,209
2020,4,A,골목상권,1000087,후암로28길,582,313,269
2020,4,A,골목상권,1000086,효창원로39길,163,87,76
2020,4,A,골목상권,1000085,회나무로13길,90,45,45
2020,4,A,골목상권,1000084,한남대로20길,231,131,100
2020,4,A,골목상권,1000083,한강대로88길,224,138,86
2020,4,A,골목상권,1000082,한강대로7길,722,462,260
2020,4,A,골목상권,1000081,한강대로62길,1047,535,512
2020,4,A,골목상권,1000080,한강대로52길,8713,2847,5866
2020,4,A,골목상권,1000079,한강대로43길,1841,1074,767
2020,4,A,골목상권,1000078,한강대로15길,774,417,357
2020,4,A,골목상권,1000077,한강대로104길,8152,1754,6398
2020,4,A,골목상권,1000076,청파로73길,248,128,120
2020,4,A,골목상권,1000075,청파로71길,1317,727,590
2020,4,A,골목상권,1000074,청파로47나길,259,176,83
2020,4,A,골목상권,1000073,청파로47길,192,87,105
2020,4,A,골목상권,1000072,장문로45길,242,106,136
2020,4,A,골목상권,1000071,이태원로54길,812,552,260
2020,4,A,골목상권,1000070,이태원로27길,567,430,137
2020,4,A,골목상권,1000069,이촌로22길,385,307,78
2020,4,A,골목상권,1000068,원효로89길,1387,969,418
2020,4,A,골목상권,1000067,원효로53길,341,222,119
2020,4,A,골목상권,1000066,원효로41길,243,153,90
2020,4,A,골목상권,1000065,원효로19길,609,435,174
2020,4,A,골목상권,1000064,우사단로4길,308,143,165
2020,4,A,골목상권,1000063,우사단로14길,1987,984,1003
2020,4,A,골목상권,1000062,우사단로10길,570,508,62
2020,4,A,골목상권,1000061,신흥로20길,178,118,60
2020,4,A,골목상권,1000060,소월로20길,151,76,75
2020,4,A,골목상권,1000059,서빙고로71길,432,265,167
2020,4,A,골목상권,1000058,백범로90길,535,288,247
2020,4,A,골목상권,1000057,백범로79길,899,560,339
2020,4,A,골목상권,1000056,두텁바위로1길,1111,483,628
2020,4,A,골목상권,1000055,대사관로34길,606,393,213
2020,4,A,골목상권,1000054,녹사평대로46길,43,19,24
2020,4,A,골목상권,1000053,녹사평대로40나길,46,21,25
2020,4,A,골목상권,1000052,녹사평대로32길,56,31,25
2020,4,A,골목상권,1000051,녹사평대로26길,494,230,264
2020,4,A,골목상권,1000050,녹사평대로11길,107,78,29
2020,4,A,골목상권,1000049,퇴계로90길,463,225,238
2020,4,A,골목상권,1000048,퇴계로8길,438,246,192
2020,4,A,골목상권,1000047,퇴계로56길,569,424,145
2020,4,A,골목상권,1000046,퇴계로46길,1098,613,485
2020,4,A,골목상권,1000045,퇴계로18길,967,435,532
2020,4,A,골목상권,1000044,퇴계로12길,180,103,77
2020,4,A,골목상권,1000043,청구로1길,108,72,36
2020,4,A,골목상권,1000042,청구로17길,485,306,179
2020,4,A,골목상권,1000041,장충단로8길,3778,1997,1781
2020,4,A,골목상권,1000040,삼일대로4길,1571,1113,458
2020,4,A,골목상권,1000039,명동길,7830,4550,3280
2020,4,A,골목상권,1000038,동호로8길,386,160,226
2020,4,A,골목상권,1000037,동호로20길,2429,1304,1125
2020,4,A,골목상권,1000036,동호로15길,1161,835,326
2020,4,A,골목상권,1000035,동호로11길,337,208,129
2020,4,A,골목상권,1000034,동호로10길,1553,857,696
2020,4,A,골목상권,1000033,다산로39길,39,19,20
2020,4,A,골목상권,1000032,다산로38길,674,311,363
2020,4,A,골목상권,1000031,다산로36길,91,55,36
2020,4,A,골목상권,1000030,다산로33길,320,201,119
2020,4,A,골목상권,1000029,난계로21길,128,93,35
2020,4,A,골목상권,1000028,난계로11길,255,170,85
2020,4,A,골목상권,1000027,필운대로1길,202,62,140
2020,4,A,골목상권,1000026,평창길,6654,2605,4049
2020,4,A,골목상권,1000025,통일로12길,13,6,7
2020,4,A,골목상권,1000024,창신길,146,29,117
2020,4,A,골목상권,1000023,창신5길,15,7,8
2020,4,A,골목상권,1000022,창신2길,56,26,30
2020,4,A,골목상권,1000021,창경궁로35길,787,171,616
2020,4,A,골목상권,1000020,지봉로8길,183,90,93
2020,4,A,골목상권,1000019,종로65길,275,157,118
2020,4,A,골목상권,1000018,종로58가길,137,71,66
2020,4,A,골목상권,1000017,종로24길,1011,716,295
2020,4,A,골목상권,1000016,자하문로7길,214,83,131
2020,4,A,골목상권,1000015,이화장길,497,221,276
2020,4,A,골목상권,1000014,율곡로16길,235,143,92
2020,4,A,골목상권,1000013,율곡로10길,313,206,107
2020,4,A,골목상권,1000012,옥인길,58,32,26
2020,4,A,골목상권,1000011,숭인동길,329,133,196
2020,4,A,골목상권,1000010,성균관로5길,148,84,64
2020,4,A,골목상권,1000009,삼청로5길,2703,2626,77
2020,4,A,골목상권,1000008,북촌로5나길,234,113,121
2020,4,A,골목상권,1000007,북촌로5길,503,419,84
2020,4,A,골목상권,1000006,북촌로11길,671,232,439
2020,4,A,골목상권,1000005,백석동길,1797,1066,731
2020,4,A,골목상권,1000004,명륜길,56,32,24
2020,4,A,골목상권,1000003,돈화문로11가길,3686,2700,986
2020,4,A,골목상권,1000002,난계로27길,201,114,87
2020,4,A,골목상권,1000001,계동길,842,388,454
2020,3,U,관광특구,1001496,강남 마이스 관광특구,15904,8904,7000
2020,3,U,관광특구,1001495,잠실 관광특구,24375,14199,10176
2020,3,U,관광특구,1001494,종로?청계 관광특구,32935,17150,15785
2020,3,U,관광특구,1001493,동대문패션타운 관광특구,6054,2958,3096
2020,3,U,관광특구,1001492,명동 남대문 북창동 다동 무교동 관광특구,104830,53674,51156
2020,3,U,관광특구,1001491,이태원 관광특구,5839,3064,2775
2020,3,R,전통시장,1001490,길동복조리시장,430,242,188
2020,3,R,전통시장,1001489,둔촌역전통시장,224,108,116
2020,3,R,전통시장,1001488,성내골목시장,30,18,12
2020,3,R,전통시장,1001487,천호시장,35,19,16
2020,3,R,전통시장,1001486,동서울시장,5,3,2
2020,3,R,전통시장,1001484,양지골목시장,60,36,24
2020,3,R,전통시장,1001483,암사종합시장,95,53,42
2020,3,R,전통시장,1001482,고덕전통시장,935,850,85
2020,3,R,전통시장,1001481,명일골목시장,89,30,59
2020,3,R,전통시장,1001480,새마을시장,208,122,86
2020,3,R,전통시장,1001479,석촌시장,286,99,187
2020,3,R,전통시장,1001478,방이시장,3469,1526,1943
2020,3,R,전통시장,1001477,마천시장,102,70,32
2020,3,R,전통시장,1001476,풍납시장,51,20,31
2020,3,R,전통시장,1001475,강남개포시장,138,84,54
2020,3,R,전통시장,1001474,도곡시장,57,25,32
2020,3,R,전통시장,1001473,청담삼익시장,48,30,18
2020,3,R,전통시장,1001472,논현종합시장,85,43,42
2020,3,R,전통시장,1001471,영동전통시장,242,95,147
2020,3,R,전통시장,1001470,강남시장_강남,58,33,25
2020,3,R,전통시장,1001469,양재시장,35,22,13
2020,3,R,전통시장,1001468,남부종합시장,85,63,22
2020,3,R,전통시장,1001467,우림시장,1,0,1
2020,3,R,전통시장,1001466,미성동도깨비시장,75,16,59
2020,3,R,전통시장,1001463,신림중앙시장,43,27,16
2020,3,R,전통시장,1001462,강남골목시장,168,124,44
2020,3,R,전통시장,1001461,신림종합시장,8,7,1
2020,3,R,전통시장,1001460,관악신사시장,120,63,57
2020,3,R,전통시장,1001459,신원시장,42,21,21
2020,3,R,전통시장,1001458,인헌시장,122,46,76
2020,3,R,전통시장,1001457,봉천중앙시장,154,42,112
2020,3,R,전통시장,1001455,봉일시장,44,23,21
2020,3,R,전통시장,1001454,봉천제일종합시장,6,1,5
2020,3,R,전통시장,1001453,낙성대시장,10,6,4
2020,3,R,전통시장,1001452,중부시장,102,40,62
2020,3,R,전통시장,1001451,사당시장,45,20,25
2020,3,R,전통시장,1001450,남성역골목시장,467,268,199
2020,3,R,전통시장,1001449,남성사계시장,136,59,77
2020,3,R,전통시장,1001448,흑석시장,78,31,47
2020,3,R,전통시장,1001447,상도4동도깨비골목시장,95,49,46
2020,3,R,전통시장,1001446,성대시장,141,55,86
2020,3,R,전통시장,1001445,영도시장,73,6,67
2020,3,R,전통시장,1001444,상도전통시장,239,104,135
2020,3,R,전통시장,1001442,신노량진시장,11,3,8
2020,3,R,전통시장,1001441,본동인정시장,59,41,18
2020,3,R,전통시장,1001440,노량진중앙시장,244,157,87
2020,3,R,전통시장,1001439,대림중앙시장,42,29,13
2020,3,R,전통시장,1001438,우리시장,6,5,1
2020,3,R,전통시장,1001436,사러가시장,57,35,22
2020,3,R,전통시장,1001435,대신시장,12,9,3
2020,3,R,전통시장,1001433,영일시장,155,115,40
2020,3,R,전통시장,1001432,도림시장,6,4,2
2020,3,R,전통시장,1001431,영등포청과시장,23,17,6
2020,3,R,전통시장,1001430,영등포전통시장,2127,1061,1066
2020,3,R,전통시장,1001429,은행나무시장,67,40,27
2020,3,R,전통시장,1001428,박미시장,39,26,13
2020,3,R,전통시장,1001427,현대시장,139,42,97
2020,3,R,전통시장,1001426,대명시장,28,11,17
2020,3,R,전통시장,1001425,푸른터시장,3,2,1
2020,3,R,전통시장,1001424,남문시장,76,47,29
2020,3,R,전통시장,1001423,독산동 우시장,611,476,135
2020,3,R,전통시장,1001422,오류시장,132,21,111
2020,3,R,전통시장,1001421,개봉중앙시장,10,7,3
2020,3,R,전통시장,1001420,고척근린시장,55,19,36
2020,3,R,전통시장,1001418,남구로시장,236,135,101
2020,3,R,전통시장,1001417,구로시장,10,5,5
2020,3,R,전통시장,1001415,방신전통시장,116,81,35
2020,3,R,전통시장,1001414,송화골목시장,119,44,75
2020,3,R,전통시장,1001413,까치산시장,114,35,79
2020,3,R,전통시장,1001412,화곡본동시장,36,16,20
2020,3,R,전통시장,1001411,남부골목시장,156,58,98
2020,3,R,전통시장,1001410,대원종합시장,9,7,2
2020,3,R,전통시장,1001409,화곡중앙골목시장,75,32,43
2020,3,R,전통시장,1001408,신월중앙시장,118,53,65
2020,3,R,전통시장,1001406,신정3동골목시장,123,81,42
2020,3,R,전통시장,1001405,신정2동골목시장,41,13,28
2020,3,R,전통시장,1001404,신정제일시장,38,21,17
2020,3,R,전통시장,1001403,신월7동골목시장,24,16,8
2020,3,R,전통시장,1001402,신월6동골목시장,141,103,38
2020,3,R,전통시장,1001400,신월3동골목시장,12,7,5
2020,3,R,전통시장,1001399,경창시장,53,23,30
2020,3,R,전통시장,1001398,월정로시장,61,42,19
2020,3,R,전통시장,1001397,신영시장,40,13,27
2020,3,R,전통시장,1001396,목4동시장,52,35,17
2020,3,R,전통시장,1001395,목3동시장,148,67,81
2020,3,R,전통시장,1001394,목2동시장,432,251,181
2020,3,R,전통시장,1001393,마포농수산물시장,77,40,37
2020,3,R,전통시장,1001392,동진시장,10,6,4
2020,3,R,전통시장,1001391,망원월드컵시장,190,123,67
2020,3,R,전통시장,1001390,망원시장,173,81,92
2020,3,R,전통시장,1001388,영진시장,29,14,15
2020,3,R,전통시장,1001387,서교시장,24,10,14
2020,3,R,전통시장,1001386,신수시장,34,19,15
2020,3,R,전통시장,1001385,아현시장,803,430,373
2020,3,R,전통시장,1001384,마포시장,11,3,8
2020,3,R,전통시장,1001383,공덕시장,3948,2001,1947
2020,3,R,전통시장,1001382,백련시장,5,3,2
2020,3,R,전통시장,1001381,모래내시장,14,9,5
2020,3,R,전통시장,1001380,포방터시장,35,23,12
2020,3,R,전통시장,1001379,인왕시장,44,7,37
2020,3,R,전통시장,1001378,아현가구거리상점가,45,22,23
2020,3,R,전통시장,1001377,영천시장,35,19,16
2020,3,R,전통시장,1001376,수일시장,7,2,5
2020,3,R,전통시장,1001375,증산종합시장,8,5,3
2020,3,R,전통시장,1001374,대림골목시장,237,46,191
2020,3,R,전통시장,1001373,신응암시장,17,10,7
2020,3,R,전통시장,1001372,녹번시장,22,9,13
2020,3,R,전통시장,1001371,대조시장,15,7,8
2020,3,R,전통시장,1001370,역촌중앙시장,9,3,6
2020,3,R,전통시장,1001369,갈현시장,287,186,101
2020,3,R,전통시장,1001368,연서시장,206,144,62
2020,3,R,전통시장,1001367,상계중앙시장,105,59,46
2020,3,R,전통시장,1001366,상계시장,8,2,6
2020,3,R,전통시장,1001365,공릉동도깨비시장,98,47,51
2020,3,R,전통시장,1001364,방학동도깨비시장,39,16,23
2020,3,R,전통시장,1001363,쌍문역골목시장,61,14,47
2020,3,R,전통시장,1001362,백운시장,33,14,19
2020,3,R,전통시장,1001361,신도봉시장,5,5,0
2020,3,R,전통시장,1001360,창동골목시장,84,47,37
2020,3,R,전통시장,1001359,창동신창시장,104,40,64
2020,3,R,전통시장,1001358,수유북부시장,20,14,6
2020,3,R,전통시장,1001357,장미원골목시장,911,571,340
2020,3,R,전통시장,1001356,수유중앙시장,13,8,5
2020,3,R,전통시장,1001355,강북종합시장,23,9,14
2020,3,R,전통시장,1001354,우이시장,69,61,8
2020,3,R,전통시장,1001353,수유전통시장,231,55,176
2020,3,R,전통시장,1001352,번동북부골목시장,50,25,25
2020,3,R,전통시장,1001351,솔샘시장,73,30,43
2020,3,R,전통시장,1001350,숭인시장,62,27,35
2020,3,R,전통시장,1001349,방천골목시장,92,55,37
2020,3,R,전통시장,1001348,동북시장,121,49,72
2020,3,R,전통시장,1001347,석관황금시장,191,157,34
2020,3,R,전통시장,1001345,새석관시장,3,1,2
2020,3,R,전통시장,1001343,장위전통시장,40,20,20
2020,3,R,전통시장,1001342,밤나무골시장,17,5,12
2020,3,R,전통시장,1001341,길음시장,91,19,72
2020,3,R,전통시장,1001340,정릉시장,131,72,59
2020,3,R,전통시장,1001339,정릉아리랑시장,22,7,15
2020,3,R,전통시장,1001338,돈암제일시장,97,22,75
2020,3,R,전통시장,1001337,유영시장,31,20,11
2020,3,R,전통시장,1001336,우림골목시장,344,118,226
2020,3,R,전통시장,1001335,묵1동도깨비시장,35,24,11
2020,3,R,전통시장,1001334,태능시장,81,34,47
2020,3,R,전통시장,1001333,중화제일시장,69,30,39
2020,3,R,전통시장,1001332,사가정시장,86,28,58
2020,3,R,전통시장,1001331,면목골목시장,45,21,24
2020,3,R,전통시장,1001330,동원시장,224,109,115
2020,3,R,전통시장,1001329,동부골목시장,179,59,120
2020,3,R,전통시장,1001327,이경시장,16,8,8
2020,3,R,전통시장,1001326,회기시장,55,17,38
2020,3,R,전통시장,1001325,청량리청과물시장,12,9,3
2020,3,R,전통시장,1001324,전곡시장,77,42,35
2020,3,R,전통시장,1001323,답십리시장,93,40,53
2020,3,R,전통시장,1001322,동부시장,14,9,5
2020,3,R,전통시장,1001321,답십리현대시장,36,31,5
2020,3,R,전통시장,1001320,전농로터리시장,7,3,4
2020,3,R,전통시장,1001319,청량리종합시장,13,8,5
2020,3,R,전통시장,1001318,청량리전통시장,9,7,2
2020,3,R,전통시장,1001316,서울약령시장,1171,642,529
2020,3,R,전통시장,1001315,동서시장,5,3,2
2020,3,R,전통시장,1001314,경동시장,130,61,69
2020,3,R,전통시장,1001313,청량리수산시장,20,11,9
2020,3,R,전통시장,1001312,용두시장,4,2,2
2020,3,R,전통시장,1001309,조양시장,31,19,12
2020,3,R,전통시장,1001308,영동교골목시장,41,30,11
2020,3,R,전통시장,1001307,능동로골목시장,56,42,14
2020,3,R,전통시장,1001306,노룬산골목시장,23,13,10
2020,3,R,전통시장,1001305,자양종합시장,14,10,4
2020,3,R,전통시장,1001304,자양골목시장,54,36,18
2020,3,R,전통시장,1001303,신성골목시장,19,6,13
2020,3,R,전통시장,1001302,면곡골목시장,49,35,14
2020,3,R,전통시장,1001301,중곡제일시장,111,68,43
2020,3,R,전통시장,1001300,화양제일골목시장,43,11,32
2020,3,R,전통시장,1001299,한아름시장,40,29,11
2020,3,R,전통시장,1001298,성동용답상가시장,66,33,33
2020,3,R,전통시장,1001297,뚝도시장,45,17,28
2020,3,R,전통시장,1001296,금남시장,36,13,23
2020,3,R,전통시장,1001295,행당시장,314,140,174
2020,3,R,전통시장,1001294,마장축산물시장,532,358,174
2020,3,R,전통시장,1001293,보광시장,31,12,19
2020,3,R,전통시장,1001292,이태원제일시장,2,1,1
2020,3,R,전통시장,1001291,이태원시장,32,20,12
2020,3,R,전통시장,1001290,이촌종합시장,109,78,31
2020,3,R,전통시장,1001289,용문전통시장,19,10,9
2020,3,R,전통시장,1001288,만리시장,12,9,3
2020,3,R,전통시장,1001287,신흥시장,4,1,3
2020,3,R,전통시장,1001286,후암시장,15,14,1
2020,3,R,전통시장,1001285,합동(새벽)시장,365,209,156
2020,3,R,전통시장,1001284,서울중앙시장,451,320,131
2020,3,R,전통시장,1001283,백학시장,95,43,52
2020,3,R,전통시장,1001282,약수시장,271,105,166
2020,3,R,전통시장,1001281,청평화시장,120,50,70
2020,3,R,전통시장,1001280,제일평화시장,53,29,24
2020,3,R,전통시장,1001279,동평화시장,178,121,57
2020,3,R,전통시장,1001278,남평화시장,5,3,2
2020,3,R,전통시장,1001277,방산종합시장,1190,736,454
2020,3,R,전통시장,1001276,평화시장,906,614,292
2020,3,R,전통시장,1001275,인현시장,167,123,44
2020,3,R,전통시장,1001274,신중부시장,3089,921,2168
2020,3,R,전통시장,1001273,남대문시장,8186,3966,4220
2020,3,R,전통시장,1001272,신설종합시장,50,37,13
2020,3,R,전통시장,1001271,동묘시장,474,223,251
2020,3,R,전통시장,1001270,창신골목시장,13,7,6
2020,3,R,전통시장,1001269,동문시장,3,1,2
2020,3,R,전통시장,1001268,충신시장,77,40,37
2020,3,R,전통시장,1001267,종로신진시장,158,89,69
2020,3,R,전통시장,1001266,동대문종합시장,1319,965,354
2020,3,R,전통시장,1001265,광장시장,444,301,143
2020,3,R,전통시장,1001264,통인시장,59,29,30
2020,3,D,발달상권,1001263,서울 노원구 노원역_3,418,159,259
2020,3,D,발달상권,1001262,서울 노원구 노원역_2,274,126,148
2020,3,D,발달상권,1001261,서울 노원구 노원역_1,336,86,250
2020,3,D,발달상권,1001260,창동역,1003,570,433
2020,3,D,발달상권,1001259,서울 강북구 수유역_3,70,36,34
2020,3,D,발달상권,1001258,등나무근린공원 주변,65,19,46
2020,3,D,발달상권,1001257,서울 강북구 수유역_2,2284,1108,1176
2020,3,D,발달상권,1001256,서울 강북구 수유역_1,831,408,423
2020,3,D,발달상권,1001255,서울 은평구 연신내역_3,108,20,88
2020,3,D,발달상권,1001254,서울 은평구 연신내역_2,555,168,387
2020,3,D,발달상권,1001253,서울 은평구 연신내역_1,70,25,45
2020,3,D,발달상권,1001252,서울 성북구 미아삼거리역_2,322,144,178
2020,3,D,발달상권,1001251,서울 강북구 미아삼거리역_1,140,86,54
2020,3,D,발달상권,1001250,서울 은평구 불광역_3,67,24,43
2020,3,D,발달상권,1001249,서울 은평구 불광역_2,116,39,77
2020,3,D,발달상권,1001248,서울 은평구 불광역_1,180,73,107
2020,3,D,발달상권,1001247,미아사거리_2,102,47,55
2020,3,D,발달상권,1001246,미아사거리_1,210,68,142
2020,3,D,발달상권,1001245,서울 성북구 성신여대입구역,2865,1629,1236
2020,3,D,발달상권,1001244,경희대학교,70,24,46
2020,3,D,발달상권,1001243,서울 성북구 안암역,59,28,31
2020,3,D,발달상권,1001242,혜화역 대학로_3,477,210,267
2020,3,D,발달상권,1001241,혜화역 대학로_2,334,256,78
2020,3,D,발달상권,1001240,혜화역 대학로_1,1230,573,657
2020,3,D,발달상권,1001239,디지털미디어시티,6727,3880,2847
2020,3,D,발달상권,1001238,서울 동대문구 청량리역,776,413,363
2020,3,D,발달상권,1001237,서울 종로구 경복궁역_2,239,107,132
2020,3,D,발달상권,1001236,서울 종로구 안국역_2,810,409,401
2020,3,D,발달상권,1001235,서울 종로구 안국역_1,8804,7324,1480
2020,3,D,발달상권,1001234,서울 종로구 경복궁역_1,599,413,186
2020,3,D,발달상권,1001233,서울 종로구 종로3가역_3,2136,1442,694
2020,3,D,발달상권,1001232,서울 종로구 종로3가역_2,1823,948,875
2020,3,D,발달상권,1001231,서울 동대문구 신설동역_2,5440,2247,3193
2020,3,D,발달상권,1001230,인사동,26072,14829,11243
2020,3,D,발달상권,1001229,서울 종로구 종로5가역_4,1358,810,548
2020,3,D,발달상권,1001228,서울 종로구 종로5가역_3,1766,1160,606
2020,3,D,발달상권,1001227,종로구청,20709,10947,9762
2020,3,D,발달상권,1001226,서울 종로구 종로5가역_2,16173,10184,5989
2020,3,D,발달상권,1001225,신설동역,118,54,64
2020,3,D,발달상권,1001224,서울 동대문구 신설동역_1,1543,677,866
2020,3,D,발달상권,1001223,서울 종로구 광화문역_2,27999,17199,10800
2020,3,D,발달상권,1001222,동묘앞역,223,138,85
2020,3,D,발달상권,1001221,장안동사거리,1587,632,955
2020,3,D,발달상권,1001220,서울 종로구 동대문역_2,748,244,504
2020,3,D,발달상권,1001219,서울 종로구 동대문역_1,28,17,11
2020,3,D,발달상권,1001218,동대문시장_2,195,123,72
2020,3,D,발달상권,1001217,서울 종로구 종로5가역_1,22,9,13
2020,3,D,발달상권,1001216,서울 종로구 종로3가역_1,2657,1167,1490
2020,3,D,발달상권,1001215,서울 종로구 광화문역_1,12759,8498,4261
2020,3,D,발달상권,1001214,종각역,10396,8086,2310
2020,3,D,발달상권,1001213,종각역 젊음의 거리,13040,3576,9464
2020,3,D,발달상권,1001212,서대문구 서대문역_1,99,67,32
2020,3,D,발달상권,1001211,동대문시장_1,1663,493,1170
2020,3,D,발달상권,1001210,시청역_2,14646,9603,5043
2020,3,D,발달상권,1001209,서울시청,9257,4890,4367
2020,3,D,발달상권,1001208,서울 중구 을지로3가역_2,3181,2166,1015
2020,3,D,발달상권,1001207,서울 중구 신당역_2,939,534,405
2020,3,D,발달상권,1001206,서대문구 서대문역_2,1486,1018,468
2020,3,D,발달상권,1001205,동대문역사문화공원역,3166,2548,618
2020,3,D,발달상권,1001204,서울 중구 을지로3가역_1,4549,2258,2291
2020,3,D,발달상권,1001203,명동거리,8147,4244,3903
2020,3,D,발달상권,1001202,롯데백화점,27149,9657,17492
2020,3,D,발달상권,1001201,서울 중구 신당역_1,277,142,135
2020,3,D,발달상권,1001200,북창동,5197,3160,2037
2020,3,D,발달상권,1001199,서울 중구 충무로역_2,16329,7851,8478
2020,3,D,발달상권,1001198,서울 강서구 송정역,335,140,195
2020,3,D,발달상권,1001197,장한평역_2,1492,995,497
2020,3,D,발달상권,1001196,시청역_1,24904,15705,9199
2020,3,D,발달상권,1001195,왕십리역_2,233,102,131
2020,3,D,발달상권,1001194,서울 강서구 발산역,983,431,552
2020,3,D,발달상권,1001193,장한평역_1,1129,748,381
2020,3,D,발달상권,1001192,서울 중구 충무로역_1,3743,2160,1583
2020,3,D,발달상권,1001191,왕십리역_1,8,2,6
2020,3,D,발달상권,1001190,장한평역,3644,2178,1466
2020,3,D,발달상권,1001189,서울 중구 명동역,3595,1952,1643
2020,3,D,발달상권,1001188,장충동 족발거리,2100,985,1115
2020,3,D,발달상권,1001187,한양시장,55,30,25
2020,3,D,발달상권,1001186,서울 서대문구 이대역,380,160,220
2020,3,D,발달상권,1001185,서울 서대문구 신촌역,924,404,520
2020,3,D,발달상권,1001184,서울 마포구 홍대입구역_3,659,386,273
2020,3,D,발달상권,1001183,서울 마포구 홍대입구역_2,977,535,442
2020,3,D,발달상권,1001182,홍익대학교 주변,8725,5062,3663
2020,3,D,발달상권,1001181,서울 광진구 군자역,621,342,279
2020,3,D,발달상권,1001180,신촌역,4403,2012,2391
2020,3,D,발달상권,1001179,강서구청,4278,2468,1810
2020,3,D,발달상권,1001178,서울 마포구 홍대입구역_1,1618,826,792
2020,3,D,발달상권,1001177,서울 중구 약수역_2,210,91,119
2020,3,D,발달상권,1001176,서울 중구 약수역_1,24,6,18
2020,3,D,발달상권,1001175,서울 강동구 고덕역,1359,916,443
2020,3,D,발달상권,1001174,등촌역,64,37,27
2020,3,D,발달상권,1001173,서울 강동구 명일역,671,252,419
2020,3,D,발달상권,1001172,어린이대공원역,41,17,24
2020,3,D,발달상권,1001171,서울 마포구 공덕역_2,3697,2404,1293
2020,3,D,발달상권,1001170,공덕역,2092,1198,894
2020,3,D,발달상권,1001169,서울 용산구 숙대입구역,3807,1436,2371
2020,3,D,발달상권,1001168,남영역,4055,2796,1259
2020,3,D,발달상권,1001167,서울 마포구 공덕역_1,2420,796,1624
2020,3,D,발달상권,1001166,서울 마포구 마포역_2,10151,6130,4021
2020,3,D,발달상권,1001165,서울 광진구 건대입구역_2,529,268,261
2020,3,D,발달상권,1001164,서울 마포구 마포역_1,3369,2292,1077
2020,3,D,발달상권,1001163,서울 강동구 천호역_2,1208,565,643
2020,3,D,발달상권,1001162,서울 광진구 건대입구역_1,109,52,57
2020,3,D,발달상권,1001161,건대입구역,24,11,13
2020,3,D,발달상권,1001160,서울 광진구 구의역,928,584,344
2020,3,D,발달상권,1001159,서울 강동구 천호역,259,93,166
2020,3,D,발달상권,1001158,당산역_2,1429,1069,360
2020,3,D,발달상권,1001157,서울 강동구 천호역_1,138,57,81
2020,3,D,발달상권,1001156,서울 강동구 길동역,2628,1190,1438
2020,3,D,발달상권,1001155,용산 전자상가_5,1976,1461,515
2020,3,D,발달상권,1001154,용산 전자상가_4,248,182,66
2020,3,D,발달상권,1001153,당산역_1,310,186,124
2020,3,D,발달상권,1001152,서울 광진구 강변역,1337,859,478
2020,3,D,발달상권,1001151,용산 전자상가_3,1752,1311,441
2020,3,D,발달상권,1001150,서울 용산구 이태원역,452,292,160
2020,3,D,발달상권,1001149,한남오거리,823,524,299
2020,3,D,발달상권,1001148,목동사거리,41,13,28
2020,3,D,발달상권,1001147,용산 전자상가_2,392,317,75
2020,3,D,발달상권,1001146,용산구청,1526,755,771
2020,3,D,발달상권,1001145,용산 전자상가_1,3893,2851,1042
2020,3,D,발달상권,1001144,국회의사당역_2,19439,11619,7820
2020,3,D,발달상권,1001143,서울 용산구 신용산역,979,675,304
2020,3,D,발달상권,1001142,국회의사당역_1,4563,3517,1046
2020,3,D,발달상권,1001141,압구정 로데오거리_2,7107,2323,4784
2020,3,D,발달상권,1001140,서울 강남구 압구정역,9345,4345,5000
2020,3,D,발달상권,1001139,서울 영등포구 영등포구청역,449,275,174
2020,3,D,발달상권,1001138,압구정 로데오거리_1,14564,7168,7396
2020,3,D,발달상권,1001137,서울 강동구 둔촌동역,250,102,148
2020,3,D,발달상권,1001136,오목교역,125,72,53
2020,3,D,발달상권,1001135,신사동 가로수길,14671,7582,7089
2020,3,D,발달상권,1001134,서울 영등포구 여의도역_2,33585,23274,10311
2020,3,D,발달상권,1001133,청담사거리_3,1376,693,683
2020,3,D,발달상권,1001132,영등포유통상가,1504,962,542
2020,3,D,발달상권,1001131,청담역_2,4142,3212,930
2020,3,D,발달상권,1001130,청담역_1,4062,2913,1149
2020,3,D,발달상권,1001129,청담사거리_2,1289,759,530
2020,3,D,발달상권,1001128,청담사거리_1,529,295,234
2020,3,D,발달상권,1001127,서울 영등포구 여의도역_1,27015,17171,9844
2020,3,D,발달상권,1001126,서울 양천구 신정네거리역_2,28,18,10
2020,3,D,발달상권,1001125,학동사거리_2,2498,1332,1166
2020,3,D,발달상권,1001124,서울 영등포구 영등포시장역,411,246,165
2020,3,D,발달상권,1001123,학동사거리_1,4075,2555,1520
2020,3,D,발달상권,1001122,여의도 시범아파트앞,10435,6976,3459
2020,3,D,발달상권,1001121,영등포역_3,121,70,51
2020,3,D,발달상권,1001120,도산공원사거리_1,4075,1954,2121
2020,3,D,발달상권,1001119,영등포역_2,583,245,338
2020,3,D,발달상권,1001118,문래동 주민센터,6184,3312,2872
2020,3,D,발달상권,1001117,강남구 신사역_2,6953,3586,3367
2020,3,D,발달상권,1001116,영등포역_1,77,27,50
2020,3,D,발달상권,1001115,서울 강남구 강남구청역_2,3172,1916,1256
2020,3,D,발달상권,1001114,강남구 신사역_1,1108,570,538
2020,3,D,발달상권,1001113,서울 동작구 노량진1동_1,40,25,15
2020,3,D,발달상권,1001112,서울 강남구 학동역_3,3152,1780,1372
2020,3,D,발달상권,1001111,서울 강남구 강남구청역_1,3516,2335,1181
2020,3,D,발달상권,1001110,잠실역,42527,22605,19922
2020,3,D,발달상권,1001109,강남구 논현역_4,4927,2720,2207
2020,3,D,발달상권,1001108,학동역,1014,616,398
2020,3,D,발달상권,1001107,방이동 먹자골목,6881,4444,2437
2020,3,D,발달상권,1001106,서울 강남구 학동역_2,2510,1674,836
2020,3,D,발달상권,1001105,서울 동작구 노량진역,436,252,184
2020,3,D,발달상권,1001104,삼성역_3,52277,41226,11051
2020,3,D,발달상권,1001103,코엑스,15904,8904,7000
2020,3,D,발달상권,1001102,서울 강남구 학동역_1,1691,1037,654
2020,3,D,발달상권,1001101,선정릉역_2,3758,2684,1074
2020,3,D,발달상권,1001100,강남구 논현역_3,2466,700,1766
2020,3,D,발달상권,1001099,포스코사거리_2,16526,9641,6885
2020,3,D,발달상권,1001098,포스코사거리_1,22702,15610,7092
2020,3,D,발달상권,1001097,잠실역 롯데월드,2247,1185,1062
2020,3,D,발달상권,1001096,신도림역,1674,907,767
2020,3,D,발달상권,1001095,강남구 논현역_2,9009,5256,3753
2020,3,D,발달상권,1001094,선정릉역_1,2392,1492,900
2020,3,D,발달상권,1001093,신천역,4789,2992,1797
2020,3,D,발달상권,1001092,강남구 논현역_1,2284,1208,1076
2020,3,D,발달상권,1001091,삼성역_2,7062,3420,3642
2020,3,D,발달상권,1001090,삼정역_2,1162,721,441
2020,3,D,발달상권,1001089,삼정역_1,2277,1123,1154
2020,3,D,발달상권,1001088,삼성역_1,18695,12565,6130
2020,3,D,발달상권,1001087,서울 강남구 선릉역_2,40183,20392,19791
2020,3,D,발달상권,1001086,고속터미널역,2010,1612,398
2020,3,D,발달상권,1001085,서울 서초구 강남역,19954,10752,9202
2020,3,D,발달상권,1001084,서울 강남구 선릉역_1,21572,9107,12465
2020,3,D,발달상권,1001083,서울 송파구 석촌역_2,597,380,217
2020,3,D,발달상권,1001082,선릉역_2,26260,16412,9848
2020,3,D,발달상권,1001081,서울 강남구 역삼역_2,19179,15530,3649
2020,3,D,발달상권,1001080,서울 송파구 석촌역_1,168,96,72
2020,3,D,발달상권,1001079,석촌역,170,135,35
2020,3,D,발달상권,1001078,서울 강남구 강남역_2,9449,4629,4820
2020,3,D,발달상권,1001077,선릉역_1,16454,10830,5624
2020,3,D,발달상권,1001076,구로역,201,101,100
2020,3,D,발달상권,1001075,역삼역_2,10137,4381,5756
2020,3,D,발달상권,1001074,대림역_2,5179,3395,1784
2020,3,D,발달상권,1001073,서울 강남구 역삼역_1,22546,15049,7497
2020,3,D,발달상권,1001072,신대방삼거리역,259,129,130
2020,3,D,발달상권,1001071,서울 강남구 한티역,673,371,302
2020,3,D,발달상권,1001070,은마아파트입구사거리_4,570,252,318
2020,3,D,발달상권,1001069,은마아파트입구사거리_3,103,45,58
2020,3,D,발달상권,1001068,은마아파트입구사거리_2,15650,5160,10490
2020,3,D,발달상권,1001067,오류동역,2297,1736,561
2020,3,D,발달상권,1001066,서울 강남구 강남역,27566,14310,13256
2020,3,D,발달상권,1001065,은마아파트입구사거리_1,277,92,185
2020,3,D,발달상권,1001064,대림역_1,340,205,135
2020,3,D,발달상권,1001063,교대역_4,6267,3940,2327
2020,3,D,발달상권,1001062,서울 강남구 강남역_1,25938,14288,11650
2020,3,D,발달상권,1001061,방배동카페골목,374,218,156
2020,3,D,발달상권,1001059,교대역_3,1005,649,356
2020,3,D,발달상권,1001058,역삼역_1,10667,5507,5160
2020,3,D,발달상권,1001057,교대역_2,3971,2510,1461
2020,3,D,발달상권,1001056,서울 송파구 가락시장역,5421,3249,2172
2020,3,D,발달상권,1001055,서울 서초구 서초역,1858,988,870
2020,3,D,발달상권,1001054,서울 강남구 대치역_2,1139,629,510
2020,3,D,발달상권,1001053,서울 강남구 대치역_1,102,38,64
2020,3,D,발달상권,1001052,뱅뱅사거리_2,12301,8384,3917
2020,3,D,발달상권,1001051,보라매공원,2417,1455,962
2020,3,D,발달상권,1001050,교대역_1,17722,8352,9370
2020,3,D,발달상권,1001049,개봉동 현대아파트 인근,271,126,145
2020,3,D,발달상권,1001048,뱅뱅사거리,7114,4891,2223
2020,3,D,발달상권,1001047,뱅뱅사거리_1,4820,3658,1162
2020,3,D,발달상권,1001046,서울 관악구 신림역_4,332,165,167
2020,3,D,발달상권,1001045,동작구 총신대입구역_1,327,125,202
2020,3,D,발달상권,1001044,양재역_3,9025,5664,3361
2020,3,D,발달상권,1001043,동작구 총신대입구역_2,1633,741,892
2020,3,D,발달상권,1001042,서울 서초구 남부터미널역_3,3060,1217,1843
2020,3,D,발달상권,1001041,서울 강남구 수서역,12418,6339,6079
2020,3,D,발달상권,1001040,서울 관악구 신림역_3,77,20,57
2020,3,D,발달상권,1001039,서울 서초구 남부터미널역_2,3012,1965,1047
2020,3,D,발달상권,1001038,구로디지탈1단지,43655,28446,15209
2020,3,D,발달상권,1001037,양재역,904,474,430
2020,3,D,발달상권,1001036,문정역,88,52,36
2020,3,D,발달상권,1001035,매봉역,5760,4107,1653
2020,3,D,발달상권,1001034,서울 서초구 방배역,1690,910,780
2020,3,D,발달상권,1001033,서울 서초구 남부터미널역_1,2033,1323,710
2020,3,D,발달상권,1001032,서울 관악구 신림역_2,166,63,103
2020,3,D,발달상권,1001031,서울 관악구 신림역_1,615,316,299
2020,3,D,발달상권,1001030,양재역_2,2634,1725,909
2020,3,D,발달상권,1001029,양재역_1,515,305,210
2020,3,D,발달상권,1001028,서울 관악구 서울대입구역_2,57,28,29
2020,3,D,발달상권,1001027,가산디지털단지역_3,22935,14390,8545
2020,3,D,발달상권,1001026,구로디지털단지역,91,67,24
2020,3,D,발달상권,1001025,서울 관악구 서울대입구역_1,1502,797,705
2020,3,D,발달상권,1001024,관악구 사당역_1,5523,2253,3270
2020,3,D,발달상권,1001023,가산디지털단지역_2,25194,16241,8953
2020,3,D,발달상권,1001022,관악구 사당역_2,744,453,291
2020,3,D,발달상권,1001021,가산디지털단지역_1,18317,12138,6179
2020,3,D,발달상권,1001020,장지역,4411,3129,1282
2020,3,D,발달상권,1001019,포이사거리_1,192,141,51
2020,3,D,발달상권,1001018,포이사거리_2,7673,5359,2314
2020,3,D,발달상권,1001017,관악구 사당역_3,1538,1135,403
2020,3,D,발달상권,1001016,서울 관악구 대학동_1,662,558,104
2020,3,D,발달상권,1001015,서울 금천구 독산1동_1,716,485,231
2020,3,D,발달상권,1001014,양재동 꽃시장,1540,858,682
2020,3,D,발달상권,1001013,양재 화물트럭터미널앞_2,843,619,224
2020,3,D,발달상권,1001012,양재 화물트럭터미널앞_1,1944,1643,301
2020,3,D,발달상권,1001011,서울 금천구 시흥1동_4,486,164,322
2020,3,A,골목상권,1001010,풍성로37가길,128,57,71
2020,3,A,골목상권,1001009,천호옛길,420,288,132
2020,3,A,골목상권,1001008,천호옛14길,177,93,84
2020,3,A,골목상권,1001007,천호대로219길,486,338,148
2020,3,A,골목상권,1001006,천호대로197길,239,168,71
2020,3,A,골목상권,1001005,천호대로187길,371,200,171
2020,3,A,골목상권,1001004,천호대로170길,303,177,126
2020,3,A,골목상권,1001003,천호대로162길,286,149,137
2020,3,A,골목상권,1001002,천중로51길,761,536,225
2020,3,A,골목상권,1001001,천중로39길,574,375,199
2020,3,A,골목상권,1001000,진황도로47길,131,63,68
2020,3,A,골목상권,1000999,진황도로27길,298,174,124
2020,3,A,골목상권,1000998,올림픽로98길,257,169,88
2020,3,A,골목상권,1000997,올림픽로80길,152,54,98
2020,3,A,골목상권,1000996,올림픽로78길,115,58,57
2020,3,A,골목상권,1000995,올림픽로77길,210,114,96
2020,3,A,골목상권,1000994,올림픽로71길,184,101,83
2020,3,A,골목상권,1000993,올림픽로48길,1847,1272,575
2020,3,A,골목상권,1000992,양재대로96길,197,131,66
2020,3,A,골목상권,1000991,양재대로95길,602,324,278
2020,3,A,골목상권,1000990,양재대로91길,358,230,128
2020,3,A,골목상권,1000989,양재대로133길,189,122,67
2020,3,A,골목상권,1000988,양재대로124길,435,258,177
2020,3,A,골목상권,1000987,양재대로116길,75,41,34
2020,3,A,골목상권,1000986,양재대로101길,677,313,364
2020,3,A,골목상권,1000985,암사길,112,70,42
2020,3,A,골목상권,1000984,성안로3길,5508,4242,1266
2020,3,A,골목상권,1000983,성내로5길,1005,650,355
2020,3,A,골목상권,1000982,상일로5길,172,124,48
2020,3,A,골목상권,1000981,상암로5길,271,99,172
2020,3,A,골목상권,1000980,상암로51길,302,122,180
2020,3,A,골목상권,1000979,상암로4길,232,147,85
2020,3,A,골목상권,1000978,상암로14길,432,261,171
2020,3,A,골목상권,1000977,명일로13길,302,182,120
2020,3,A,골목상권,1000976,동남로85길,635,344,291
2020,3,A,골목상권,1000975,동남로82길,108,64,44
2020,3,A,골목상권,1000974,동남로65길,297,202,95
2020,3,A,골목상권,1000973,구천면로42길,87,52,35
2020,3,A,골목상권,1000972,구천면로41길,442,228,214
2020,3,A,골목상권,1000971,구천면로36길,32,14,18
2020,3,A,골목상권,1000970,고덕로61길,137,93,44
2020,3,A,골목상권,1000969,고덕로25길,143,91,52
2020,3,A,골목상권,1000968,고덕로10길,738,335,403
2020,3,A,골목상권,1000967,강동대로53길,1092,726,366
2020,3,A,골목상권,1000966,풍성로25길,84,43,41
2020,3,A,골목상권,1000965,오금로46길,711,359,352
2020,3,A,골목상권,1000964,오금로36길,1133,803,330
2020,3,A,골목상권,1000963,오금로11길,1427,884,543
2020,3,A,골목상권,1000962,양재대로72길,245,124,121
2020,3,A,골목상권,1000961,양재대로71길,1999,1458,541
2020,3,A,골목상권,1000960,양재대로64길,1212,705,507
2020,3,A,골목상권,1000959,양재대로62길,3230,2137,1093
2020,3,A,골목상권,1000958,송파대로30길,2240,1393,847
2020,3,A,골목상권,1000957,송이로36길,2096,1409,687
2020,3,A,골목상권,1000956,송이로32길,1295,733,562
2020,3,A,골목상권,1000955,송이로23길,1850,1269,581
2020,3,A,골목상권,1000954,삼전로13길,1420,916,504
2020,3,A,골목상권,1000953,백제고분로50길,1209,796,413
2020,3,A,골목상권,1000952,백제고분로46길,665,472,193
2020,3,A,골목상권,1000951,백제고분로45길,1349,869,480
2020,3,A,골목상권,1000950,백제고분로42길,590,289,301
2020,3,A,골목상권,1000949,백제고분로39길,566,393,173
2020,3,A,골목상권,1000948,백제고분로34길,1779,1368,411
2020,3,A,골목상권,1000947,백제고분로33길,921,574,347
2020,3,A,골목상권,1000946,백제고분로32길,725,407,318
2020,3,A,골목상권,1000945,백제고분로31길,1708,1370,338
2020,3,A,골목상권,1000944,백제고분로22길,1371,955,416
2020,3,A,골목상권,1000943,백제고분로21길,483,309,174
2020,3,A,골목상권,1000942,마천로51길,417,245,172
2020,3,A,골목상권,1000941,동남로20길,2463,1773,690
2020,3,A,골목상권,1000940,거마로20길,503,229,274
2020,3,A,골목상권,1000939,학동로77길,1851,1119,732
2020,3,A,골목상권,1000938,학동로6길,1447,977,470
2020,3,A,골목상권,1000937,학동로56길,2421,1533,888
2020,3,A,골목상권,1000936,학동로38길,1862,891,971
2020,3,A,골목상권,1000935,테헤란로81길,1637,791,846
2020,3,A,골목상권,1000934,일원로9길,590,334,256
2020,3,A,골목상권,1000933,일원로3길,513,237,276
2020,3,A,골목상권,1000932,영동대로65길,1175,692,483
2020,3,A,골목상권,1000931,영동대로112길,9367,7734,1633
2020,3,A,골목상권,1000930,언주로81길,5810,3989,1821
2020,3,A,골목상권,1000929,압구정로2길,1937,1352,585
2020,3,A,골목상권,1000928,선릉로18길,466,366,100
2020,3,A,골목상권,1000927,선릉로146길,1123,536,587
2020,3,A,골목상권,1000926,선릉로133길,739,434,305
2020,3,A,골목상권,1000925,선릉로132길,1305,645,660
2020,3,A,골목상권,1000924,선릉로121길,2263,1243,1020
2020,3,A,골목상권,1000923,삼성로75길,1814,1262,552
2020,3,A,골목상권,1000922,삼성로69길,2064,1086,978
2020,3,A,골목상권,1000921,삼성로64길,2957,1473,1484
2020,3,A,골목상권,1000920,삼성로63길,1079,554,525
2020,3,A,골목상권,1000919,삼성로57길,3231,1896,1335
2020,3,A,골목상권,1000918,삼성로147길,190,88,102
2020,3,A,골목상권,1000917,삼성로115길,839,429,410
2020,3,A,골목상권,1000916,봉은사로68길,1265,789,476
2020,3,A,골목상권,1000915,봉은사로57길,638,409,229
2020,3,A,골목상권,1000914,봉은사로43길,2978,1692,1286
2020,3,A,골목상권,1000913,봉은사로29길,1860,1203,657
2020,3,A,골목상권,1000912,봉은사로109길,2837,2093,744
2020,3,A,골목상권,1000911,도산대로89길,1284,730,554
2020,3,A,골목상권,1000910,도산대로81길,3094,1363,1731
2020,3,A,골목상권,1000909,도산대로50길,2685,1863,822
2020,3,A,골목상권,1000908,도산대로38길,1043,622,421
2020,3,A,골목상권,1000907,도산대로30길,3153,1611,1542
2020,3,A,골목상권,1000906,도산대로23길,425,176,249
2020,3,A,골목상권,1000905,도산대로15길,123,65,58
2020,3,A,골목상권,1000904,도곡로37길,7206,4518,2688
2020,3,A,골목상권,1000903,논현로8길,1081,701,380
2020,3,A,골목상권,1000902,논현로63길,2139,1352,787
2020,3,A,골목상권,1000901,논현로28길,2736,1826,910
2020,3,A,골목상권,1000900,논현로26길,17916,5148,12768
2020,3,A,골목상권,1000899,논현로159길,109,49,60
2020,3,A,골목상권,1000898,논현로139길,3565,2123,1442
2020,3,A,골목상권,1000897,논현로123길,162,106,56
2020,3,A,골목상권,1000896,논현로115길,2866,1752,1114
2020,3,A,골목상권,1000895,논현로10길,454,271,183
2020,3,A,골목상권,1000894,논현로106길,1488,1027,461
2020,3,A,골목상권,1000893,남부순환로365길,691,445,246
2020,3,A,골목상권,1000892,개포로82길,103,51,52
2020,3,A,골목상권,1000891,개포로28길,589,445,144
2020,3,A,골목상권,1000890,개포로20길,647,400,247
2020,3,A,골목상권,1000889,개포로17길,961,659,302
2020,3,A,골목상권,1000888,강남대로140길,1433,810,623
2020,3,A,골목상권,1000887,강남대로136길,5070,3655,1415
2020,3,A,골목상권,1000886,강남대로118길,218,91,127
2020,3,A,골목상권,1000885,서초중앙로8길,21671,11288,10383
2020,3,A,골목상권,1000884,방배중앙로21길,7153,2605,4548
2020,3,A,골목상권,1000883,효령로72길,3428,2690,738
2020,3,A,골목상권,1000882,효령로34길,1015,653,362
2020,3,A,골목상권,1000881,효령로31길,2710,2198,512
2020,3,A,골목상권,1000880,효령로23길,1492,964,528
2020,3,A,골목상권,1000879,청두곶길,1446,795,651
2020,3,A,골목상권,1000878,주흥길,164,111,53
2020,3,A,골목상권,1000877,주흥15길,834,539,295
2020,3,A,골목상권,1000876,언남길,1128,742,386
2020,3,A,골목상권,1000875,신반포로45길,1192,625,567
2020,3,A,골목상권,1000874,서초대로8길,2598,644,1954
2020,3,A,골목상권,1000873,서초대로64길,829,489,340
2020,3,A,골목상권,1000872,서초대로4길,847,478,369
2020,3,A,골목상권,1000871,서초대로25길,2073,1591,482
2020,3,A,골목상권,1000870,서초대로23길,2098,1239,859
2020,3,A,골목상권,1000869,서초대로15길,467,253,214
2020,3,A,골목상권,1000868,사평대로57길,65,33,32
2020,3,A,골목상권,1000867,사평대로26길,509,346,163
2020,3,A,골목상권,1000866,사평대로22길,1697,1052,645
2020,3,A,골목상권,1000865,사임당로17길,1939,1273,666
2020,3,A,골목상권,1000864,방배로42길,861,707,154
2020,3,A,골목상권,1000863,방배로35길,1137,711,426
2020,3,A,골목상권,1000862,방배로18길,873,535,338
2020,3,A,골목상권,1000861,반포대로9길,538,288,250
2020,3,A,골목상권,1000860,바우뫼로39길,2648,1935,713
2020,3,A,골목상권,1000859,마방로2길,3582,2570,1012
2020,3,A,골목상권,1000858,방배천로4안길,959,401,558
2020,3,A,골목상권,1000857,동산로19길,1276,633,643
2020,3,A,골목상권,1000856,동산로10길,2158,1493,665
2020,3,A,골목상권,1000855,동광로39길,1227,825,402
2020,3,A,골목상권,1000854,동광로1길,2565,1862,703
2020,3,A,골목상권,1000853,동광로12길,1237,610,627
2020,3,A,골목상권,1000852,논현로27길,2808,2146,662
2020,3,A,골목상권,1000851,논현로1길,1227,780,447
2020,3,A,골목상권,1000850,남부순환로339길,1451,978,473
2020,3,A,골목상권,1000849,남부순환로325길,1477,1061,416
2020,3,A,골목상권,1000848,남부순환로317길,2386,1532,854
2020,3,A,골목상권,1000847,고무래로8길,5479,3568,1911
2020,3,A,골목상권,1000846,강남대로8길,1850,1231,619
2020,3,A,골목상권,1000845,강남대로34길,1734,1204,530
2020,3,A,골목상권,1000844,강남대로23길,2897,1993,904
2020,3,A,골목상권,1000843,소담길,14,4,10
2020,3,A,골목상권,1000842,원신길,22,11,11
2020,3,A,골목상권,1000840,양산길,11,3,8
2020,3,A,골목상권,1000839,호암로24길,1218,1084,134
2020,3,A,골목상권,1000838,호암로20길,186,77,109
2020,3,A,골목상권,1000837,행운길,557,428,129
2020,3,A,골목상권,1000836,행운1길,250,151,99
2020,3,A,골목상권,1000835,청림3길,167,58,109
2020,3,A,골목상권,1000834,청룡길,404,224,180
2020,3,A,골목상권,1000833,청룡8길,222,53,169
2020,3,A,골목상권,1000832,중앙길,99,30,69
2020,3,A,골목상권,1000831,조원중앙로2길,921,694,227
2020,3,A,골목상권,1000830,조원로18길,179,92,87
2020,3,A,골목상권,1000829,조원로10길,397,215,182
2020,3,A,골목상권,1000828,장군봉2길,201,115,86
2020,3,A,골목상권,1000827,장군봉1길,326,166,160
2020,3,A,골목상권,1000826,인헌길,115,61,54
2020,3,A,골목상권,1000825,은천로25길,44,21,23
2020,3,A,골목상권,1000824,양녕로6길,205,124,81
2020,3,A,골목상권,1000823,신원로3길,180,103,77
2020,3,A,골목상권,1000822,신사로20길,121,93,28
2020,3,A,골목상권,1000821,신림로65길,228,175,53
2020,3,A,골목상권,1000820,신림로64길,113,45,68
2020,3,A,골목상권,1000819,신림로48길,75,49,26
2020,3,A,골목상권,1000818,신림로38길,147,90,57
2020,3,A,골목상권,1000817,신림로28길,442,283,159
2020,3,A,골목상권,1000816,신림로11길,284,183,101
2020,3,A,골목상권,1000815,신림동길,669,435,234
2020,3,A,골목상권,1000814,승방길,251,141,110
2020,3,A,골목상권,1000813,서림7길,116,58,58
2020,3,A,골목상권,1000812,봉천로33길,211,131,80
2020,3,A,골목상권,1000811,봉천로13길,241,86,155
2020,3,A,골목상권,1000810,복은길,405,229,176
2020,3,A,골목상권,1000809,법원단지길,16,5,11
2020,3,A,골목상권,1000808,법원단지9길,163,102,61
2020,3,A,골목상권,1000807,미성5길,309,154,155
2020,3,A,골목상권,1000806,대학길,80,45,35
2020,3,A,골목상권,1000805,대학14길,61,31,30
2020,3,A,골목상권,1000804,당곡길,227,117,110
2020,3,A,골목상권,1000803,남현길,117,28,89
2020,3,A,골목상권,1000802,남현3길,372,256,116
2020,3,A,골목상권,1000801,남현2길,568,398,170
2020,3,A,골목상권,1000800,남부순환로248길,404,213,191
2020,3,A,골목상권,1000799,남부순환로234길,126,81,45
2020,3,A,골목상권,1000798,남부순환로172길,450,316,134
2020,3,A,골목상권,1000797,남부순환로161길,347,223,124
2020,3,A,골목상권,1000796,남부순환로151길,788,369,419
2020,3,A,골목상권,1000795,남부순환로142길,418,252,166
2020,3,A,골목상권,1000794,난향길,206,89,117
2020,3,A,골목상권,1000793,난우길,217,121,96
2020,3,A,골목상권,1000792,난곡로74길,2179,1754,425
2020,3,A,골목상권,1000791,난곡로34길,47,19,28
2020,3,A,골목상권,1000790,난곡로26길,120,85,35
2020,3,A,골목상권,1000789,난곡로24길,89,34,55
2020,3,A,골목상권,1000788,낙성대역길,431,230,201
2020,3,A,골목상권,1000787,국회단지길,1430,396,1034
2020,3,A,골목상권,1000786,구암길,228,72,156
2020,3,A,골목상권,1000785,관천로22길,194,117,77
2020,3,A,골목상권,1000784,관천로15길,236,149,87
2020,3,A,골목상권,1000783,관악로30길,140,51,89
2020,3,A,골목상권,1000782,관악로28길,122,39,83
2020,3,A,골목상권,1000781,관악로14길,109,42,67
2020,3,A,골목상권,1000780,관악로10길,1482,1050,432
2020,3,A,골목상권,1000779,흑석로9길,110,76,34
2020,3,A,골목상권,1000778,흑석로13길,77,33,44
2020,3,A,골목상권,1000777,장승배기로27길,260,135,125
2020,3,A,골목상권,1000776,장승배기로19길,518,409,109
2020,3,A,골목상권,1000775,장승배기로10길,223,90,133
2020,3,A,골목상권,1000774,여의대방로46길,1238,733,505
2020,3,A,골목상권,1000773,여의대방로24길,16249,10586,5663
2020,3,A,골목상권,1000772,여의대방로22카길,346,202,144
2020,3,A,골목상권,1000771,여의대방로22나길,188,95,93
2020,3,A,골목상권,1000770,여의대방로22길,241,128,113
2020,3,A,골목상권,1000769,양녕로26길,92,49,43
2020,3,A,골목상권,1000768,신대방길,191,90,101
2020,3,A,골목상권,1000767,성대로29길,297,143,154
2020,3,A,골목상권,1000766,성대로1길,87,43,44
2020,3,A,골목상권,1000765,서달로8가길,83,34,49
2020,3,A,골목상권,1000764,서달로15길,42,14,28
2020,3,A,골목상권,1000763,서달로14길,21,7,14
2020,3,A,골목상권,1000762,서달로10길,51,28,23
2020,3,A,골목상권,1000761,상도로62길,332,179,153
2020,3,A,골목상권,1000760,상도로61길,187,67,120
2020,3,A,골목상권,1000759,상도로47길,601,288,313
2020,3,A,골목상권,1000758,상도로37길,128,65,63
2020,3,A,골목상권,1000757,상도로15길,320,121,199
2020,3,A,골목상권,1000756,사당로8길,131,70,61
2020,3,A,골목상권,1000755,사당로30길,514,180,334
2020,3,A,골목상권,1000754,사당로2차길,324,216,108
2020,3,A,골목상권,1000753,사당로29길,128,78,50
2020,3,A,골목상권,1000752,사당로26길,321,199,122
2020,3,A,골목상권,1000751,사당로23나길,36,21,15
2020,3,A,골목상권,1000749,사당로20길,103,53,50
2020,3,A,골목상권,1000748,사당로16길,116,36,80
2020,3,A,골목상권,1000747,사당로16가길,237,147,90
2020,3,A,골목상권,1000746,만양로8길,824,512,312
2020,3,A,골목상권,1000745,만양로14길,47,29,18
2020,3,A,골목상권,1000744,등용로14길,409,134,275
2020,3,A,골목상권,1000743,동작대로7길,182,84,98
2020,3,A,골목상권,1000742,동작대로35길,190,87,103
2020,3,A,골목상권,1000741,동작대로33길,170,88,82
2020,3,A,골목상권,1000740,동작대로29길,224,49,175
2020,3,A,골목상권,1000739,동작대로17길,806,386,420
2020,3,A,골목상권,1000738,대방동2길,281,134,147
2020,3,A,골목상권,1000737,대방동27길,465,223,242
2020,3,A,골목상권,1000736,노량진로6길,307,204,103
2020,3,A,골목상권,1000735,국사봉길,138,79,59
2020,3,A,골목상권,1000734,국사봉2길,55,34,21
2020,3,A,골목상권,1000733,국사봉1길,85,52,33
2020,3,A,골목상권,1000732,영신로9길,3221,1646,1575
2020,3,A,골목상권,1000731,영등포로84길,1933,673,1260
2020,3,A,골목상권,1000730,영등포로80길,96,48,48
2020,3,A,골목상권,1000729,영등포로62길,118,85,33
2020,3,A,골목상권,1000728,영등포로35길,340,192,148
2020,3,A,골목상권,1000727,영등포로27길,301,189,112
2020,3,A,골목상권,1000726,영등포로25길,493,363,130
2020,3,A,골목상권,1000725,여의대방로61길,514,400,114
2020,3,A,골목상권,1000724,여의대방로43나길,859,661,198
2020,3,A,골목상권,1000723,여의대방로39길,193,112,81
2020,3,A,골목상권,1000722,여의대방로35길,197,65,132
2020,3,A,골목상권,1000721,양평로28길,847,707,140
2020,3,A,골목상권,1000720,양평로22라길,555,299,256
2020,3,A,골목상권,1000719,양평로19길,748,436,312
2020,3,A,골목상권,1000718,신길로60길,260,196,64
2020,3,A,골목상권,1000717,신길로42길,501,270,231
2020,3,A,골목상권,1000716,신길로42가길,210,90,120
2020,3,A,골목상권,1000715,신길로39길,56,32,24
2020,3,A,골목상권,1000714,신길로17길,676,289,387
2020,3,A,골목상권,1000713,선유서로28길,208,110,98
2020,3,A,골목상권,1000712,선유서로25길,1697,1284,413
2020,3,A,골목상권,1000711,선유서로24길,114,70,44
2020,3,A,골목상권,1000710,선유로55길,416,273,143
2020,3,A,골목상권,1000709,디지털로74길,13,8,5
2020,3,A,골목상권,1000708,디지털로57길,1036,639,397
2020,3,A,골목상권,1000707,디지털로37길,172,55,117
2020,3,A,골목상권,1000706,도신로62길,227,173,54
2020,3,A,골목상권,1000705,도신로60길,124,51,73
2020,3,A,골목상권,1000704,도신로29길,108,49,59
2020,3,A,골목상권,1000703,도신로15길,437,238,199
2020,3,A,골목상권,1000702,도림천로21길,236,157,79
2020,3,A,골목상권,1000701,도림로63길,53,41,12
2020,3,A,골목상권,1000700,도림로147길,334,255,79
2020,3,A,골목상권,1000699,도림로112길,30,19,11
2020,3,A,골목상권,1000698,대림로8길,234,113,121
2020,3,A,골목상권,1000697,대림로7길,49,23,26
2020,3,A,골목상권,1000696,대림로44길,411,289,122
2020,3,A,골목상권,1000695,대림로34길,201,139,62
2020,3,A,골목상권,1000694,대림로31길,454,281,173
2020,3,A,골목상권,1000693,대림로29길,964,624,340
2020,3,A,골목상권,1000692,대림로22길,190,98,92
2020,3,A,골목상권,1000691,당산로46길,698,529,169
2020,3,A,골목상권,1000690,당산로38길,676,471,205
2020,3,A,골목상권,1000689,당산로37길,2439,1483,956
2020,3,A,골목상권,1000688,당산로31길,1481,749,732
2020,3,A,골목상권,1000687,국회대로56길,3275,1590,1685
2020,3,A,골목상권,1000686,경인로90길,282,210,72
2020,3,A,골목상권,1000685,경인로80길,1007,706,301
2020,3,A,골목상권,1000684,경인로77길,741,512,229
2020,3,A,골목상권,1000683,가마산로61길,47,35,12
2020,3,A,골목상권,1000682,시흥대로94길,446,164,282
2020,3,A,골목상권,1000681,시흥대로84길,178,103,75
2020,3,A,골목상권,1000680,시흥대로68길,549,219,330
2020,3,A,골목상권,1000679,시흥대로63길,1016,542,474
2020,3,A,골목상권,1000678,시흥대로62가길,86,59,27
2020,3,A,골목상권,1000677,시흥대로36길,288,173,115
2020,3,A,골목상권,1000676,시흥대로22길,259,143,116
2020,3,A,골목상권,1000675,시흥대로153길,92,55,37
2020,3,A,골목상권,1000674,시흥대로150길,421,278,143
2020,3,A,골목상권,1000673,시흥대로141길,214,142,72
2020,3,A,골목상권,1000672,시흥대로138길,341,246,95
2020,3,A,골목상권,1000671,시흥대로120길,192,117,75
2020,3,A,골목상권,1000670,벚꽃로56길,301,260,41
2020,3,A,골목상권,1000669,범안로17길,4567,2830,1737
2020,3,A,골목상권,1000668,범안로11길,1498,819,679
2020,3,A,골목상권,1000667,문성로5길,379,199,180
2020,3,A,골목상권,1000666,독산로85길,68,34,34
2020,3,A,골목상권,1000665,독산로78다길,195,124,71
2020,3,A,골목상권,1000664,독산로70길,74,31,43
2020,3,A,골목상권,1000663,독산로64길,186,152,34
2020,3,A,골목상권,1000662,독산로50길,27,6,21
2020,3,A,골목상권,1000661,독산로40길,219,75,144
2020,3,A,골목상권,1000660,독산로108길,1619,1443,176
2020,3,A,골목상권,1000659,남부순환로112길,96,66,30
2020,3,A,골목상권,1000658,금하로24길,132,72,60
2020,3,A,골목상권,1000657,금하로1길,227,175,52
2020,3,A,골목상권,1000656,금하로14길,96,65,31
2020,3,A,골목상권,1000655,가산로5길,499,350,149
2020,3,A,골목상권,1000654,가산로3길,999,756,243
2020,3,A,골목상권,1000653,중앙로1길,960,704,256
2020,3,A,골목상권,1000652,중앙로15길,171,106,65
2020,3,A,골목상권,1000651,우마길,43,19,24
2020,3,A,골목상권,1000650,오류로8길,442,219,223
2020,3,A,골목상권,1000649,신도림로13길,148,100,48
2020,3,A,골목상권,1000648,새말로18길,933,549,384
2020,3,A,골목상권,1000647,부일로1길,356,321,35
2020,3,A,골목상권,1000646,부일로15길,156,107,49
2020,3,A,골목상권,1000645,부일로11길,281,115,166
2020,3,A,골목상권,1000644,디지털로32길,815,435,380
2020,3,A,골목상권,1000643,디지털로32가길,2221,1322,899
2020,3,A,골목상권,1000642,디지털로27길,26,20,6
2020,3,A,골목상권,1000641,도림로6길,160,93,67
2020,3,A,골목상권,1000640,도림로12길,186,124,62
2020,3,A,골목상권,1000639,남부순환로97길,101,48,53
2020,3,A,골목상권,1000638,구로중앙로8길,107,41,66
2020,3,A,골목상권,1000637,구로중앙로7길,86,42,44
2020,3,A,골목상권,1000636,구로중앙로42길,403,284,119
2020,3,A,골목상권,1000635,구로중앙로34길,189,149,40
2020,3,A,골목상권,1000634,구로중앙로28길,470,226,244
2020,3,A,골목상권,1000633,구로중앙로19길,666,398,268
2020,3,A,골목상권,1000632,구로동로8길,298,153,145
2020,3,A,골목상권,1000631,구로동로7길,115,71,44
2020,3,A,골목상권,1000630,구로동로42길,131,75,56
2020,3,A,골목상권,1000629,구로동로41길,119,79,40
2020,3,A,골목상권,1000628,구로동로38길,625,240,385
2020,3,A,골목상권,1000627,구로동로28길,42,18,24
2020,3,A,골목상권,1000626,구로동로15길,88,50,38
2020,3,A,골목상권,1000625,공원로6가길,1158,755,403
2020,3,A,골목상권,1000624,고척로52길,40,27,13
2020,3,A,골목상권,1000623,고척로27다길,169,99,70
2020,3,A,골목상권,1000622,고척로27길,309,167,142
2020,3,A,골목상권,1000621,고척로21나길,369,197,172
2020,3,A,골목상권,1000620,경인로47길,657,264,393
2020,3,A,골목상권,1000619,경인로35길,364,232,132
2020,3,A,골목상권,1000618,경인로31길,130,61,69
2020,3,A,골목상권,1000617,경인로15길,259,93,166
2020,3,A,골목상권,1000616,개봉로3길,273,139,134
2020,3,A,골목상권,1000615,개봉로2길,186,99,87
2020,3,A,골목상권,1000614,개봉로23가길,826,590,236
2020,3,A,골목상권,1000613,개봉로20길,3082,1346,1736
2020,3,A,골목상권,1000612,개봉로1길,187,126,61
2020,3,A,골목상권,1000611,개봉로17다길,2362,1606,756
2020,3,A,골목상권,1000610,개봉로17길,1304,418,886
2020,3,A,골목상권,1000609,개봉로11길,181,97,84
2020,3,A,골목상권,1000608,화곡로64길,1128,686,442
2020,3,A,골목상권,1000607,화곡로59길,316,232,84
2020,3,A,골목상권,1000606,화곡로44나길,625,559,66
2020,3,A,골목상권,1000605,화곡로31길,618,375,243
2020,3,A,골목상권,1000604,화곡로20길,355,193,162
2020,3,A,골목상권,1000603,화곡로13길,368,249,119
2020,3,A,골목상권,1000602,초원로16길,523,369,154
2020,3,A,골목상권,1000601,초록마을로8길,116,68,48
2020,3,A,골목상권,1000600,초록마을로3길,439,355,84
2020,3,A,골목상권,1000599,월정로20길,135,31,104
2020,3,A,골목상권,1000598,우장산로6길,486,298,188
2020,3,A,골목상권,1000597,양천로73가길,468,360,108
2020,3,A,골목상권,1000596,양천로71길,1203,752,451
2020,3,A,골목상권,1000595,양천로49길,342,232,110
2020,3,A,골목상권,1000594,양천로26길,479,377,102
2020,3,A,골목상권,1000593,양천로24길,186,100,86
2020,3,A,골목상권,1000592,양천로24가길,207,113,94
2020,3,A,골목상권,1000591,양천로14길,257,143,114
2020,3,A,골목상권,1000590,방화대로6라길,653,413,240
2020,3,A,골목상권,1000589,방화대로21길,390,243,147
2020,3,A,골목상권,1000588,등촌로5길,1524,514,1010
2020,3,A,골목상권,1000587,등촌로55길,432,323,109
2020,3,A,골목상권,1000586,등촌로51길,239,137,102
2020,3,A,골목상권,1000585,등촌로39길,313,146,167
2020,3,A,골목상권,1000584,등촌로13길,183,128,55
2020,3,A,골목상권,1000583,남부순환로11길,307,201,106
2020,3,A,골목상권,1000582,까치산로4길,189,112,77
2020,3,A,골목상권,1000581,국회대로7길,215,101,114
2020,3,A,골목상권,1000580,공항대로8길,276,172,104
2020,3,A,골목상권,1000579,공항대로61길,547,415,132
2020,3,A,골목상권,1000578,공항대로59다길,1037,645,392
2020,3,A,골목상권,1000577,공항대로59길,654,454,200
2020,3,A,골목상권,1000576,공항대로55길,900,577,323
2020,3,A,골목상권,1000575,공항대로42길,514,323,191
2020,3,A,골목상권,1000574,공항대로38길,92,49,43
2020,3,A,골목상권,1000573,곰달래로60길,221,146,75
2020,3,A,골목상권,1000572,곰달래로53길,130,89,41
2020,3,A,골목상권,1000571,곰달래로47길,333,218,115
2020,3,A,골목상권,1000570,곰달래로31길,120,78,42
2020,3,A,골목상권,1000569,곰달래로25길,245,139,106
2020,3,A,골목상권,1000568,개화동로25길,351,201,150
2020,3,A,골목상권,1000567,개화동로23길,857,669,188
2020,3,A,골목상권,1000566,강서로8길,214,125,89
2020,3,A,골목상권,1000565,강서로5라길,245,176,69
2020,3,A,골목상권,1000564,강서로5나길,360,221,139
2020,3,A,골목상권,1000563,강서로5가길,182,98,84
2020,3,A,골목상권,1000562,강서로47라길,207,150,57
2020,3,A,골목상권,1000561,강서로47길,327,146,181
2020,3,A,골목상권,1000560,강서로45다길,243,178,65
2020,3,A,골목상권,1000559,강서로45길,101,43,58
2020,3,A,골목상권,1000558,강서로35길,280,120,160
2020,3,A,골목상권,1000557,강서로29길,384,230,154
2020,3,A,골목상권,1000556,강서로18길,676,545,131
2020,3,A,골목상권,1000555,강서로17가길,554,386,168
2020,3,A,골목상권,1000554,강서로15길,261,152,109
2020,3,A,골목상권,1000553,가로공원로80길,270,175,95
2020,3,A,골목상권,1000552,가로공원로76가길,168,91,77
2020,3,A,골목상권,1000551,화곡로4길,421,219,202
2020,3,A,골목상권,1000550,화곡로3길,351,177,174
2020,3,A,골목상권,1000549,지양로7길,245,105,140
2020,3,A,골목상권,1000548,중앙로55길,592,261,331
2020,3,A,골목상권,1000547,중앙로51길,283,178,105
2020,3,A,골목상권,1000546,중앙로47길,94,40,54
2020,3,A,골목상권,1000545,중앙로45길,1386,1342,44
2020,3,A,골목상권,1000544,중앙로36길,133,49,84
2020,3,A,골목상권,1000543,중앙로32길,145,87,58
2020,3,A,골목상권,1000542,중앙로25길,97,61,36
2020,3,A,골목상권,1000541,은행정로7길,472,183,289
2020,3,A,골목상권,1000540,은행정로5길,109,57,52
2020,3,A,골목상권,1000539,오목로5길,120,85,35
2020,3,A,골목상권,1000538,오목로3길,375,296,79
2020,3,A,골목상권,1000537,오목로30길,220,125,95
2020,3,A,골목상권,1000536,오목로23길,401,155,246
2020,3,A,골목상권,1000535,신월로20길,47,30,17
2020,3,A,골목상권,1000534,신월로15길,357,184,173
2020,3,A,골목상권,1000533,신목로6길,582,383,199
2020,3,A,골목상권,1000532,신목로5길,645,416,229
2020,3,A,골목상권,1000531,신목로2길,386,255,131
2020,3,A,골목상권,1000530,목동중앙서로8가길,317,200,117
2020,3,A,골목상권,1000529,목동중앙서로7길,75,52,23
2020,3,A,골목상권,1000528,목동중앙북로8길,171,102,69
2020,3,A,골목상권,1000527,목동중앙북로16길,488,190,298
2020,3,A,골목상권,1000526,목동중앙본로7길,131,70,61
2020,3,A,골목상권,1000525,목동중앙로3길,157,95,62
2020,3,A,골목상권,1000524,목동중앙로13나길,346,248,98
2020,3,A,골목상권,1000523,목동중앙남로3가길,190,108,82
2020,3,A,골목상권,1000522,목동로9길,768,479,289
2020,3,A,골목상권,1000521,목동로19길,351,190,161
2020,3,A,골목상권,1000520,목동동로8길,184,106,78
2020,3,A,골목상권,1000519,목동동로12길,335,228,107
2020,3,A,골목상권,1000518,목동남로4길,797,494,303
2020,3,A,골목상권,1000517,남부순환로88길,328,124,204
2020,3,A,골목상권,1000516,남부순환로79길,142,74,68
2020,3,A,골목상권,1000515,남부순환로70길,165,101,64
2020,3,A,골목상권,1000514,남부순환로58길,282,179,103
2020,3,A,골목상권,1000513,남부순환로40길,122,46,76
2020,3,A,골목상권,1000512,남부순환로33길,179,116,63
2020,3,A,골목상권,1000511,곰달래로5길,211,125,86
2020,3,A,골목상권,1000510,곰달래로3길,313,213,100
2020,3,A,골목상권,1000509,곰달래로2길,610,344,266
2020,3,A,골목상권,1000508,곰달래로10길,543,449,94
2020,3,A,골목상권,1000507,가로공원로58길,91,54,37
2020,3,A,골목상권,1000506,효창원로93길,243,99,144
2020,3,A,골목상권,1000505,토정로37길,431,166,265
2020,3,A,골목상권,1000504,월드컵로8길,939,462,477
2020,3,A,골목상권,1000503,월드컵로7길,759,308,451
2020,3,A,골목상권,1000502,월드컵로36길,461,286,175
2020,3,A,골목상권,1000501,월드컵로25길,309,125,184
2020,3,A,골목상권,1000500,월드컵로19길,284,181,103
2020,3,A,골목상권,1000499,월드컵로16길,1538,929,609
2020,3,A,골목상권,1000498,월드컵로11길,421,153,268
2020,3,A,골목상권,1000497,월드컵로10길,1102,654,448
2020,3,A,골목상권,1000496,와우산로3길,257,176,81
2020,3,A,골목상권,1000495,와우산로29길,78,30,48
2020,3,A,골목상권,1000494,와우산로29가길,989,653,336
2020,3,A,골목상권,1000493,양화진길,676,412,264
2020,3,A,골목상권,1000492,양화로1길,544,248,296
2020,3,A,골목상권,1000491,양화로11길,2761,1012,1749
2020,3,A,골목상권,1000490,신촌로30길,109,64,45
2020,3,A,골목상권,1000489,신촌로28가길,59,19,40
2020,3,A,골목상권,1000488,신촌로12길,197,95,102
2020,3,A,골목상권,1000487,숭문길,1467,1016,451
2020,3,A,골목상권,1000486,숭문8길,109,65,44
2020,3,A,골목상권,1000485,성지3길,338,228,110
2020,3,A,골목상권,1000484,성산로4길,855,546,309
2020,3,A,골목상권,1000483,성미산로32길,243,172,71
2020,3,A,골목상권,1000482,성미산로1길,554,299,255
2020,3,A,골목상권,1000481,성미산로11길,1114,807,307
2020,3,A,골목상권,1000480,백범로16길,1908,1298,610
2020,3,A,골목상권,1000479,방울내로9안길,619,351,268
2020,3,A,골목상권,1000478,모래내로7길,91,63,28
2020,3,A,골목상권,1000477,매봉산로2길,806,601,205
2020,3,A,골목상권,1000476,망원로2길,282,190,92
2020,3,A,골목상권,1000475,망원로11길,144,73,71
2020,3,A,골목상권,1000474,만리재옛길,1190,687,503
2020,3,A,골목상권,1000473,마포대로4길,674,365,309
2020,3,A,골목상권,1000472,마포대로20길,483,258,225
2020,3,A,골목상권,1000471,마포대로12길,78,39,39
2020,3,A,골목상권,1000470,동교로38길,464,247,217
2020,3,A,골목상권,1000469,동교로27길,1172,795,377
2020,3,A,골목상권,1000468,동교로25길,1378,581,797
2020,3,A,골목상권,1000467,동교로19길,1207,739,468
2020,3,A,골목상권,1000466,동교로17길,405,240,165
2020,3,A,골목상권,1000465,독막로8길,441,274,167
2020,3,A,골목상권,1000464,독막로32길,487,240,247
2020,3,A,골목상권,1000463,독막로22길,91,61,30
2020,3,A,골목상권,1000462,도화길,56,32,24
2020,3,A,골목상권,1000461,도화4길,825,292,533
2020,3,A,골목상권,1000460,대흥로28길,50,17,33
2020,3,A,골목상권,1000459,대흥로21길,372,188,184
2020,3,A,골목상권,1000458,광성로6길,295,169,126
2020,3,A,골목상권,1000457,홍제내길,565,201,364
2020,3,A,골목상권,1000456,홍연길,79,47,32
2020,3,A,골목상권,1000455,통일로39길,67,32,35
2020,3,A,골목상권,1000454,통일로37길,611,407,204
2020,3,A,골목상권,1000453,통일로11길,97,46,51
2020,3,A,골목상권,1000452,충정로6길,3185,1879,1306
2020,3,A,골목상권,1000451,충정로4길,2044,1298,746
2020,3,A,골목상권,1000450,증가로6길,326,277,49
2020,3,A,골목상권,1000449,증가로23나길,902,441,461
2020,3,A,골목상권,1000448,증가로20가길,336,99,237
2020,3,A,골목상권,1000447,증가로10길,1463,1123,340
2020,3,A,골목상권,1000446,응암로1길,621,380,241
2020,3,A,골목상권,1000445,연희로10길,3448,3135,313
2020,3,A,골목상권,1000444,신촌로37길,52,25,27
2020,3,A,골목상권,1000443,수색로8길,1090,905,185
2020,3,A,골목상권,1000442,세무서길,164,78,86
2020,3,A,골목상권,1000441,세무서2길,186,77,109
2020,3,A,골목상권,1000440,세검정로1길,109,37,72
2020,3,A,골목상권,1000439,북아현로4길,350,225,125
2020,3,A,골목상권,1000438,모래내로15길,74,54,20
2020,3,A,골목상권,1000437,명지대길,107,58,49
2020,3,A,골목상권,1000436,독립문로8길,679,422,257
2020,3,A,골목상권,1000435,가재울로6길,168,108,60
2020,3,A,골목상권,1000434,통일로92길,186,72,114
2020,3,A,골목상권,1000433,통일로87길,255,130,125
2020,3,A,골목상권,1000432,통일로78길,172,60,112
2020,3,A,골목상권,1000431,통일로69길,107,55,52
2020,3,A,골목상권,1000430,진흥로1길,310,165,145
2020,3,A,골목상권,1000429,진흥로12길,392,144,248
2020,3,A,골목상권,1000428,증산서길,334,189,145
2020,3,A,골목상권,1000427,증산로9길,606,525,81
2020,3,A,골목상권,1000426,증산로5길,508,308,200
2020,3,A,골목상권,1000425,증산로21길,237,122,115
2020,3,A,골목상권,1000424,증산로17길,161,110,51
2020,3,A,골목상권,1000423,증산로15길,398,297,101
2020,3,A,골목상권,1000422,증산로13길,79,42,37
2020,3,A,골목상권,1000421,응암로34길,231,118,113
2020,3,A,골목상권,1000420,응암로22길,130,53,77
2020,3,A,골목상권,1000419,응암로14길,99,50,49
2020,3,A,골목상권,1000418,응암로13길,156,44,112
2020,3,A,골목상권,1000417,응암로12길,67,32,35
2020,3,A,골목상권,1000416,은평로8길,275,194,81
2020,3,A,골목상권,1000415,은평로3길,242,110,132
2020,3,A,골목상권,1000414,은평로20길,9,2,7
2020,3,A,골목상권,1000413,은평로13길,655,283,372
2020,3,A,골목상권,1000412,은평로10길,246,148,98
2020,3,A,골목상권,1000411,연서로5길,647,303,344
2020,3,A,골목상권,1000410,연서로41길,64,33,31
2020,3,A,골목상권,1000409,연서로3길,119,51,68
2020,3,A,골목상권,1000408,연서로34길,1310,709,601
2020,3,A,골목상권,1000407,연서로33길,109,49,60
2020,3,A,골목상권,1000406,연서로29길,100,60,40
2020,3,A,골목상권,1000405,연서로28길,226,118,108
2020,3,A,골목상권,1000404,연서로27길,339,148,191
2020,3,A,골목상권,1000403,연서로21길,684,486,198
2020,3,A,골목상권,1000402,연서로17길,540,162,378
2020,3,A,골목상권,1000401,연서로16길,121,66,55
2020,3,A,골목상권,1000400,연서로13길,218,135,83
2020,3,A,골목상권,1000399,연서로11길,640,263,377
2020,3,A,골목상권,1000398,역말로9길,159,82,77
2020,3,A,골목상권,1000397,수색로18길,128,93,35
2020,3,A,골목상권,1000396,서오릉로8길,160,104,56
2020,3,A,골목상권,1000395,서오릉로21길,153,56,97
2020,3,A,골목상권,1000394,불광천길,192,95,97
2020,3,A,골목상권,1000393,갈현로7길,398,205,193
2020,3,A,골목상권,1000392,갈현로41길,171,78,93
2020,3,A,골목상권,1000391,갈현로33길,255,149,106
2020,3,A,골목상권,1000390,갈현로1길,66,36,30
2020,3,A,골목상권,1000389,가좌로7길,329,203,126
2020,3,A,골목상권,1000388,한글비석로44길,232,95,137
2020,3,A,골목상권,1000387,한글비석로24길,180,62,118
2020,3,A,골목상권,1000386,한글비석로22길,172,92,80
2020,3,A,골목상권,1000385,석계로1길,605,255,350
2020,3,A,골목상권,1000384,상계로9가길,151,82,69
2020,3,A,골목상권,1000383,상계로1길,334,244,90
2020,3,A,골목상권,1000382,상계로12길,144,90,54
2020,3,A,골목상권,1000381,동일로242길,302,142,160
2020,3,A,골목상권,1000380,동일로192길,429,326,103
2020,3,A,골목상권,1000379,동일로173가길,1230,946,284
2020,3,A,골목상권,1000378,공릉로58길,129,61,68
2020,3,A,골목상권,1000377,해등로16길,285,134,151
2020,3,A,골목상권,1000376,우이천로4다길,125,83,42
2020,3,A,골목상권,1000375,우이천로32길,206,83,123
2020,3,A,골목상권,1000374,시루봉로23길,267,128,139
2020,3,A,골목상권,1000373,삼양로144길,50,24,26
2020,3,A,골목상권,1000372,방학로6가길,167,67,100
2020,3,A,골목상권,1000371,방학로5길,124,87,37
2020,3,A,골목상권,1000370,방학로15길,687,454,233
2020,3,A,골목상권,1000369,방학로10길,67,51,16
2020,3,A,골목상권,1000368,도봉산길,135,64,71
2020,3,A,골목상권,1000367,도봉산4길,27,24,3
2020,3,A,골목상권,1000366,도봉로181길,93,30,63
2020,3,A,골목상권,1000365,도봉로169나길,244,184,60
2020,3,A,골목상권,1000364,도봉로156길,93,62,31
2020,3,A,골목상권,1000363,도봉로152가길,342,311,31
2020,3,A,골목상권,1000362,도봉로147길,161,81,80
2020,3,A,골목상권,1000361,도봉로143길,73,48,25
2020,3,A,골목상권,1000360,도봉로114길,380,143,237
2020,3,A,골목상권,1000359,도봉로109길,276,223,53
2020,3,A,골목상권,1000358,도당로29길,518,292,226
2020,3,A,골목상권,1000357,도당로19길,597,66,531
2020,3,A,골목상권,1000356,도당로13바길,74,35,39
2020,3,A,골목상권,1000355,도당로13가길,36,21,15
2020,3,A,골목상권,1000354,덕릉로60길,177,126,51
2020,3,A,골목상권,1000353,노해로63다길,43,19,24
2020,3,A,골목상권,1000352,노해로60길,136,85,51
2020,3,A,골목상권,1000351,한천로140길,36,25,11
2020,3,A,골목상권,1000350,한천로139가길,108,47,61
2020,3,A,골목상권,1000349,한천로132길,56,31,25
2020,3,A,골목상권,1000348,한천로130길,91,69,22
2020,3,A,골목상권,1000347,한천로124나길,54,23,31
2020,3,A,골목상권,1000346,한천로109길,439,280,159
2020,3,A,골목상권,1000345,인수봉로79길,242,153,89
2020,3,A,골목상권,1000344,인수봉로72길,54,18,36
2020,3,A,골목상권,1000343,인수봉로56길,44,25,19
2020,3,A,골목상권,1000342,오패산로67길,238,89,149
2020,3,A,골목상권,1000341,오패산로52길,105,47,58
2020,3,A,골목상권,1000340,오패산로30길,13,5,8
2020,3,A,골목상권,1000339,수유로12길,281,199,82
2020,3,A,골목상권,1000338,솔샘로65길,284,66,218
2020,3,A,골목상권,1000337,솔매로50길,442,162,280
2020,3,A,골목상권,1000336,솔매로45길,65,32,33
2020,3,A,골목상권,1000335,솔매로41길,67,38,29
2020,3,A,골목상권,1000334,삼양로93길,209,94,115
2020,3,A,골목상권,1000333,삼양로77길,131,58,73
2020,3,A,골목상권,1000332,삼양로54길,295,66,229
2020,3,A,골목상권,1000331,삼양로41길,338,275,63
2020,3,A,골목상권,1000330,삼양로27길,7,4,3
2020,3,A,골목상권,1000329,삼양로24길,26,16,10
2020,3,A,골목상권,1000328,삼양로20길,179,168,11
2020,3,A,골목상권,1000327,삼각산로28길,70,33,37
2020,3,A,골목상권,1000326,도봉로99길,250,155,95
2020,3,A,골목상권,1000325,도봉로8길,6,4,2
2020,3,A,골목상권,1000324,도봉로76길,311,138,173
2020,3,A,골목상권,1000323,도봉로67길,116,57,59
2020,3,A,골목상권,1000322,도봉로45길,112,54,58
2020,3,A,골목상권,1000321,도봉로18길,225,182,43
2020,3,A,골목상권,1000320,도봉로13길,13,8,5
2020,3,A,골목상권,1000319,덕릉로41길,185,105,80
2020,3,A,골목상권,1000318,덕릉로40길,187,95,92
2020,3,A,골목상권,1000317,노해로33길,84,30,54
2020,3,A,골목상권,1000316,노해로23길,70,47,23
2020,3,A,골목상권,1000315,노해로17길,103,56,47
2020,3,A,골목상권,1000314,화랑로40길,71,46,25
2020,3,A,골목상권,1000313,화랑로32길,395,292,103
2020,3,A,골목상권,1000312,화랑로1길,1112,811,301
2020,3,A,골목상권,1000311,화랑로19길,43,19,24
2020,3,A,골목상권,1000310,화랑로14길,99,73,26
2020,3,A,골목상권,1000309,화랑로13길,267,95,172
2020,3,A,골목상권,1000308,한천로76길,132,100,32
2020,3,A,골목상권,1000307,한천로101가길,15,9,6
2020,3,A,골목상권,1000306,창경궁로43길,917,434,483
2020,3,A,골목상권,1000305,지봉로20길,3780,3162,618
2020,3,A,골목상권,1000304,종암로5길,404,201,203
2020,3,A,골목상권,1000303,종암로24가길,81,18,63
2020,3,A,골목상권,1000302,종암로21길,550,344,206
2020,3,A,골목상권,1000301,종암로19길,18269,9427,8842
2020,3,A,골목상권,1000300,종암로16길,140,61,79
2020,3,A,골목상권,1000299,정릉로8길,1407,1165,242
2020,3,A,골목상권,1000298,정릉로27길,75,30,45
2020,3,A,골목상권,1000297,정릉로26길,214,103,111
2020,3,A,골목상권,1000296,장위로50길,343,160,183
2020,3,A,골목상권,1000295,장월로1길,74,19,55
2020,3,A,골목상권,1000294,인촌로6길,195,131,64
2020,3,A,골목상권,1000293,인촌로5길,63,31,32
2020,3,A,골목상권,1000292,인촌로24길,1580,1010,570
2020,3,A,골목상권,1000291,개운사길,150,83,67
2020,3,A,골목상권,1000290,인촌로1길,127,78,49
2020,3,A,골목상권,1000289,인촌로17가길,90,48,42
2020,3,A,골목상권,1000288,오패산로4길,841,540,301
2020,3,A,골목상권,1000287,오패산로3길,310,187,123
2020,3,A,골목상권,1000286,오패산로19길,101,36,65
2020,3,A,골목상권,1000285,안암로5길,960,743,217
2020,3,A,골목상권,1000284,아리랑로4길,595,281,314
2020,3,A,골목상권,1000283,솔샘로6길,74,48,26
2020,3,A,골목상권,1000282,성북로8길,143,88,55
2020,3,A,골목상권,1000281,삼양로8길,147,70,77
2020,3,A,골목상권,1000280,삼선교로16가길,99,42,57
2020,3,A,골목상권,1000279,삼선교로10다길,38,17,21
2020,3,A,골목상권,1000278,삼선교로10길,186,110,76
2020,3,A,골목상권,1000277,보문로32길,267,128,139
2020,3,A,골목상권,1000276,보문로31길,253,128,125
2020,3,A,골목상권,1000275,보문로26길,134,62,72
2020,3,A,골목상권,1000274,보문로13길,1048,741,307
2020,3,A,골목상권,1000273,보국문로16길,181,97,84
2020,3,A,골목상권,1000272,동소문로6길,62,28,34
2020,3,A,골목상권,1000271,동소문로2길,53,21,32
2020,3,A,골목상권,1000270,동소문로26가길,219,122,97
2020,3,A,골목상권,1000269,동소문로15길,209,152,57
2020,3,A,골목상권,1000268,동소문로13길,572,285,287
2020,3,A,골목상권,1000267,돌곶이로8길,117,75,42
2020,3,A,골목상권,1000266,돌곶이로41길,40,13,27
2020,3,A,골목상권,1000265,돌곶이로28길,222,96,126
2020,3,A,골목상권,1000264,돌곶이로27길,103,59,44
2020,3,A,골목상권,1000263,돌곶이로22길,61,34,27
2020,3,A,골목상권,1000262,돌곶이로14길,77,58,19
2020,3,A,골목상권,1000261,길음로7길,14,5,9
2020,3,A,골목상권,1000260,중랑천로10길,207,109,98
2020,3,A,골목상권,1000259,용마산로94길,304,259,45
2020,3,A,골목상권,1000258,용마산로118길,108,63,45
2020,3,A,골목상권,1000257,용마산로112길,114,69,45
2020,3,A,골목상권,1000256,용마산로100길,122,52,70
2020,3,A,골목상권,1000255,신내로7가길,276,115,161
2020,3,A,골목상권,1000254,사가정로54길,122,47,75
2020,3,A,골목상권,1000253,사가정로42길,183,89,94
2020,3,A,골목상권,1000252,봉화산로56길,649,289,360
2020,3,A,골목상권,1000251,봉화산로4길,58,30,28
2020,3,A,골목상권,1000250,봉화산로30길,139,38,101
2020,3,A,골목상권,1000249,봉우재로33길,150,59,91
2020,3,A,골목상권,1000248,면목로78길,93,44,49
2020,3,A,골목상권,1000247,면목로56길,91,53,38
2020,3,A,골목상권,1000246,면목로55길,473,306,167
2020,3,A,골목상권,1000245,면목로49길,109,67,42
2020,3,A,골목상권,1000244,면목로48길,873,544,329
2020,3,A,골목상권,1000243,면목로45길,454,364,90
2020,3,A,골목상권,1000242,면목로33길,86,28,58
2020,3,A,골목상권,1000241,면목로21길,54,37,17
2020,3,A,골목상권,1000240,망우로73길,51,34,17
2020,3,A,골목상권,1000239,망우로68길,107,44,63
2020,3,A,골목상권,1000238,동일로163길,112,67,45
2020,3,A,골목상권,1000237,동일로157길,443,270,173
2020,3,A,골목상권,1000236,동일로149길,870,749,121
2020,3,A,골목상권,1000235,동일로140길,432,314,118
2020,3,A,골목상권,1000234,동일로139길,77,53,24
2020,3,A,골목상권,1000233,동일로139가길,187,81,106
2020,3,A,골목상권,1000232,동일로130길,130,99,31
2020,3,A,골목상권,1000231,동일로123길,145,74,71
2020,3,A,골목상권,1000230,동일로112길,193,120,73
2020,3,A,골목상권,1000229,동일로101길,202,58,144
2020,3,A,골목상권,1000228,동일로100길,328,240,88
2020,3,A,골목상권,1000227,답십리로75길,57,33,24
2020,3,A,골목상권,1000226,공릉로2길,148,69,79
2020,3,A,골목상권,1000225,공릉로12가길,75,50,25
2020,3,A,골목상권,1000224,겸재로54길,131,79,52
2020,3,A,골목상권,1000223,겸재로36길,134,60,74
2020,3,A,골목상권,1000222,겸재로29길,126,74,52
2020,3,A,골목상권,1000221,휘경로3길,127,69,58
2020,3,A,골목상권,1000220,휘경로2길,138,88,50
2020,3,A,골목상권,1000219,휘경로23길,89,56,33
2020,3,A,골목상권,1000218,휘경로14길,113,41,72
2020,3,A,골목상권,1000217,한천로46길,257,101,156
2020,3,A,골목상권,1000216,한천로40길,90,57,33
2020,3,A,골목상권,1000215,한천로33길,203,76,127
2020,3,A,골목상권,1000214,한천로14길,696,440,256
2020,3,A,골목상권,1000213,천호대로97길,878,590,288
2020,3,A,골목상권,1000212,천호대로77길,169,111,58
2020,3,A,골목상권,1000211,천호대로45길,47,38,9
2020,3,A,골목상권,1000210,천호대로17길,2512,1893,619
2020,3,A,골목상권,1000209,천호대로12길,55,35,20
2020,3,A,골목상권,1000208,천장산로7길,74,32,42
2020,3,A,골목상권,1000207,제기로5길,45,39,6
2020,3,A,골목상권,1000206,제기로21길,101,62,39
2020,3,A,골목상권,1000205,전농로4길,274,210,64
2020,3,A,골목상권,1000204,전농로3길,170,120,50
2020,3,A,골목상권,1000203,전농로29길,461,336,125
2020,3,A,골목상권,1000202,장한로8길,438,295,143
2020,3,A,골목상권,1000201,장한로5길,314,189,125
2020,3,A,골목상권,1000200,장한로27길,167,119,48
2020,3,A,골목상권,1000199,장한로27가길,148,81,67
2020,3,A,골목상권,1000198,장한로26길,2436,1696,740
2020,3,A,골목상권,1000197,장한로26가길,122,87,35
2020,3,A,골목상권,1000196,장한로25길,408,210,198
2020,3,A,골목상권,1000195,장한로14길,179,98,81
2020,3,A,골목상권,1000194,이문로42길,48,29,19
2020,3,A,골목상권,1000193,왕산로43길,560,199,361
2020,3,A,골목상권,1000192,왕산로33길,72,30,42
2020,3,A,골목상권,1000191,왕산로32길,129,64,65
2020,3,A,골목상권,1000190,약령시로17길,109,77,32
2020,3,A,골목상권,1000189,서울시립대로4길,404,264,140
2020,3,A,골목상권,1000188,서울시립대로29길,368,263,105
2020,3,A,골목상권,1000187,서울시립대로16길,42,14,28
2020,3,A,골목상권,1000186,사가정로2길,268,177,91
2020,3,A,골목상권,1000185,사가정로23가길,84,46,38
2020,3,A,골목상권,1000184,사가정로13길,180,65,115
2020,3,A,골목상권,1000183,무학로45길,227,141,86
2020,3,A,골목상권,1000182,무학로16길,574,441,133
2020,3,A,골목상권,1000181,망우로21길,96,67,29
2020,3,A,골목상권,1000180,망우로18길,52,17,35
2020,3,A,골목상권,1000179,망우로18가길,114,75,39
2020,3,A,골목상권,1000178,답십리로72길,54,20,34
2020,3,A,골목상권,1000177,답십리로69길,533,270,263
2020,3,A,골목상권,1000176,답십리로68길,287,158,129
2020,3,A,골목상권,1000175,답십리로64길,103,73,30
2020,3,A,골목상권,1000174,답십리로63길,1747,1051,696
2020,3,A,골목상권,1000173,답십리로60길,341,213,128
2020,3,A,골목상권,1000172,답십리로56길,78,39,39
2020,3,A,골목상권,1000171,답십리로23길,47,22,25
2020,3,A,골목상권,1000170,난계로30길,4980,2233,2747
2020,3,A,골목상권,1000169,경희대로4길,41,18,23
2020,3,A,골목상권,1000168,경희대로3길,28,16,12
2020,3,A,골목상권,1000167,천호대로129길,344,207,137
2020,3,A,골목상권,1000166,천호대로123길,625,282,343
2020,3,A,골목상권,1000165,천호대로109길,915,504,411
2020,3,A,골목상권,1000164,자양번영로3길,587,462,125
2020,3,A,골목상권,1000163,자양로53길,170,120,50
2020,3,A,골목상권,1000162,자양로50길,218,121,97
2020,3,A,골목상권,1000161,자양로45길,448,184,264
2020,3,A,골목상권,1000160,자양로26길,141,91,50
2020,3,A,골목상권,1000159,자양로15길,106,45,61
2020,3,A,골목상권,1000158,자양로11길,646,250,396
2020,3,A,골목상권,1000157,용마산로3길,541,431,110
2020,3,A,골목상권,1000156,용마산로21길,396,253,143
2020,3,A,골목상권,1000155,아차산로78길,575,421,154
2020,3,A,골목상권,1000154,아차산로65길,357,214,143
2020,3,A,골목상권,1000153,아차산로55길,243,150,93
2020,3,A,골목상권,1000152,아차산로51길,432,110,322
2020,3,A,골목상권,1000151,아차산로40길,357,207,150
2020,3,A,골목상권,1000150,면목로17길,230,138,92
2020,3,A,골목상권,1000149,뚝섬로64길,239,127,112
2020,3,A,골목상권,1000148,뚝섬로58길,278,141,137
2020,3,A,골목상권,1000147,뚝섬로54길,948,798,150
2020,3,A,골목상권,1000146,뚝섬로48길,228,134,94
2020,3,A,골목상권,1000145,뚝섬로24길,111,66,45
2020,3,A,골목상권,1000144,뚝섬로23길,209,148,61
2020,3,A,골목상권,1000143,동일로24길,42,32,10
2020,3,A,골목상권,1000142,동일로18길,79,54,25
2020,3,A,골목상권,1000141,능동로4길,947,834,113
2020,3,A,골목상권,1000140,능동로3길,71,45,26
2020,3,A,골목상권,1000139,능동로34길,1018,676,342
2020,3,A,골목상권,1000138,능동로19길,133,77,56
2020,3,A,골목상권,1000137,능동로13길,221,109,112
2020,3,A,골목상권,1000136,긴고랑로9길,138,51,87
2020,3,A,골목상권,1000135,긴고랑로8길,947,573,374
2020,3,A,골목상권,1000134,긴고랑로7길,460,353,107
2020,3,A,골목상권,1000133,긴고랑로20길,174,98,76
2020,3,A,골목상권,1000132,광나루로52길,649,395,254
2020,3,A,골목상권,1000131,광나루로40길,242,128,114
2020,3,A,골목상권,1000130,광나루로37길,60,29,31
2020,3,A,골목상권,1000129,광나루로36길,412,169,243
2020,3,A,골목상권,1000128,광나루로24길,25,12,13
2020,3,A,골목상권,1000127,광나루로12길,60,19,41
2020,3,A,골목상권,1000126,한림말길,355,174,181
2020,3,A,골목상권,1000125,한림말3길,3329,1128,2201
2020,3,A,골목상권,1000124,청계천로10나길,4951,3728,1223
2020,3,A,골목상권,1000123,장터길,90,46,44
2020,3,A,골목상권,1000122,용답중앙길,93,66,27
2020,3,A,골목상권,1000121,용답29길,537,360,177
2020,3,A,골목상권,1000120,왕십리로6길,538,350,188
2020,3,A,골목상권,1000119,왕십리로31길,208,95,113
2020,3,A,골목상권,1000118,왕십리로26길,2076,1357,719
2020,3,A,골목상권,1000117,왕십리로21길,164,77,87
2020,3,A,골목상권,1000116,왕십리로14길,997,776,221
2020,3,A,골목상권,1000115,아차산로5길,1871,1041,830
2020,3,A,골목상권,1000114,아차산로15길,3361,2374,987
2020,3,A,골목상권,1000113,아차산로11길,3213,2213,1000
2020,3,A,골목상권,1000112,송정4가길,291,123,168
2020,3,A,골목상권,1000111,송정12라길,94,48,46
2020,3,A,골목상권,1000110,성수일로6길,1342,928,414
2020,3,A,골목상권,1000109,성수이로7길,1442,895,547
2020,3,A,골목상권,1000108,성수이로18길,2988,1968,1020
2020,3,A,골목상권,1000107,성덕정길,227,152,75
2020,3,A,골목상권,1000106,성덕정17길,393,244,149
2020,3,A,골목상권,1000105,서울숲2길,335,196,139
2020,3,A,골목상권,1000104,상원길,1919,1334,585
2020,3,A,골목상권,1000103,상원12길,398,238,160
2020,3,A,골목상권,1000102,사근동길,78,48,30
2020,3,A,골목상권,1000101,무학봉길,22,11,11
2020,3,A,골목상권,1000100,무학봉28길,143,69,74
2020,3,A,골목상권,1000099,무학로6길,1897,382,1515
2020,3,A,골목상권,1000098,무수막길,164,122,42
2020,3,A,골목상권,1000097,매봉길,60,30,30
2020,3,A,골목상권,1000096,마조로1길,30,14,16
2020,3,A,골목상권,1000095,마조로16길,155,93,62
2020,3,A,골목상권,1000094,마장로39길,443,258,185
2020,3,A,골목상권,1000093,마장로27길,197,92,105
2020,3,A,골목상권,1000092,뚝섬로5길,2136,1426,710
2020,3,A,골목상권,1000091,둘레9길,419,255,164
2020,3,A,골목상권,1000090,금호산길,159,83,76
2020,3,A,골목상권,1000089,금호산2길,22,12,10
2020,3,A,골목상권,1000088,고산자로6길,704,495,209
2020,3,A,골목상권,1000087,후암로28길,582,313,269
2020,3,A,골목상권,1000086,효창원로39길,163,87,76
2020,3,A,골목상권,1000085,회나무로13길,90,45,45
2020,3,A,골목상권,1000084,한남대로20길,231,131,100
2020,3,A,골목상권,1000083,한강대로88길,224,138,86
2020,3,A,골목상권,1000082,한강대로7길,722,462,260
2020,3,A,골목상권,1000081,한강대로62길,1047,535,512
2020,3,A,골목상권,1000080,한강대로52길,8713,2847,5866
2020,3,A,골목상권,1000079,한강대로43길,1841,1074,767
2020,3,A,골목상권,1000078,한강대로15길,774,417,357
2020,3,A,골목상권,1000077,한강대로104길,8152,1754,6398
2020,3,A,골목상권,1000076,청파로73길,248,128,120
2020,3,A,골목상권,1000075,청파로71길,1317,727,590
2020,3,A,골목상권,1000074,청파로47나길,259,176,83
2020,3,A,골목상권,1000073,청파로47길,192,87,105
2020,3,A,골목상권,1000072,장문로45길,242,106,136
2020,3,A,골목상권,1000071,이태원로54길,812,552,260
2020,3,A,골목상권,1000070,이태원로27길,567,430,137
2020,3,A,골목상권,1000069,이촌로22길,385,307,78
2020,3,A,골목상권,1000068,원효로89길,1387,969,418
2020,3,A,골목상권,1000067,원효로53길,341,222,119
2020,3,A,골목상권,1000066,원효로41길,243,153,90
2020,3,A,골목상권,1000065,원효로19길,609,435,174
2020,3,A,골목상권,1000064,우사단로4길,308,143,165
2020,3,A,골목상권,1000063,우사단로14길,1987,984,1003
2020,3,A,골목상권,1000062,우사단로10길,570,508,62
2020,3,A,골목상권,1000061,신흥로20길,178,118,60
2020,3,A,골목상권,1000060,소월로20길,151,76,75
2020,3,A,골목상권,1000059,서빙고로71길,432,265,167
2020,3,A,골목상권,1000058,백범로90길,535,288,247
2020,3,A,골목상권,1000057,백범로79길,899,560,339
2020,3,A,골목상권,1000056,두텁바위로1길,1111,483,628
2020,3,A,골목상권,1000055,대사관로34길,606,393,213
2020,3,A,골목상권,1000054,녹사평대로46길,43,19,24
2020,3,A,골목상권,1000053,녹사평대로40나길,46,21,25
2020,3,A,골목상권,1000052,녹사평대로32길,56,31,25
2020,3,A,골목상권,1000051,녹사평대로26길,494,230,264
2020,3,A,골목상권,1000050,녹사평대로11길,107,78,29
2020,3,A,골목상권,1000049,퇴계로90길,463,225,238
2020,3,A,골목상권,1000048,퇴계로8길,438,246,192
2020,3,A,골목상권,1000047,퇴계로56길,569,424,145
2020,3,A,골목상권,1000046,퇴계로46길,1098,613,485
2020,3,A,골목상권,1000045,퇴계로18길,967,435,532
2020,3,A,골목상권,1000044,퇴계로12길,180,103,77
2020,3,A,골목상권,1000043,청구로1길,108,72,36
2020,3,A,골목상권,1000042,청구로17길,485,306,179
2020,3,A,골목상권,1000041,장충단로8길,3778,1997,1781
2020,3,A,골목상권,1000040,삼일대로4길,1571,1113,458
2020,3,A,골목상권,1000039,명동길,7830,4550,3280
2020,3,A,골목상권,1000038,동호로8길,386,160,226
2020,3,A,골목상권,1000037,동호로20길,2429,1304,1125
2020,3,A,골목상권,1000036,동호로15길,1161,835,326
2020,3,A,골목상권,1000035,동호로11길,337,208,129
2020,3,A,골목상권,1000034,동호로10길,1553,857,696
2020,3,A,골목상권,1000033,다산로39길,39,19,20
2020,3,A,골목상권,1000032,다산로38길,674,311,363
2020,3,A,골목상권,1000031,다산로36길,91,55,36
2020,3,A,골목상권,1000030,다산로33길,320,201,119
2020,3,A,골목상권,1000029,난계로21길,128,93,35
2020,3,A,골목상권,1000028,난계로11길,255,170,85
2020,3,A,골목상권,1000027,필운대로1길,202,62,140
2020,3,A,골목상권,1000026,평창길,6654,2605,4049
2020,3,A,골목상권,1000025,통일로12길,13,6,7
2020,3,A,골목상권,1000024,창신길,146,29,117
2020,3,A,골목상권,1000023,창신5길,15,7,8
2020,3,A,골목상권,1000022,창신2길,56,26,30
2020,3,A,골목상권,1000021,창경궁로35길,787,171,616
2020,3,A,골목상권,1000020,지봉로8길,183,90,93
2020,3,A,골목상권,1000019,종로65길,275,157,118
2020,3,A,골목상권,1000018,종로58가길,137,71,66
2020,3,A,골목상권,1000017,종로24길,1011,716,295
2020,3,A,골목상권,1000016,자하문로7길,214,83,131
2020,3,A,골목상권,1000015,이화장길,497,221,276
2020,3,A,골목상권,1000014,율곡로16길,235,143,92
2020,3,A,골목상권,1000013,율곡로10길,313,206,107
2020,3,A,골목상권,1000012,옥인길,58,32,26
2020,3,A,골목상권,1000011,숭인동길,329,133,196
2020,3,A,골목상권,1000010,성균관로5길,148,84,64
2020,3,A,골목상권,1000009,삼청로5길,2703,2626,77
2020,3,A,골목상권,1000008,북촌로5나길,234,113,121
2020,3,A,골목상권,1000007,북촌로5길,503,419,84
2020,3,A,골목상권,1000006,북촌로11길,671,232,439
2020,3,A,골목상권,1000005,백석동길,1797,1066,731
2020,3,A,골목상권,1000004,명륜길,56,32,24
2020,3,A,골목상권,1000003,돈화문로11가길,3686,2700,986
2020,3,A,골목상권,1000002,난계로27길,201,114,87
2020,3,A,골목상권,1000001,계동길,842,388,454
2020,2,U,관광특구,1001496,강남 마이스 관광특구,15904,8904,7000
2020,2,U,관광특구,1001495,잠실 관광특구,24375,14199,10176
2020,2,U,관광특구,1001494,종로?청계 관광특구,32935,17150,15785
2020,2,U,관광특구,1001493,동대문패션타운 관광특구,6054,2958,3096
2020,2,U,관광특구,1001492,명동 남대문 북창동 다동 무교동 관광특구,104830,53674,51156
2020,2,U,관광특구,1001491,이태원 관광특구,5839,3064,2775
2020,2,R,전통시장,1001490,길동복조리시장,430,242,188
2020,2,R,전통시장,1001489,둔촌역전통시장,224,108,116
2020,2,R,전통시장,1001488,성내골목시장,30,18,12
2020,2,R,전통시장,1001487,천호시장,35,19,16
2020,2,R,전통시장,1001486,동서울시장,5,3,2
2020,2,R,전통시장,1001484,양지골목시장,60,36,24
2020,2,R,전통시장,1001483,암사종합시장,95,53,42
2020,2,R,전통시장,1001482,고덕전통시장,935,850,85
2020,2,R,전통시장,1001481,명일골목시장,89,30,59
2020,2,R,전통시장,1001480,새마을시장,208,122,86
2020,2,R,전통시장,1001479,석촌시장,286,99,187
2020,2,R,전통시장,1001478,방이시장,3469,1526,1943
2020,2,R,전통시장,1001477,마천시장,102,70,32
2020,2,R,전통시장,1001476,풍납시장,51,20,31
2020,2,R,전통시장,1001475,강남개포시장,138,84,54
2020,2,R,전통시장,1001474,도곡시장,57,25,32
2020,2,R,전통시장,1001473,청담삼익시장,48,30,18
2020,2,R,전통시장,1001472,논현종합시장,85,43,42
2020,2,R,전통시장,1001471,영동전통시장,242,95,147
2020,2,R,전통시장,1001470,강남시장_강남,58,33,25
2020,2,R,전통시장,1001469,양재시장,35,22,13
2020,2,R,전통시장,1001468,남부종합시장,85,63,22
2020,2,R,전통시장,1001467,우림시장,1,0,1
2020,2,R,전통시장,1001466,미성동도깨비시장,75,16,59
2020,2,R,전통시장,1001463,신림중앙시장,43,27,16
2020,2,R,전통시장,1001462,강남골목시장,168,124,44
2020,2,R,전통시장,1001461,신림종합시장,8,7,1
2020,2,R,전통시장,1001460,관악신사시장,120,63,57
2020,2,R,전통시장,1001459,신원시장,42,21,21
2020,2,R,전통시장,1001458,인헌시장,122,46,76
2020,2,R,전통시장,1001457,봉천중앙시장,154,42,112
2020,2,R,전통시장,1001455,봉일시장,44,23,21
2020,2,R,전통시장,1001454,봉천제일종합시장,6,1,5
2020,2,R,전통시장,1001453,낙성대시장,10,6,4
2020,2,R,전통시장,1001452,중부시장,102,40,62
2020,2,R,전통시장,1001451,사당시장,45,20,25
2020,2,R,전통시장,1001450,남성역골목시장,467,268,199
2020,2,R,전통시장,1001449,남성사계시장,136,59,77
2020,2,R,전통시장,1001448,흑석시장,78,31,47
2020,2,R,전통시장,1001447,상도4동도깨비골목시장,95,49,46
2020,2,R,전통시장,1001446,성대시장,141,55,86
2020,2,R,전통시장,1001445,영도시장,73,6,67
2020,2,R,전통시장,1001444,상도전통시장,239,104,135
2020,2,R,전통시장,1001442,신노량진시장,11,3,8
2020,2,R,전통시장,1001441,본동인정시장,59,41,18
2020,2,R,전통시장,1001440,노량진중앙시장,244,157,87
2020,2,R,전통시장,1001439,대림중앙시장,42,29,13
2020,2,R,전통시장,1001438,우리시장,6,5,1
2020,2,R,전통시장,1001436,사러가시장,57,35,22
2020,2,R,전통시장,1001435,대신시장,12,9,3
2020,2,R,전통시장,1001433,영일시장,155,115,40
2020,2,R,전통시장,1001432,도림시장,6,4,2
2020,2,R,전통시장,1001431,영등포청과시장,23,17,6
2020,2,R,전통시장,1001430,영등포전통시장,2127,1061,1066
2020,2,R,전통시장,1001429,은행나무시장,67,40,27
2020,2,R,전통시장,1001428,박미시장,39,26,13
2020,2,R,전통시장,1001427,현대시장,139,42,97
2020,2,R,전통시장,1001426,대명시장,28,11,17
2020,2,R,전통시장,1001425,푸른터시장,3,2,1
2020,2,R,전통시장,1001424,남문시장,76,47,29
2020,2,R,전통시장,1001423,독산동 우시장,611,476,135
2020,2,R,전통시장,1001422,오류시장,132,21,111
2020,2,R,전통시장,1001421,개봉중앙시장,10,7,3
2020,2,R,전통시장,1001420,고척근린시장,55,19,36
2020,2,R,전통시장,1001418,남구로시장,236,135,101
2020,2,R,전통시장,1001417,구로시장,10,5,5
2020,2,R,전통시장,1001415,방신전통시장,116,81,35
2020,2,R,전통시장,1001414,송화골목시장,119,44,75
2020,2,R,전통시장,1001413,까치산시장,114,35,79
2020,2,R,전통시장,1001412,화곡본동시장,36,16,20
2020,2,R,전통시장,1001411,남부골목시장,156,58,98
2020,2,R,전통시장,1001410,대원종합시장,9,7,2
2020,2,R,전통시장,1001409,화곡중앙골목시장,75,32,43
2020,2,R,전통시장,1001408,신월중앙시장,118,53,65
2020,2,R,전통시장,1001406,신정3동골목시장,123,81,42
2020,2,R,전통시장,1001405,신정2동골목시장,41,13,28
2020,2,R,전통시장,1001404,신정제일시장,38,21,17
2020,2,R,전통시장,1001403,신월7동골목시장,24,16,8
2020,2,R,전통시장,1001402,신월6동골목시장,141,103,38
2020,2,R,전통시장,1001400,신월3동골목시장,12,7,5
2020,2,R,전통시장,1001399,경창시장,53,23,30
2020,2,R,전통시장,1001398,월정로시장,61,42,19
2020,2,R,전통시장,1001397,신영시장,40,13,27
2020,2,R,전통시장,1001396,목4동시장,52,35,17
2020,2,R,전통시장,1001395,목3동시장,148,67,81
2020,2,R,전통시장,1001394,목2동시장,432,251,181
2020,2,R,전통시장,1001393,마포농수산물시장,77,40,37
2020,2,R,전통시장,1001392,동진시장,10,6,4
2020,2,R,전통시장,1001391,망원월드컵시장,190,123,67
2020,2,R,전통시장,1001390,망원시장,173,81,92
2020,2,R,전통시장,1001388,영진시장,29,14,15
2020,2,R,전통시장,1001387,서교시장,24,10,14
2020,2,R,전통시장,1001386,신수시장,34,19,15
2020,2,R,전통시장,1001385,아현시장,803,430,373
2020,2,R,전통시장,1001384,마포시장,11,3,8
2020,2,R,전통시장,1001383,공덕시장,3948,2001,1947
2020,2,R,전통시장,1001382,백련시장,5,3,2
2020,2,R,전통시장,1001381,모래내시장,14,9,5
2020,2,R,전통시장,1001380,포방터시장,35,23,12
2020,2,R,전통시장,1001379,인왕시장,44,7,37
2020,2,R,전통시장,1001378,아현가구거리상점가,45,22,23
2020,2,R,전통시장,1001377,영천시장,35,19,16
2020,2,R,전통시장,1001376,수일시장,7,2,5
2020,2,R,전통시장,1001375,증산종합시장,8,5,3
2020,2,R,전통시장,1001374,대림골목시장,237,46,191
2020,2,R,전통시장,1001373,신응암시장,17,10,7
2020,2,R,전통시장,1001372,녹번시장,22,9,13
2020,2,R,전통시장,1001371,대조시장,15,7,8
2020,2,R,전통시장,1001370,역촌중앙시장,9,3,6
2020,2,R,전통시장,1001369,갈현시장,287,186,101
2020,2,R,전통시장,1001368,연서시장,206,144,62
2020,2,R,전통시장,1001367,상계중앙시장,105,59,46
2020,2,R,전통시장,1001366,상계시장,8,2,6
2020,2,R,전통시장,1001365,공릉동도깨비시장,98,47,51
2020,2,R,전통시장,1001364,방학동도깨비시장,39,16,23
2020,2,R,전통시장,1001363,쌍문역골목시장,61,14,47
2020,2,R,전통시장,1001362,백운시장,33,14,19
2020,2,R,전통시장,1001361,신도봉시장,5,5,0
2020,2,R,전통시장,1001360,창동골목시장,84,47,37
2020,2,R,전통시장,1001359,창동신창시장,104,40,64
2020,2,R,전통시장,1001358,수유북부시장,20,14,6
2020,2,R,전통시장,1001357,장미원골목시장,911,571,340
2020,2,R,전통시장,1001356,수유중앙시장,13,8,5
2020,2,R,전통시장,1001355,강북종합시장,23,9,14
2020,2,R,전통시장,1001354,우이시장,69,61,8
2020,2,R,전통시장,1001353,수유전통시장,231,55,176
2020,2,R,전통시장,1001352,번동북부골목시장,50,25,25
2020,2,R,전통시장,1001351,솔샘시장,73,30,43
2020,2,R,전통시장,1001350,숭인시장,62,27,35
2020,2,R,전통시장,1001349,방천골목시장,92,55,37
2020,2,R,전통시장,1001348,동북시장,121,49,72
2020,2,R,전통시장,1001347,석관황금시장,191,157,34
2020,2,R,전통시장,1001345,새석관시장,3,1,2
2020,2,R,전통시장,1001343,장위전통시장,40,20,20
2020,2,R,전통시장,1001342,밤나무골시장,17,5,12
2020,2,R,전통시장,1001341,길음시장,91,19,72
2020,2,R,전통시장,1001340,정릉시장,131,72,59
2020,2,R,전통시장,1001339,정릉아리랑시장,22,7,15
2020,2,R,전통시장,1001338,돈암제일시장,97,22,75
2020,2,R,전통시장,1001337,유영시장,31,20,11
2020,2,R,전통시장,1001336,우림골목시장,344,118,226
2020,2,R,전통시장,1001335,묵1동도깨비시장,35,24,11
2020,2,R,전통시장,1001334,태능시장,81,34,47
2020,2,R,전통시장,1001333,중화제일시장,69,30,39
2020,2,R,전통시장,1001332,사가정시장,86,28,58
2020,2,R,전통시장,1001331,면목골목시장,45,21,24
2020,2,R,전통시장,1001330,동원시장,224,109,115
2020,2,R,전통시장,1001329,동부골목시장,179,59,120
2020,2,R,전통시장,1001327,이경시장,16,8,8
2020,2,R,전통시장,1001326,회기시장,55,17,38
2020,2,R,전통시장,1001325,청량리청과물시장,12,9,3
2020,2,R,전통시장,1001324,전곡시장,77,42,35
2020,2,R,전통시장,1001323,답십리시장,93,40,53
2020,2,R,전통시장,1001322,동부시장,14,9,5
2020,2,R,전통시장,1001321,답십리현대시장,36,31,5
2020,2,R,전통시장,1001320,전농로터리시장,7,3,4
2020,2,R,전통시장,1001319,청량리종합시장,13,8,5
2020,2,R,전통시장,1001318,청량리전통시장,9,7,2
2020,2,R,전통시장,1001316,서울약령시장,1171,642,529
2020,2,R,전통시장,1001315,동서시장,5,3,2
2020,2,R,전통시장,1001314,경동시장,130,61,69
2020,2,R,전통시장,1001313,청량리수산시장,20,11,9
2020,2,R,전통시장,1001312,용두시장,4,2,2
2020,2,R,전통시장,1001309,조양시장,31,19,12
2020,2,R,전통시장,1001308,영동교골목시장,41,30,11
2020,2,R,전통시장,1001307,능동로골목시장,56,42,14
2020,2,R,전통시장,1001306,노룬산골목시장,23,13,10
2020,2,R,전통시장,1001305,자양종합시장,14,10,4
2020,2,R,전통시장,1001304,자양골목시장,54,36,18
2020,2,R,전통시장,1001303,신성골목시장,19,6,13
2020,2,R,전통시장,1001302,면곡골목시장,49,35,14
2020,2,R,전통시장,1001301,중곡제일시장,111,68,43
2020,2,R,전통시장,1001300,화양제일골목시장,43,11,32
2020,2,R,전통시장,1001299,한아름시장,40,29,11
2020,2,R,전통시장,1001298,성동용답상가시장,66,33,33
2020,2,R,전통시장,1001297,뚝도시장,45,17,28
2020,2,R,전통시장,1001296,금남시장,36,13,23
2020,2,R,전통시장,1001295,행당시장,314,140,174
2020,2,R,전통시장,1001294,마장축산물시장,532,358,174
2020,2,R,전통시장,1001293,보광시장,31,12,19
2020,2,R,전통시장,1001292,이태원제일시장,2,1,1
2020,2,R,전통시장,1001291,이태원시장,32,20,12
2020,2,R,전통시장,1001290,이촌종합시장,109,78,31
2020,2,R,전통시장,1001289,용문전통시장,19,10,9
2020,2,R,전통시장,1001288,만리시장,12,9,3
2020,2,R,전통시장,1001287,신흥시장,4,1,3
2020,2,R,전통시장,1001286,후암시장,15,14,1
2020,2,R,전통시장,1001285,합동(새벽)시장,365,209,156
2020,2,R,전통시장,1001284,서울중앙시장,451,320,131
2020,2,R,전통시장,1001283,백학시장,95,43,52
2020,2,R,전통시장,1001282,약수시장,271,105,166
2020,2,R,전통시장,1001281,청평화시장,120,50,70
2020,2,R,전통시장,1001280,제일평화시장,53,29,24
2020,2,R,전통시장,1001279,동평화시장,178,121,57
2020,2,R,전통시장,1001278,남평화시장,5,3,2
2020,2,R,전통시장,1001277,방산종합시장,1190,736,454
2020,2,R,전통시장,1001276,평화시장,906,614,292
2020,2,R,전통시장,1001275,인현시장,167,123,44
2020,2,R,전통시장,1001274,신중부시장,3089,921,2168
2020,2,R,전통시장,1001273,남대문시장,8186,3966,4220
2020,2,R,전통시장,1001272,신설종합시장,50,37,13
2020,2,R,전통시장,1001271,동묘시장,474,223,251
2020,2,R,전통시장,1001270,창신골목시장,13,7,6
2020,2,R,전통시장,1001269,동문시장,3,1,2
2020,2,R,전통시장,1001268,충신시장,77,40,37
2020,2,R,전통시장,1001267,종로신진시장,158,89,69
2020,2,R,전통시장,1001266,동대문종합시장,1319,965,354
2020,2,R,전통시장,1001265,광장시장,444,301,143
2020,2,R,전통시장,1001264,통인시장,59,29,30
2020,2,D,발달상권,1001263,서울 노원구 노원역_3,418,159,259
2020,2,D,발달상권,1001262,서울 노원구 노원역_2,274,126,148
2020,2,D,발달상권,1001261,서울 노원구 노원역_1,336,86,250
2020,2,D,발달상권,1001260,창동역,1003,570,433
2020,2,D,발달상권,1001259,서울 강북구 수유역_3,70,36,34
2020,2,D,발달상권,1001258,등나무근린공원 주변,65,19,46
2020,2,D,발달상권,1001257,서울 강북구 수유역_2,2284,1108,1176
2020,2,D,발달상권,1001256,서울 강북구 수유역_1,831,408,423
2020,2,D,발달상권,1001255,서울 은평구 연신내역_3,108,20,88
2020,2,D,발달상권,1001254,서울 은평구 연신내역_2,555,168,387
2020,2,D,발달상권,1001253,서울 은평구 연신내역_1,70,25,45
2020,2,D,발달상권,1001252,서울 성북구 미아삼거리역_2,322,144,178
2020,2,D,발달상권,1001251,서울 강북구 미아삼거리역_1,140,86,54
2020,2,D,발달상권,1001250,서울 은평구 불광역_3,67,24,43
2020,2,D,발달상권,1001249,서울 은평구 불광역_2,116,39,77
2020,2,D,발달상권,1001248,서울 은평구 불광역_1,180,73,107
2020,2,D,발달상권,1001247,미아사거리_2,102,47,55
2020,2,D,발달상권,1001246,미아사거리_1,210,68,142
2020,2,D,발달상권,1001245,서울 성북구 성신여대입구역,2865,1629,1236
2020,2,D,발달상권,1001244,경희대학교,70,24,46
2020,2,D,발달상권,1001243,서울 성북구 안암역,59,28,31
2020,2,D,발달상권,1001242,혜화역 대학로_3,477,210,267
2020,2,D,발달상권,1001241,혜화역 대학로_2,334,256,78
2020,2,D,발달상권,1001240,혜화역 대학로_1,1230,573,657
2020,2,D,발달상권,1001239,디지털미디어시티,6727,3880,2847
2020,2,D,발달상권,1001238,서울 동대문구 청량리역,776,413,363
2020,2,D,발달상권,1001237,서울 종로구 경복궁역_2,239,107,132
2020,2,D,발달상권,1001236,서울 종로구 안국역_2,810,409,401
2020,2,D,발달상권,1001235,서울 종로구 안국역_1,8804,7324,1480
2020,2,D,발달상권,1001234,서울 종로구 경복궁역_1,599,413,186
2020,2,D,발달상권,1001233,서울 종로구 종로3가역_3,2136,1442,694
2020,2,D,발달상권,1001232,서울 종로구 종로3가역_2,1823,948,875
2020,2,D,발달상권,1001231,서울 동대문구 신설동역_2,5440,2247,3193
2020,2,D,발달상권,1001230,인사동,26072,14829,11243
2020,2,D,발달상권,1001229,서울 종로구 종로5가역_4,1358,810,548
2020,2,D,발달상권,1001228,서울 종로구 종로5가역_3,1766,1160,606
2020,2,D,발달상권,1001227,종로구청,20709,10947,9762
2020,2,D,발달상권,1001226,서울 종로구 종로5가역_2,16173,10184,5989
2020,2,D,발달상권,1001225,신설동역,118,54,64
2020,2,D,발달상권,1001224,서울 동대문구 신설동역_1,1543,677,866
2020,2,D,발달상권,1001223,서울 종로구 광화문역_2,27999,17199,10800
2020,2,D,발달상권,1001222,동묘앞역,223,138,85
2020,2,D,발달상권,1001221,장안동사거리,1587,632,955
2020,2,D,발달상권,1001220,서울 종로구 동대문역_2,748,244,504
2020,2,D,발달상권,1001219,서울 종로구 동대문역_1,28,17,11
2020,2,D,발달상권,1001218,동대문시장_2,195,123,72
2020,2,D,발달상권,1001217,서울 종로구 종로5가역_1,22,9,13
2020,2,D,발달상권,1001216,서울 종로구 종로3가역_1,2657,1167,1490
2020,2,D,발달상권,1001215,서울 종로구 광화문역_1,12759,8498,4261
2020,2,D,발달상권,1001214,종각역,10396,8086,2310
2020,2,D,발달상권,1001213,종각역 젊음의 거리,13040,3576,9464
2020,2,D,발달상권,1001212,서대문구 서대문역_1,99,67,32
2020,2,D,발달상권,1001211,동대문시장_1,1663,493,1170
2020,2,D,발달상권,1001210,시청역_2,14646,9603,5043
2020,2,D,발달상권,1001209,서울시청,9257,4890,4367
2020,2,D,발달상권,1001208,서울 중구 을지로3가역_2,3181,2166,1015
2020,2,D,발달상권,1001207,서울 중구 신당역_2,939,534,405
2020,2,D,발달상권,1001206,서대문구 서대문역_2,1486,1018,468
2020,2,D,발달상권,1001205,동대문역사문화공원역,3166,2548,618
2020,2,D,발달상권,1001204,서울 중구 을지로3가역_1,4549,2258,2291
2020,2,D,발달상권,1001203,명동거리,8147,4244,3903
2020,2,D,발달상권,1001202,롯데백화점,27149,9657,17492
2020,2,D,발달상권,1001201,서울 중구 신당역_1,277,142,135
2020,2,D,발달상권,1001200,북창동,5197,3160,2037
2020,2,D,발달상권,1001199,서울 중구 충무로역_2,16329,7851,8478
2020,2,D,발달상권,1001198,서울 강서구 송정역,335,140,195
2020,2,D,발달상권,1001197,장한평역_2,1492,995,497
2020,2,D,발달상권,1001196,시청역_1,24904,15705,9199
2020,2,D,발달상권,1001195,왕십리역_2,233,102,131
2020,2,D,발달상권,1001194,서울 강서구 발산역,983,431,552
2020,2,D,발달상권,1001193,장한평역_1,1129,748,381
2020,2,D,발달상권,1001192,서울 중구 충무로역_1,3743,2160,1583
2020,2,D,발달상권,1001191,왕십리역_1,8,2,6
2020,2,D,발달상권,1001190,장한평역,3644,2178,1466
2020,2,D,발달상권,1001189,서울 중구 명동역,3595,1952,1643
2020,2,D,발달상권,1001188,장충동 족발거리,2100,985,1115
2020,2,D,발달상권,1001187,한양시장,55,30,25
2020,2,D,발달상권,1001186,서울 서대문구 이대역,380,160,220
2020,2,D,발달상권,1001185,서울 서대문구 신촌역,924,404,520
2020,2,D,발달상권,1001184,서울 마포구 홍대입구역_3,659,386,273
2020,2,D,발달상권,1001183,서울 마포구 홍대입구역_2,977,535,442
2020,2,D,발달상권,1001182,홍익대학교 주변,8725,5062,3663
2020,2,D,발달상권,1001181,서울 광진구 군자역,621,342,279
2020,2,D,발달상권,1001180,신촌역,4403,2012,2391
2020,2,D,발달상권,1001179,강서구청,4278,2468,1810
2020,2,D,발달상권,1001178,서울 마포구 홍대입구역_1,1618,826,792
2020,2,D,발달상권,1001177,서울 중구 약수역_2,210,91,119
2020,2,D,발달상권,1001176,서울 중구 약수역_1,24,6,18
2020,2,D,발달상권,1001175,서울 강동구 고덕역,1359,916,443
2020,2,D,발달상권,1001174,등촌역,64,37,27
2020,2,D,발달상권,1001173,서울 강동구 명일역,671,252,419
2020,2,D,발달상권,1001172,어린이대공원역,41,17,24
2020,2,D,발달상권,1001171,서울 마포구 공덕역_2,3697,2404,1293
2020,2,D,발달상권,1001170,공덕역,2092,1198,894
2020,2,D,발달상권,1001169,서울 용산구 숙대입구역,3807,1436,2371
2020,2,D,발달상권,1001168,남영역,4055,2796,1259
2020,2,D,발달상권,1001167,서울 마포구 공덕역_1,2420,796,1624
2020,2,D,발달상권,1001166,서울 마포구 마포역_2,10151,6130,4021
2020,2,D,발달상권,1001165,서울 광진구 건대입구역_2,529,268,261
2020,2,D,발달상권,1001164,서울 마포구 마포역_1,3369,2292,1077
2020,2,D,발달상권,1001163,서울 강동구 천호역_2,1208,565,643
2020,2,D,발달상권,1001162,서울 광진구 건대입구역_1,109,52,57
2020,2,D,발달상권,1001161,건대입구역,24,11,13
2020,2,D,발달상권,1001160,서울 광진구 구의역,928,584,344
2020,2,D,발달상권,1001159,서울 강동구 천호역,259,93,166
2020,2,D,발달상권,1001158,당산역_2,1429,1069,360
2020,2,D,발달상권,1001157,서울 강동구 천호역_1,138,57,81
2020,2,D,발달상권,1001156,서울 강동구 길동역,2628,1190,1438
2020,2,D,발달상권,1001155,용산 전자상가_5,1976,1461,515
2020,2,D,발달상권,1001154,용산 전자상가_4,248,182,66
2020,2,D,발달상권,1001153,당산역_1,310,186,124
2020,2,D,발달상권,1001152,서울 광진구 강변역,1337,859,478
2020,2,D,발달상권,1001151,용산 전자상가_3,1752,1311,441
2020,2,D,발달상권,1001150,서울 용산구 이태원역,452,292,160
2020,2,D,발달상권,1001149,한남오거리,823,524,299
2020,2,D,발달상권,1001148,목동사거리,41,13,28
2020,2,D,발달상권,1001147,용산 전자상가_2,392,317,75
2020,2,D,발달상권,1001146,용산구청,1526,755,771
2020,2,D,발달상권,1001145,용산 전자상가_1,3893,2851,1042
2020,2,D,발달상권,1001144,국회의사당역_2,19439,11619,7820
2020,2,D,발달상권,1001143,서울 용산구 신용산역,979,675,304
2020,2,D,발달상권,1001142,국회의사당역_1,4563,3517,1046
2020,2,D,발달상권,1001141,압구정 로데오거리_2,7107,2323,4784
2020,2,D,발달상권,1001140,서울 강남구 압구정역,9345,4345,5000
2020,2,D,발달상권,1001139,서울 영등포구 영등포구청역,449,275,174
2020,2,D,발달상권,1001138,압구정 로데오거리_1,14564,7168,7396
2020,2,D,발달상권,1001137,서울 강동구 둔촌동역,250,102,148
2020,2,D,발달상권,1001136,오목교역,125,72,53
2020,2,D,발달상권,1001135,신사동 가로수길,14671,7582,7089
2020,2,D,발달상권,1001134,서울 영등포구 여의도역_2,33585,23274,10311
2020,2,D,발달상권,1001133,청담사거리_3,1376,693,683
2020,2,D,발달상권,1001132,영등포유통상가,1504,962,542
2020,2,D,발달상권,1001131,청담역_2,4142,3212,930
2020,2,D,발달상권,1001130,청담역_1,4062,2913,1149
2020,2,D,발달상권,1001129,청담사거리_2,1289,759,530
2020,2,D,발달상권,1001128,청담사거리_1,529,295,234
2020,2,D,발달상권,1001127,서울 영등포구 여의도역_1,27015,17171,9844
2020,2,D,발달상권,1001126,서울 양천구 신정네거리역_2,28,18,10
2020,2,D,발달상권,1001125,학동사거리_2,2498,1332,1166
2020,2,D,발달상권,1001124,서울 영등포구 영등포시장역,411,246,165
2020,2,D,발달상권,1001123,학동사거리_1,4075,2555,1520
2020,2,D,발달상권,1001122,여의도 시범아파트앞,10435,6976,3459
2020,2,D,발달상권,1001121,영등포역_3,121,70,51
2020,2,D,발달상권,1001120,도산공원사거리_1,4075,1954,2121
2020,2,D,발달상권,1001119,영등포역_2,583,245,338
2020,2,D,발달상권,1001118,문래동 주민센터,6184,3312,2872
2020,2,D,발달상권,1001117,강남구 신사역_2,6953,3586,3367
2020,2,D,발달상권,1001116,영등포역_1,77,27,50
2020,2,D,발달상권,1001115,서울 강남구 강남구청역_2,3172,1916,1256
2020,2,D,발달상권,1001114,강남구 신사역_1,1108,570,538
2020,2,D,발달상권,1001113,서울 동작구 노량진1동_1,40,25,15
2020,2,D,발달상권,1001112,서울 강남구 학동역_3,3152,1780,1372
2020,2,D,발달상권,1001111,서울 강남구 강남구청역_1,3516,2335,1181
2020,2,D,발달상권,1001110,잠실역,42527,22605,19922
2020,2,D,발달상권,1001109,강남구 논현역_4,4927,2720,2207
2020,2,D,발달상권,1001108,학동역,1014,616,398
2020,2,D,발달상권,1001107,방이동 먹자골목,6881,4444,2437
2020,2,D,발달상권,1001106,서울 강남구 학동역_2,2510,1674,836
2020,2,D,발달상권,1001105,서울 동작구 노량진역,436,252,184
2020,2,D,발달상권,1001104,삼성역_3,52277,41226,11051
2020,2,D,발달상권,1001103,코엑스,15904,8904,7000
2020,2,D,발달상권,1001102,서울 강남구 학동역_1,1691,1037,654
2020,2,D,발달상권,1001101,선정릉역_2,3758,2684,1074
2020,2,D,발달상권,1001100,강남구 논현역_3,2466,700,1766
2020,2,D,발달상권,1001099,포스코사거리_2,16526,9641,6885
2020,2,D,발달상권,1001098,포스코사거리_1,22702,15610,7092
2020,2,D,발달상권,1001097,잠실역 롯데월드,2247,1185,1062
2020,2,D,발달상권,1001096,신도림역,1674,907,767
2020,2,D,발달상권,1001095,강남구 논현역_2,9009,5256,3753
2020,2,D,발달상권,1001094,선정릉역_1,2392,1492,900
2020,2,D,발달상권,1001093,신천역,4789,2992,1797
2020,2,D,발달상권,1001092,강남구 논현역_1,2284,1208,1076
2020,2,D,발달상권,1001091,삼성역_2,7062,3420,3642
2020,2,D,발달상권,1001090,삼정역_2,1162,721,441
2020,2,D,발달상권,1001089,삼정역_1,2277,1123,1154
2020,2,D,발달상권,1001088,삼성역_1,18695,12565,6130
2020,2,D,발달상권,1001087,서울 강남구 선릉역_2,40183,20392,19791
2020,2,D,발달상권,1001086,고속터미널역,2010,1612,398
2020,2,D,발달상권,1001085,서울 서초구 강남역,19954,10752,9202
2020,2,D,발달상권,1001084,서울 강남구 선릉역_1,21572,9107,12465
2020,2,D,발달상권,1001083,서울 송파구 석촌역_2,597,380,217
2020,2,D,발달상권,1001082,선릉역_2,26260,16412,9848
2020,2,D,발달상권,1001081,서울 강남구 역삼역_2,19179,15530,3649
2020,2,D,발달상권,1001080,서울 송파구 석촌역_1,168,96,72
2020,2,D,발달상권,1001079,석촌역,170,135,35
2020,2,D,발달상권,1001078,서울 강남구 강남역_2,9449,4629,4820
2020,2,D,발달상권,1001077,선릉역_1,16454,10830,5624
2020,2,D,발달상권,1001076,구로역,201,101,100
2020,2,D,발달상권,1001075,역삼역_2,10137,4381,5756
2020,2,D,발달상권,1001074,대림역_2,5179,3395,1784
2020,2,D,발달상권,1001073,서울 강남구 역삼역_1,22546,15049,7497
2020,2,D,발달상권,1001072,신대방삼거리역,259,129,130
2020,2,D,발달상권,1001071,서울 강남구 한티역,673,371,302
2020,2,D,발달상권,1001070,은마아파트입구사거리_4,570,252,318
2020,2,D,발달상권,1001069,은마아파트입구사거리_3,103,45,58
2020,2,D,발달상권,1001068,은마아파트입구사거리_2,15650,5160,10490
2020,2,D,발달상권,1001067,오류동역,2297,1736,561
2020,2,D,발달상권,1001066,서울 강남구 강남역,27566,14310,13256
2020,2,D,발달상권,1001065,은마아파트입구사거리_1,277,92,185
2020,2,D,발달상권,1001064,대림역_1,340,205,135
2020,2,D,발달상권,1001063,교대역_4,6267,3940,2327
2020,2,D,발달상권,1001062,서울 강남구 강남역_1,25938,14288,11650
2020,2,D,발달상권,1001061,방배동카페골목,374,218,156
2020,2,D,발달상권,1001059,교대역_3,1005,649,356
2020,2,D,발달상권,1001058,역삼역_1,10667,5507,5160
2020,2,D,발달상권,1001057,교대역_2,3971,2510,1461
2020,2,D,발달상권,1001056,서울 송파구 가락시장역,5421,3249,2172
2020,2,D,발달상권,1001055,서울 서초구 서초역,1858,988,870
2020,2,D,발달상권,1001054,서울 강남구 대치역_2,1139,629,510
2020,2,D,발달상권,1001053,서울 강남구 대치역_1,102,38,64
2020,2,D,발달상권,1001052,뱅뱅사거리_2,12301,8384,3917
2020,2,D,발달상권,1001051,보라매공원,2417,1455,962
2020,2,D,발달상권,1001050,교대역_1,17722,8352,9370
2020,2,D,발달상권,1001049,개봉동 현대아파트 인근,271,126,145
2020,2,D,발달상권,1001048,뱅뱅사거리,7114,4891,2223
2020,2,D,발달상권,1001047,뱅뱅사거리_1,4820,3658,1162
2020,2,D,발달상권,1001046,서울 관악구 신림역_4,332,165,167
2020,2,D,발달상권,1001045,동작구 총신대입구역_1,327,125,202
2020,2,D,발달상권,1001044,양재역_3,9025,5664,3361
2020,2,D,발달상권,1001043,동작구 총신대입구역_2,1633,741,892
2020,2,D,발달상권,1001042,서울 서초구 남부터미널역_3,3060,1217,1843
2020,2,D,발달상권,1001041,서울 강남구 수서역,12418,6339,6079
2020,2,D,발달상권,1001040,서울 관악구 신림역_3,77,20,57
2020,2,D,발달상권,1001039,서울 서초구 남부터미널역_2,3012,1965,1047
2020,2,D,발달상권,1001038,구로디지탈1단지,43655,28446,15209
2020,2,D,발달상권,1001037,양재역,904,474,430
2020,2,D,발달상권,1001036,문정역,88,52,36
2020,2,D,발달상권,1001035,매봉역,5760,4107,1653
2020,2,D,발달상권,1001034,서울 서초구 방배역,1690,910,780
2020,2,D,발달상권,1001033,서울 서초구 남부터미널역_1,2033,1323,710
2020,2,D,발달상권,1001032,서울 관악구 신림역_2,166,63,103
2020,2,D,발달상권,1001031,서울 관악구 신림역_1,615,316,299
2020,2,D,발달상권,1001030,양재역_2,2634,1725,909
2020,2,D,발달상권,1001029,양재역_1,515,305,210
2020,2,D,발달상권,1001028,서울 관악구 서울대입구역_2,57,28,29
2020,2,D,발달상권,1001027,가산디지털단지역_3,22935,14390,8545
2020,2,D,발달상권,1001026,구로디지털단지역,91,67,24
2020,2,D,발달상권,1001025,서울 관악구 서울대입구역_1,1502,797,705
2020,2,D,발달상권,1001024,관악구 사당역_1,5523,2253,3270
2020,2,D,발달상권,1001023,가산디지털단지역_2,25194,16241,8953
2020,2,D,발달상권,1001022,관악구 사당역_2,744,453,291
2020,2,D,발달상권,1001021,가산디지털단지역_1,18317,12138,6179
2020,2,D,발달상권,1001020,장지역,4411,3129,1282
2020,2,D,발달상권,1001019,포이사거리_1,192,141,51
2020,2,D,발달상권,1001018,포이사거리_2,7673,5359,2314
2020,2,D,발달상권,1001017,관악구 사당역_3,1538,1135,403
2020,2,D,발달상권,1001016,서울 관악구 대학동_1,662,558,104
2020,2,D,발달상권,1001015,서울 금천구 독산1동_1,716,485,231
2020,2,D,발달상권,1001014,양재동 꽃시장,1540,858,682
2020,2,D,발달상권,1001013,양재 화물트럭터미널앞_2,843,619,224
2020,2,D,발달상권,1001012,양재 화물트럭터미널앞_1,1944,1643,301
2020,2,D,발달상권,1001011,서울 금천구 시흥1동_4,486,164,322
2020,2,A,골목상권,1001010,풍성로37가길,128,57,71
2020,2,A,골목상권,1001009,천호옛길,420,288,132
2020,2,A,골목상권,1001008,천호옛14길,177,93,84
2020,2,A,골목상권,1001007,천호대로219길,486,338,148
2020,2,A,골목상권,1001006,천호대로197길,239,168,71
2020,2,A,골목상권,1001005,천호대로187길,371,200,171
2020,2,A,골목상권,1001004,천호대로170길,303,177,126
2020,2,A,골목상권,1001003,천호대로162길,286,149,137
2020,2,A,골목상권,1001002,천중로51길,761,536,225
2020,2,A,골목상권,1001001,천중로39길,574,375,199
2020,2,A,골목상권,1001000,진황도로47길,131,63,68
2020,2,A,골목상권,1000999,진황도로27길,298,174,124
2020,2,A,골목상권,1000998,올림픽로98길,257,169,88
2020,2,A,골목상권,1000997,올림픽로80길,152,54,98
2020,2,A,골목상권,1000996,올림픽로78길,115,58,57
2020,2,A,골목상권,1000995,올림픽로77길,210,114,96
2020,2,A,골목상권,1000994,올림픽로71길,184,101,83
2020,2,A,골목상권,1000993,올림픽로48길,1847,1272,575
2020,2,A,골목상권,1000992,양재대로96길,197,131,66
2020,2,A,골목상권,1000991,양재대로95길,602,324,278
2020,2,A,골목상권,1000990,양재대로91길,358,230,128
2020,2,A,골목상권,1000989,양재대로133길,189,122,67
2020,2,A,골목상권,1000988,양재대로124길,435,258,177
2020,2,A,골목상권,1000987,양재대로116길,75,41,34
2020,2,A,골목상권,1000986,양재대로101길,677,313,364
2020,2,A,골목상권,1000985,암사길,112,70,42
2020,2,A,골목상권,1000984,성안로3길,5508,4242,1266
2020,2,A,골목상권,1000983,성내로5길,1005,650,355
2020,2,A,골목상권,1000982,상일로5길,172,124,48
2020,2,A,골목상권,1000981,상암로5길,271,99,172
2020,2,A,골목상권,1000980,상암로51길,302,122,180
2020,2,A,골목상권,1000979,상암로4길,232,147,85
2020,2,A,골목상권,1000978,상암로14길,432,261,171
2020,2,A,골목상권,1000977,명일로13길,302,182,120
2020,2,A,골목상권,1000976,동남로85길,635,344,291
2020,2,A,골목상권,1000975,동남로82길,108,64,44
2020,2,A,골목상권,1000974,동남로65길,297,202,95
2020,2,A,골목상권,1000973,구천면로42길,87,52,35
2020,2,A,골목상권,1000972,구천면로41길,442,228,214
2020,2,A,골목상권,1000971,구천면로36길,32,14,18
2020,2,A,골목상권,1000970,고덕로61길,137,93,44
2020,2,A,골목상권,1000969,고덕로25길,143,91,52
2020,2,A,골목상권,1000968,고덕로10길,738,335,403
2020,2,A,골목상권,1000967,강동대로53길,1092,726,366
2020,2,A,골목상권,1000966,풍성로25길,84,43,41
2020,2,A,골목상권,1000965,오금로46길,711,359,352
2020,2,A,골목상권,1000964,오금로36길,1133,803,330
2020,2,A,골목상권,1000963,오금로11길,1427,884,543
2020,2,A,골목상권,1000962,양재대로72길,245,124,121
2020,2,A,골목상권,1000961,양재대로71길,1999,1458,541
2020,2,A,골목상권,1000960,양재대로64길,1212,705,507
2020,2,A,골목상권,1000959,양재대로62길,3230,2137,1093
2020,2,A,골목상권,1000958,송파대로30길,2240,1393,847
2020,2,A,골목상권,1000957,송이로36길,2096,1409,687
2020,2,A,골목상권,1000956,송이로32길,1295,733,562
2020,2,A,골목상권,1000955,송이로23길,1850,1269,581
2020,2,A,골목상권,1000954,삼전로13길,1420,916,504
2020,2,A,골목상권,1000953,백제고분로50길,1209,796,413
2020,2,A,골목상권,1000952,백제고분로46길,665,472,193
2020,2,A,골목상권,1000951,백제고분로45길,1349,869,480
2020,2,A,골목상권,1000950,백제고분로42길,590,289,301
2020,2,A,골목상권,1000949,백제고분로39길,566,393,173
2020,2,A,골목상권,1000948,백제고분로34길,1779,1368,411
2020,2,A,골목상권,1000947,백제고분로33길,921,574,347
2020,2,A,골목상권,1000946,백제고분로32길,725,407,318
2020,2,A,골목상권,1000945,백제고분로31길,1708,1370,338
2020,2,A,골목상권,1000944,백제고분로22길,1371,955,416
2020,2,A,골목상권,1000943,백제고분로21길,483,309,174
2020,2,A,골목상권,1000942,마천로51길,417,245,172
2020,2,A,골목상권,1000941,동남로20길,2463,1773,690
2020,2,A,골목상권,1000940,거마로20길,503,229,274
2020,2,A,골목상권,1000939,학동로77길,1851,1119,732
2020,2,A,골목상권,1000938,학동로6길,1447,977,470
2020,2,A,골목상권,1000937,학동로56길,2421,1533,888
2020,2,A,골목상권,1000936,학동로38길,1862,891,971
2020,2,A,골목상권,1000935,테헤란로81길,1637,791,846
2020,2,A,골목상권,1000934,일원로9길,590,334,256
2020,2,A,골목상권,1000933,일원로3길,513,237,276
2020,2,A,골목상권,1000932,영동대로65길,1175,692,483
2020,2,A,골목상권,1000931,영동대로112길,9367,7734,1633
2020,2,A,골목상권,1000930,언주로81길,5810,3989,1821
2020,2,A,골목상권,1000929,압구정로2길,1937,1352,585
2020,2,A,골목상권,1000928,선릉로18길,466,366,100
2020,2,A,골목상권,1000927,선릉로146길,1123,536,587
2020,2,A,골목상권,1000926,선릉로133길,739,434,305
2020,2,A,골목상권,1000925,선릉로132길,1305,645,660
2020,2,A,골목상권,1000924,선릉로121길,2263,1243,1020
2020,2,A,골목상권,1000923,삼성로75길,1814,1262,552
2020,2,A,골목상권,1000922,삼성로69길,2064,1086,978
2020,2,A,골목상권,1000921,삼성로64길,2957,1473,1484
2020,2,A,골목상권,1000920,삼성로63길,1079,554,525
2020,2,A,골목상권,1000919,삼성로57길,3231,1896,1335
2020,2,A,골목상권,1000918,삼성로147길,190,88,102
2020,2,A,골목상권,1000917,삼성로115길,839,429,410
2020,2,A,골목상권,1000916,봉은사로68길,1265,789,476
2020,2,A,골목상권,1000915,봉은사로57길,638,409,229
2020,2,A,골목상권,1000914,봉은사로43길,2978,1692,1286
2020,2,A,골목상권,1000913,봉은사로29길,1860,1203,657
2020,2,A,골목상권,1000912,봉은사로109길,2837,2093,744
2020,2,A,골목상권,1000911,도산대로89길,1284,730,554
2020,2,A,골목상권,1000910,도산대로81길,3094,1363,1731
2020,2,A,골목상권,1000909,도산대로50길,2685,1863,822
2020,2,A,골목상권,1000908,도산대로38길,1043,622,421
2020,2,A,골목상권,1000907,도산대로30길,3153,1611,1542
2020,2,A,골목상권,1000906,도산대로23길,425,176,249
2020,2,A,골목상권,1000905,도산대로15길,123,65,58
2020,2,A,골목상권,1000904,도곡로37길,7206,4518,2688
2020,2,A,골목상권,1000903,논현로8길,1081,701,380
2020,2,A,골목상권,1000902,논현로63길,2139,1352,787
2020,2,A,골목상권,1000901,논현로28길,2736,1826,910
2020,2,A,골목상권,1000900,논현로26길,17916,5148,12768
2020,2,A,골목상권,1000899,논현로159길,109,49,60
2020,2,A,골목상권,1000898,논현로139길,3565,2123,1442
2020,2,A,골목상권,1000897,논현로123길,162,106,56
2020,2,A,골목상권,1000896,논현로115길,2866,1752,1114
2020,2,A,골목상권,1000895,논현로10길,454,271,183
2020,2,A,골목상권,1000894,논현로106길,1488,1027,461
2020,2,A,골목상권,1000893,남부순환로365길,691,445,246
2020,2,A,골목상권,1000892,개포로82길,103,51,52
2020,2,A,골목상권,1000891,개포로28길,589,445,144
2020,2,A,골목상권,1000890,개포로20길,647,400,247
2020,2,A,골목상권,1000889,개포로17길,961,659,302
2020,2,A,골목상권,1000888,강남대로140길,1433,810,623
2020,2,A,골목상권,1000887,강남대로136길,5070,3655,1415
2020,2,A,골목상권,1000886,강남대로118길,218,91,127
2020,2,A,골목상권,1000885,서초중앙로8길,21671,11288,10383
2020,2,A,골목상권,1000884,방배중앙로21길,7153,2605,4548
2020,2,A,골목상권,1000883,효령로72길,3428,2690,738
2020,2,A,골목상권,1000882,효령로34길,1015,653,362
2020,2,A,골목상권,1000881,효령로31길,2710,2198,512
2020,2,A,골목상권,1000880,효령로23길,1492,964,528
2020,2,A,골목상권,1000879,청두곶길,1446,795,651
2020,2,A,골목상권,1000878,주흥길,164,111,53
2020,2,A,골목상권,1000877,주흥15길,834,539,295
2020,2,A,골목상권,1000876,언남길,1128,742,386
2020,2,A,골목상권,1000875,신반포로45길,1192,625,567
2020,2,A,골목상권,1000874,서초대로8길,2598,644,1954
2020,2,A,골목상권,1000873,서초대로64길,829,489,340
2020,2,A,골목상권,1000872,서초대로4길,847,478,369
2020,2,A,골목상권,1000871,서초대로25길,2073,1591,482
2020,2,A,골목상권,1000870,서초대로23길,2098,1239,859
2020,2,A,골목상권,1000869,서초대로15길,467,253,214
2020,2,A,골목상권,1000868,사평대로57길,65,33,32
2020,2,A,골목상권,1000867,사평대로26길,509,346,163
2020,2,A,골목상권,1000866,사평대로22길,1697,1052,645
2020,2,A,골목상권,1000865,사임당로17길,1939,1273,666
2020,2,A,골목상권,1000864,방배로42길,861,707,154
2020,2,A,골목상권,1000863,방배로35길,1137,711,426
2020,2,A,골목상권,1000862,방배로18길,873,535,338
2020,2,A,골목상권,1000861,반포대로9길,538,288,250
2020,2,A,골목상권,1000860,바우뫼로39길,2648,1935,713
2020,2,A,골목상권,1000859,마방로2길,3582,2570,1012
2020,2,A,골목상권,1000858,방배천로4안길,959,401,558
2020,2,A,골목상권,1000857,동산로19길,1276,633,643
2020,2,A,골목상권,1000856,동산로10길,2158,1493,665
2020,2,A,골목상권,1000855,동광로39길,1227,825,402
2020,2,A,골목상권,1000854,동광로1길,2565,1862,703
2020,2,A,골목상권,1000853,동광로12길,1237,610,627
2020,2,A,골목상권,1000852,논현로27길,2808,2146,662
2020,2,A,골목상권,1000851,논현로1길,1227,780,447
2020,2,A,골목상권,1000850,남부순환로339길,1451,978,473
2020,2,A,골목상권,1000849,남부순환로325길,1477,1061,416
2020,2,A,골목상권,1000848,남부순환로317길,2386,1532,854
2020,2,A,골목상권,1000847,고무래로8길,5479,3568,1911
2020,2,A,골목상권,1000846,강남대로8길,1850,1231,619
2020,2,A,골목상권,1000845,강남대로34길,1734,1204,530
2020,2,A,골목상권,1000844,강남대로23길,2897,1993,904
2020,2,A,골목상권,1000843,소담길,14,4,10
2020,2,A,골목상권,1000842,원신길,22,11,11
2020,2,A,골목상권,1000840,양산길,11,3,8
2020,2,A,골목상권,1000839,호암로24길,1218,1084,134
2020,2,A,골목상권,1000838,호암로20길,186,77,109
2020,2,A,골목상권,1000837,행운길,557,428,129
2020,2,A,골목상권,1000836,행운1길,250,151,99
2020,2,A,골목상권,1000835,청림3길,167,58,109
2020,2,A,골목상권,1000834,청룡길,404,224,180
2020,2,A,골목상권,1000833,청룡8길,222,53,169
2020,2,A,골목상권,1000832,중앙길,99,30,69
2020,2,A,골목상권,1000831,조원중앙로2길,921,694,227
2020,2,A,골목상권,1000830,조원로18길,179,92,87
2020,2,A,골목상권,1000829,조원로10길,397,215,182
2020,2,A,골목상권,1000828,장군봉2길,201,115,86
2020,2,A,골목상권,1000827,장군봉1길,326,166,160
2020,2,A,골목상권,1000826,인헌길,115,61,54
2020,2,A,골목상권,1000825,은천로25길,44,21,23
2020,2,A,골목상권,1000824,양녕로6길,205,124,81
2020,2,A,골목상권,1000823,신원로3길,180,103,77
2020,2,A,골목상권,1000822,신사로20길,121,93,28
2020,2,A,골목상권,1000821,신림로65길,228,175,53
2020,2,A,골목상권,1000820,신림로64길,113,45,68
2020,2,A,골목상권,1000819,신림로48길,75,49,26
2020,2,A,골목상권,1000818,신림로38길,147,90,57
2020,2,A,골목상권,1000817,신림로28길,442,283,159
2020,2,A,골목상권,1000816,신림로11길,284,183,101
2020,2,A,골목상권,1000815,신림동길,669,435,234
2020,2,A,골목상권,1000814,승방길,251,141,110
2020,2,A,골목상권,1000813,서림7길,116,58,58
2020,2,A,골목상권,1000812,봉천로33길,211,131,80
2020,2,A,골목상권,1000811,봉천로13길,241,86,155
2020,2,A,골목상권,1000810,복은길,405,229,176
2020,2,A,골목상권,1000809,법원단지길,16,5,11
2020,2,A,골목상권,1000808,법원단지9길,163,102,61
2020,2,A,골목상권,1000807,미성5길,309,154,155
2020,2,A,골목상권,1000806,대학길,80,45,35
2020,2,A,골목상권,1000805,대학14길,61,31,30
2020,2,A,골목상권,1000804,당곡길,227,117,110
2020,2,A,골목상권,1000803,남현길,117,28,89
2020,2,A,골목상권,1000802,남현3길,372,256,116
2020,2,A,골목상권,1000801,남현2길,568,398,170
2020,2,A,골목상권,1000800,남부순환로248길,404,213,191
2020,2,A,골목상권,1000799,남부순환로234길,126,81,45
2020,2,A,골목상권,1000798,남부순환로172길,450,316,134
2020,2,A,골목상권,1000797,남부순환로161길,347,223,124
2020,2,A,골목상권,1000796,남부순환로151길,788,369,419
2020,2,A,골목상권,1000795,남부순환로142길,418,252,166
2020,2,A,골목상권,1000794,난향길,206,89,117
2020,2,A,골목상권,1000793,난우길,217,121,96
2020,2,A,골목상권,1000792,난곡로74길,2179,1754,425
2020,2,A,골목상권,1000791,난곡로34길,47,19,28
2020,2,A,골목상권,1000790,난곡로26길,120,85,35
2020,2,A,골목상권,1000789,난곡로24길,89,34,55
2020,2,A,골목상권,1000788,낙성대역길,431,230,201
2020,2,A,골목상권,1000787,국회단지길,1430,396,1034
2020,2,A,골목상권,1000786,구암길,228,72,156
2020,2,A,골목상권,1000785,관천로22길,194,117,77
2020,2,A,골목상권,1000784,관천로15길,236,149,87
2020,2,A,골목상권,1000783,관악로30길,140,51,89
2020,2,A,골목상권,1000782,관악로28길,122,39,83
2020,2,A,골목상권,1000781,관악로14길,109,42,67
2020,2,A,골목상권,1000780,관악로10길,1482,1050,432
2020,2,A,골목상권,1000779,흑석로9길,110,76,34
2020,2,A,골목상권,1000778,흑석로13길,77,33,44
2020,2,A,골목상권,1000777,장승배기로27길,260,135,125
2020,2,A,골목상권,1000776,장승배기로19길,518,409,109
2020,2,A,골목상권,1000775,장승배기로10길,223,90,133
2020,2,A,골목상권,1000774,여의대방로46길,1238,733,505
2020,2,A,골목상권,1000773,여의대방로24길,16249,10586,5663
2020,2,A,골목상권,1000772,여의대방로22카길,346,202,144
2020,2,A,골목상권,1000771,여의대방로22나길,188,95,93
2020,2,A,골목상권,1000770,여의대방로22길,241,128,113
2020,2,A,골목상권,1000769,양녕로26길,92,49,43
2020,2,A,골목상권,1000768,신대방길,191,90,101
2020,2,A,골목상권,1000767,성대로29길,297,143,154
2020,2,A,골목상권,1000766,성대로1길,87,43,44
2020,2,A,골목상권,1000765,서달로8가길,83,34,49
2020,2,A,골목상권,1000764,서달로15길,42,14,28
2020,2,A,골목상권,1000763,서달로14길,21,7,14
2020,2,A,골목상권,1000762,서달로10길,51,28,23
2020,2,A,골목상권,1000761,상도로62길,332,179,153
2020,2,A,골목상권,1000760,상도로61길,187,67,120
2020,2,A,골목상권,1000759,상도로47길,601,288,313
2020,2,A,골목상권,1000758,상도로37길,128,65,63
2020,2,A,골목상권,1000757,상도로15길,320,121,199
2020,2,A,골목상권,1000756,사당로8길,131,70,61
2020,2,A,골목상권,1000755,사당로30길,514,180,334
2020,2,A,골목상권,1000754,사당로2차길,324,216,108
2020,2,A,골목상권,1000753,사당로29길,128,78,50
2020,2,A,골목상권,1000752,사당로26길,321,199,122
2020,2,A,골목상권,1000751,사당로23나길,36,21,15
2020,2,A,골목상권,1000749,사당로20길,103,53,50
2020,2,A,골목상권,1000748,사당로16길,116,36,80
2020,2,A,골목상권,1000747,사당로16가길,237,147,90
2020,2,A,골목상권,1000746,만양로8길,824,512,312
2020,2,A,골목상권,1000745,만양로14길,47,29,18
2020,2,A,골목상권,1000744,등용로14길,409,134,275
2020,2,A,골목상권,1000743,동작대로7길,182,84,98
2020,2,A,골목상권,1000742,동작대로35길,190,87,103
2020,2,A,골목상권,1000741,동작대로33길,170,88,82
2020,2,A,골목상권,1000740,동작대로29길,224,49,175
2020,2,A,골목상권,1000739,동작대로17길,806,386,420
2020,2,A,골목상권,1000738,대방동2길,281,134,147
2020,2,A,골목상권,1000737,대방동27길,465,223,242
2020,2,A,골목상권,1000736,노량진로6길,307,204,103
2020,2,A,골목상권,1000735,국사봉길,138,79,59
2020,2,A,골목상권,1000734,국사봉2길,55,34,21
2020,2,A,골목상권,1000733,국사봉1길,85,52,33
2020,2,A,골목상권,1000732,영신로9길,3221,1646,1575
2020,2,A,골목상권,1000731,영등포로84길,1933,673,1260
2020,2,A,골목상권,1000730,영등포로80길,96,48,48
2020,2,A,골목상권,1000729,영등포로62길,118,85,33
2020,2,A,골목상권,1000728,영등포로35길,340,192,148
2020,2,A,골목상권,1000727,영등포로27길,301,189,112
2020,2,A,골목상권,1000726,영등포로25길,493,363,130
2020,2,A,골목상권,1000725,여의대방로61길,514,400,114
2020,2,A,골목상권,1000724,여의대방로43나길,859,661,198
2020,2,A,골목상권,1000723,여의대방로39길,193,112,81
2020,2,A,골목상권,1000722,여의대방로35길,197,65,132
2020,2,A,골목상권,1000721,양평로28길,847,707,140
2020,2,A,골목상권,1000720,양평로22라길,555,299,256
2020,2,A,골목상권,1000719,양평로19길,748,436,312
2020,2,A,골목상권,1000718,신길로60길,260,196,64
2020,2,A,골목상권,1000717,신길로42길,501,270,231
2020,2,A,골목상권,1000716,신길로42가길,210,90,120
2020,2,A,골목상권,1000715,신길로39길,56,32,24
2020,2,A,골목상권,1000714,신길로17길,676,289,387
2020,2,A,골목상권,1000713,선유서로28길,208,110,98
2020,2,A,골목상권,1000712,선유서로25길,1697,1284,413
2020,2,A,골목상권,1000711,선유서로24길,114,70,44
2020,2,A,골목상권,1000710,선유로55길,416,273,143
2020,2,A,골목상권,1000709,디지털로74길,13,8,5
2020,2,A,골목상권,1000708,디지털로57길,1036,639,397
2020,2,A,골목상권,1000707,디지털로37길,172,55,117
2020,2,A,골목상권,1000706,도신로62길,227,173,54
2020,2,A,골목상권,1000705,도신로60길,124,51,73
2020,2,A,골목상권,1000704,도신로29길,108,49,59
2020,2,A,골목상권,1000703,도신로15길,437,238,199
2020,2,A,골목상권,1000702,도림천로21길,236,157,79
2020,2,A,골목상권,1000701,도림로63길,53,41,12
2020,2,A,골목상권,1000700,도림로147길,334,255,79
2020,2,A,골목상권,1000699,도림로112길,30,19,11
2020,2,A,골목상권,1000698,대림로8길,234,113,121
2020,2,A,골목상권,1000697,대림로7길,49,23,26
2020,2,A,골목상권,1000696,대림로44길,411,289,122
2020,2,A,골목상권,1000695,대림로34길,201,139,62
2020,2,A,골목상권,1000694,대림로31길,454,281,173
2020,2,A,골목상권,1000693,대림로29길,964,624,340
2020,2,A,골목상권,1000692,대림로22길,190,98,92
2020,2,A,골목상권,1000691,당산로46길,698,529,169
2020,2,A,골목상권,1000690,당산로38길,676,471,205
2020,2,A,골목상권,1000689,당산로37길,2439,1483,956
2020,2,A,골목상권,1000688,당산로31길,1481,749,732
2020,2,A,골목상권,1000687,국회대로56길,3275,1590,1685
2020,2,A,골목상권,1000686,경인로90길,282,210,72
2020,2,A,골목상권,1000685,경인로80길,1007,706,301
2020,2,A,골목상권,1000684,경인로77길,741,512,229
2020,2,A,골목상권,1000683,가마산로61길,47,35,12
2020,2,A,골목상권,1000682,시흥대로94길,446,164,282
2020,2,A,골목상권,1000681,시흥대로84길,178,103,75
2020,2,A,골목상권,1000680,시흥대로68길,549,219,330
2020,2,A,골목상권,1000679,시흥대로63길,1016,542,474
2020,2,A,골목상권,1000678,시흥대로62가길,86,59,27
2020,2,A,골목상권,1000677,시흥대로36길,288,173,115
2020,2,A,골목상권,1000676,시흥대로22길,259,143,116
2020,2,A,골목상권,1000675,시흥대로153길,92,55,37
2020,2,A,골목상권,1000674,시흥대로150길,421,278,143
2020,2,A,골목상권,1000673,시흥대로141길,214,142,72
2020,2,A,골목상권,1000672,시흥대로138길,341,246,95
2020,2,A,골목상권,1000671,시흥대로120길,192,117,75
2020,2,A,골목상권,1000670,벚꽃로56길,301,260,41
2020,2,A,골목상권,1000669,범안로17길,4567,2830,1737
2020,2,A,골목상권,1000668,범안로11길,1498,819,679
2020,2,A,골목상권,1000667,문성로5길,379,199,180
2020,2,A,골목상권,1000666,독산로85길,68,34,34
2020,2,A,골목상권,1000665,독산로78다길,195,124,71
2020,2,A,골목상권,1000664,독산로70길,74,31,43
2020,2,A,골목상권,1000663,독산로64길,186,152,34
2020,2,A,골목상권,1000662,독산로50길,27,6,21
2020,2,A,골목상권,1000661,독산로40길,219,75,144
2020,2,A,골목상권,1000660,독산로108길,1619,1443,176
2020,2,A,골목상권,1000659,남부순환로112길,96,66,30
2020,2,A,골목상권,1000658,금하로24길,132,72,60
2020,2,A,골목상권,1000657,금하로1길,227,175,52
2020,2,A,골목상권,1000656,금하로14길,96,65,31
2020,2,A,골목상권,1000655,가산로5길,499,350,149
2020,2,A,골목상권,1000654,가산로3길,999,756,243
2020,2,A,골목상권,1000653,중앙로1길,960,704,256
2020,2,A,골목상권,1000652,중앙로15길,171,106,65
2020,2,A,골목상권,1000651,우마길,43,19,24
2020,2,A,골목상권,1000650,오류로8길,442,219,223
2020,2,A,골목상권,1000649,신도림로13길,148,100,48
2020,2,A,골목상권,1000648,새말로18길,933,549,384
2020,2,A,골목상권,1000647,부일로1길,356,321,35
2020,2,A,골목상권,1000646,부일로15길,156,107,49
2020,2,A,골목상권,1000645,부일로11길,281,115,166
2020,2,A,골목상권,1000644,디지털로32길,815,435,380
2020,2,A,골목상권,1000643,디지털로32가길,2221,1322,899
2020,2,A,골목상권,1000642,디지털로27길,26,20,6
2020,2,A,골목상권,1000641,도림로6길,160,93,67
2020,2,A,골목상권,1000640,도림로12길,186,124,62
2020,2,A,골목상권,1000639,남부순환로97길,101,48,53
2020,2,A,골목상권,1000638,구로중앙로8길,107,41,66
2020,2,A,골목상권,1000637,구로중앙로7길,86,42,44
2020,2,A,골목상권,1000636,구로중앙로42길,403,284,119
2020,2,A,골목상권,1000635,구로중앙로34길,189,149,40
2020,2,A,골목상권,1000634,구로중앙로28길,470,226,244
2020,2,A,골목상권,1000633,구로중앙로19길,666,398,268
2020,2,A,골목상권,1000632,구로동로8길,298,153,145
2020,2,A,골목상권,1000631,구로동로7길,115,71,44
2020,2,A,골목상권,1000630,구로동로42길,131,75,56
2020,2,A,골목상권,1000629,구로동로41길,119,79,40
2020,2,A,골목상권,1000628,구로동로38길,625,240,385
2020,2,A,골목상권,1000627,구로동로28길,42,18,24
2020,2,A,골목상권,1000626,구로동로15길,88,50,38
2020,2,A,골목상권,1000625,공원로6가길,1158,755,403
2020,2,A,골목상권,1000624,고척로52길,40,27,13
2020,2,A,골목상권,1000623,고척로27다길,169,99,70
2020,2,A,골목상권,1000622,고척로27길,309,167,142
2020,2,A,골목상권,1000621,고척로21나길,369,197,172
2020,2,A,골목상권,1000620,경인로47길,657,264,393
2020,2,A,골목상권,1000619,경인로35길,364,232,132
2020,2,A,골목상권,1000618,경인로31길,130,61,69
2020,2,A,골목상권,1000617,경인로15길,259,93,166
2020,2,A,골목상권,1000616,개봉로3길,273,139,134
2020,2,A,골목상권,1000615,개봉로2길,186,99,87
2020,2,A,골목상권,1000614,개봉로23가길,826,590,236
2020,2,A,골목상권,1000613,개봉로20길,3082,1346,1736
2020,2,A,골목상권,1000612,개봉로1길,187,126,61
2020,2,A,골목상권,1000611,개봉로17다길,2362,1606,756
2020,2,A,골목상권,1000610,개봉로17길,1304,418,886
2020,2,A,골목상권,1000609,개봉로11길,181,97,84
2020,2,A,골목상권,1000608,화곡로64길,1128,686,442
2020,2,A,골목상권,1000607,화곡로59길,316,232,84
2020,2,A,골목상권,1000606,화곡로44나길,625,559,66
2020,2,A,골목상권,1000605,화곡로31길,618,375,243
2020,2,A,골목상권,1000604,화곡로20길,355,193,162
2020,2,A,골목상권,1000603,화곡로13길,368,249,119
2020,2,A,골목상권,1000602,초원로16길,523,369,154
2020,2,A,골목상권,1000601,초록마을로8길,116,68,48
2020,2,A,골목상권,1000600,초록마을로3길,439,355,84
2020,2,A,골목상권,1000599,월정로20길,135,31,104
2020,2,A,골목상권,1000598,우장산로6길,486,298,188
2020,2,A,골목상권,1000597,양천로73가길,468,360,108
2020,2,A,골목상권,1000596,양천로71길,1203,752,451
2020,2,A,골목상권,1000595,양천로49길,342,232,110
2020,2,A,골목상권,1000594,양천로26길,479,377,102
2020,2,A,골목상권,1000593,양천로24길,186,100,86
2020,2,A,골목상권,1000592,양천로24가길,207,113,94
2020,2,A,골목상권,1000591,양천로14길,257,143,114
2020,2,A,골목상권,1000590,방화대로6라길,653,413,240
2020,2,A,골목상권,1000589,방화대로21길,390,243,147
2020,2,A,골목상권,1000588,등촌로5길,1524,514,1010
2020,2,A,골목상권,1000587,등촌로55길,432,323,109
2020,2,A,골목상권,1000586,등촌로51길,239,137,102
2020,2,A,골목상권,1000585,등촌로39길,313,146,167
2020,2,A,골목상권,1000584,등촌로13길,183,128,55
2020,2,A,골목상권,1000583,남부순환로11길,307,201,106
2020,2,A,골목상권,1000582,까치산로4길,189,112,77
2020,2,A,골목상권,1000581,국회대로7길,215,101,114
2020,2,A,골목상권,1000580,공항대로8길,276,172,104
2020,2,A,골목상권,1000579,공항대로61길,547,415,132
2020,2,A,골목상권,1000578,공항대로59다길,1037,645,392
2020,2,A,골목상권,1000577,공항대로59길,654,454,200
2020,2,A,골목상권,1000576,공항대로55길,900,577,323
2020,2,A,골목상권,1000575,공항대로42길,514,323,191
2020,2,A,골목상권,1000574,공항대로38길,92,49,43
2020,2,A,골목상권,1000573,곰달래로60길,221,146,75
2020,2,A,골목상권,1000572,곰달래로53길,130,89,41
2020,2,A,골목상권,1000571,곰달래로47길,333,218,115
2020,2,A,골목상권,1000570,곰달래로31길,120,78,42
2020,2,A,골목상권,1000569,곰달래로25길,245,139,106
2020,2,A,골목상권,1000568,개화동로25길,351,201,150
2020,2,A,골목상권,1000567,개화동로23길,857,669,188
2020,2,A,골목상권,1000566,강서로8길,214,125,89
2020,2,A,골목상권,1000565,강서로5라길,245,176,69
2020,2,A,골목상권,1000564,강서로5나길,360,221,139
2020,2,A,골목상권,1000563,강서로5가길,182,98,84
2020,2,A,골목상권,1000562,강서로47라길,207,150,57
2020,2,A,골목상권,1000561,강서로47길,327,146,181
2020,2,A,골목상권,1000560,강서로45다길,243,178,65
2020,2,A,골목상권,1000559,강서로45길,101,43,58
2020,2,A,골목상권,1000558,강서로35길,280,120,160
2020,2,A,골목상권,1000557,강서로29길,384,230,154
2020,2,A,골목상권,1000556,강서로18길,676,545,131
2020,2,A,골목상권,1000555,강서로17가길,554,386,168
2020,2,A,골목상권,1000554,강서로15길,261,152,109
2020,2,A,골목상권,1000553,가로공원로80길,270,175,95
2020,2,A,골목상권,1000552,가로공원로76가길,168,91,77
2020,2,A,골목상권,1000551,화곡로4길,421,219,202
2020,2,A,골목상권,1000550,화곡로3길,351,177,174
2020,2,A,골목상권,1000549,지양로7길,245,105,140
2020,2,A,골목상권,1000548,중앙로55길,592,261,331
2020,2,A,골목상권,1000547,중앙로51길,283,178,105
2020,2,A,골목상권,1000546,중앙로47길,94,40,54
2020,2,A,골목상권,1000545,중앙로45길,1386,1342,44
2020,2,A,골목상권,1000544,중앙로36길,133,49,84
2020,2,A,골목상권,1000543,중앙로32길,145,87,58
2020,2,A,골목상권,1000542,중앙로25길,97,61,36
2020,2,A,골목상권,1000541,은행정로7길,472,183,289
2020,2,A,골목상권,1000540,은행정로5길,109,57,52
2020,2,A,골목상권,1000539,오목로5길,120,85,35
2020,2,A,골목상권,1000538,오목로3길,375,296,79
2020,2,A,골목상권,1000537,오목로30길,220,125,95
2020,2,A,골목상권,1000536,오목로23길,401,155,246
2020,2,A,골목상권,1000535,신월로20길,47,30,17
2020,2,A,골목상권,1000534,신월로15길,357,184,173
2020,2,A,골목상권,1000533,신목로6길,582,383,199
2020,2,A,골목상권,1000532,신목로5길,645,416,229
2020,2,A,골목상권,1000531,신목로2길,386,255,131
2020,2,A,골목상권,1000530,목동중앙서로8가길,317,200,117
2020,2,A,골목상권,1000529,목동중앙서로7길,75,52,23
2020,2,A,골목상권,1000528,목동중앙북로8길,171,102,69
2020,2,A,골목상권,1000527,목동중앙북로16길,488,190,298
2020,2,A,골목상권,1000526,목동중앙본로7길,131,70,61
2020,2,A,골목상권,1000525,목동중앙로3길,157,95,62
2020,2,A,골목상권,1000524,목동중앙로13나길,346,248,98
2020,2,A,골목상권,1000523,목동중앙남로3가길,190,108,82
2020,2,A,골목상권,1000522,목동로9길,768,479,289
2020,2,A,골목상권,1000521,목동로19길,351,190,161
2020,2,A,골목상권,1000520,목동동로8길,184,106,78
2020,2,A,골목상권,1000519,목동동로12길,335,228,107
2020,2,A,골목상권,1000518,목동남로4길,797,494,303
2020,2,A,골목상권,1000517,남부순환로88길,328,124,204
2020,2,A,골목상권,1000516,남부순환로79길,142,74,68
2020,2,A,골목상권,1000515,남부순환로70길,165,101,64
2020,2,A,골목상권,1000514,남부순환로58길,282,179,103
2020,2,A,골목상권,1000513,남부순환로40길,122,46,76
2020,2,A,골목상권,1000512,남부순환로33길,179,116,63
2020,2,A,골목상권,1000511,곰달래로5길,211,125,86
2020,2,A,골목상권,1000510,곰달래로3길,313,213,100
2020,2,A,골목상권,1000509,곰달래로2길,610,344,266
2020,2,A,골목상권,1000508,곰달래로10길,543,449,94
2020,2,A,골목상권,1000507,가로공원로58길,91,54,37
2020,2,A,골목상권,1000506,효창원로93길,243,99,144
2020,2,A,골목상권,1000505,토정로37길,431,166,265
2020,2,A,골목상권,1000504,월드컵로8길,939,462,477
2020,2,A,골목상권,1000503,월드컵로7길,759,308,451
2020,2,A,골목상권,1000502,월드컵로36길,461,286,175
2020,2,A,골목상권,1000501,월드컵로25길,309,125,184
2020,2,A,골목상권,1000500,월드컵로19길,284,181,103
2020,2,A,골목상권,1000499,월드컵로16길,1538,929,609
2020,2,A,골목상권,1000498,월드컵로11길,421,153,268
2020,2,A,골목상권,1000497,월드컵로10길,1102,654,448
2020,2,A,골목상권,1000496,와우산로3길,257,176,81
2020,2,A,골목상권,1000495,와우산로29길,78,30,48
2020,2,A,골목상권,1000494,와우산로29가길,989,653,336
2020,2,A,골목상권,1000493,양화진길,676,412,264
2020,2,A,골목상권,1000492,양화로1길,544,248,296
2020,2,A,골목상권,1000491,양화로11길,2761,1012,1749
2020,2,A,골목상권,1000490,신촌로30길,109,64,45
2020,2,A,골목상권,1000489,신촌로28가길,59,19,40
2020,2,A,골목상권,1000488,신촌로12길,197,95,102
2020,2,A,골목상권,1000487,숭문길,1467,1016,451
2020,2,A,골목상권,1000486,숭문8길,109,65,44
2020,2,A,골목상권,1000485,성지3길,338,228,110
2020,2,A,골목상권,1000484,성산로4길,855,546,309
2020,2,A,골목상권,1000483,성미산로32길,243,172,71
2020,2,A,골목상권,1000482,성미산로1길,554,299,255
2020,2,A,골목상권,1000481,성미산로11길,1114,807,307
2020,2,A,골목상권,1000480,백범로16길,1908,1298,610
2020,2,A,골목상권,1000479,방울내로9안길,619,351,268
2020,2,A,골목상권,1000478,모래내로7길,91,63,28
2020,2,A,골목상권,1000477,매봉산로2길,806,601,205
2020,2,A,골목상권,1000476,망원로2길,282,190,92
2020,2,A,골목상권,1000475,망원로11길,144,73,71
2020,2,A,골목상권,1000474,만리재옛길,1190,687,503
2020,2,A,골목상권,1000473,마포대로4길,674,365,309
2020,2,A,골목상권,1000472,마포대로20길,483,258,225
2020,2,A,골목상권,1000471,마포대로12길,78,39,39
2020,2,A,골목상권,1000470,동교로38길,464,247,217
2020,2,A,골목상권,1000469,동교로27길,1172,795,377
2020,2,A,골목상권,1000468,동교로25길,1378,581,797
2020,2,A,골목상권,1000467,동교로19길,1207,739,468
2020,2,A,골목상권,1000466,동교로17길,405,240,165
2020,2,A,골목상권,1000465,독막로8길,441,274,167
2020,2,A,골목상권,1000464,독막로32길,487,240,247
2020,2,A,골목상권,1000463,독막로22길,91,61,30
2020,2,A,골목상권,1000462,도화길,56,32,24
2020,2,A,골목상권,1000461,도화4길,825,292,533
2020,2,A,골목상권,1000460,대흥로28길,50,17,33
2020,2,A,골목상권,1000459,대흥로21길,372,188,184
2020,2,A,골목상권,1000458,광성로6길,295,169,126
2020,2,A,골목상권,1000457,홍제내길,565,201,364
2020,2,A,골목상권,1000456,홍연길,79,47,32
2020,2,A,골목상권,1000455,통일로39길,67,32,35
2020,2,A,골목상권,1000454,통일로37길,611,407,204
2020,2,A,골목상권,1000453,통일로11길,97,46,51
2020,2,A,골목상권,1000452,충정로6길,3185,1879,1306
2020,2,A,골목상권,1000451,충정로4길,2044,1298,746
2020,2,A,골목상권,1000450,증가로6길,326,277,49
2020,2,A,골목상권,1000449,증가로23나길,902,441,461
2020,2,A,골목상권,1000448,증가로20가길,336,99,237
2020,2,A,골목상권,1000447,증가로10길,1463,1123,340
2020,2,A,골목상권,1000446,응암로1길,621,380,241
2020,2,A,골목상권,1000445,연희로10길,3448,3135,313
2020,2,A,골목상권,1000444,신촌로37길,52,25,27
2020,2,A,골목상권,1000443,수색로8길,1090,905,185
2020,2,A,골목상권,1000442,세무서길,164,78,86
2020,2,A,골목상권,1000441,세무서2길,186,77,109
2020,2,A,골목상권,1000440,세검정로1길,109,37,72
2020,2,A,골목상권,1000439,북아현로4길,350,225,125
2020,2,A,골목상권,1000438,모래내로15길,74,54,20
2020,2,A,골목상권,1000437,명지대길,107,58,49
2020,2,A,골목상권,1000436,독립문로8길,679,422,257
2020,2,A,골목상권,1000435,가재울로6길,168,108,60
2020,2,A,골목상권,1000434,통일로92길,186,72,114
2020,2,A,골목상권,1000433,통일로87길,255,130,125
2020,2,A,골목상권,1000432,통일로78길,172,60,112
2020,2,A,골목상권,1000431,통일로69길,107,55,52
2020,2,A,골목상권,1000430,진흥로1길,310,165,145
2020,2,A,골목상권,1000429,진흥로12길,392,144,248
2020,2,A,골목상권,1000428,증산서길,334,189,145
2020,2,A,골목상권,1000427,증산로9길,606,525,81
2020,2,A,골목상권,1000426,증산로5길,508,308,200
2020,2,A,골목상권,1000425,증산로21길,237,122,115
2020,2,A,골목상권,1000424,증산로17길,161,110,51
2020,2,A,골목상권,1000423,증산로15길,398,297,101
2020,2,A,골목상권,1000422,증산로13길,79,42,37
2020,2,A,골목상권,1000421,응암로34길,231,118,113
2020,2,A,골목상권,1000420,응암로22길,130,53,77
2020,2,A,골목상권,1000419,응암로14길,99,50,49
2020,2,A,골목상권,1000418,응암로13길,156,44,112
2020,2,A,골목상권,1000417,응암로12길,67,32,35
2020,2,A,골목상권,1000416,은평로8길,275,194,81
2020,2,A,골목상권,1000415,은평로3길,242,110,132
2020,2,A,골목상권,1000414,은평로20길,9,2,7
2020,2,A,골목상권,1000413,은평로13길,655,283,372
2020,2,A,골목상권,1000412,은평로10길,246,148,98
2020,2,A,골목상권,1000411,연서로5길,647,303,344
2020,2,A,골목상권,1000410,연서로41길,64,33,31
2020,2,A,골목상권,1000409,연서로3길,119,51,68
2020,2,A,골목상권,1000408,연서로34길,1310,709,601
2020,2,A,골목상권,1000407,연서로33길,109,49,60
2020,2,A,골목상권,1000406,연서로29길,100,60,40
2020,2,A,골목상권,1000405,연서로28길,226,118,108
2020,2,A,골목상권,1000404,연서로27길,339,148,191
2020,2,A,골목상권,1000403,연서로21길,684,486,198
2020,2,A,골목상권,1000402,연서로17길,540,162,378
2020,2,A,골목상권,1000401,연서로16길,121,66,55
2020,2,A,골목상권,1000400,연서로13길,218,135,83
2020,2,A,골목상권,1000399,연서로11길,640,263,377
2020,2,A,골목상권,1000398,역말로9길,159,82,77
2020,2,A,골목상권,1000397,수색로18길,128,93,35
2020,2,A,골목상권,1000396,서오릉로8길,160,104,56
2020,2,A,골목상권,1000395,서오릉로21길,153,56,97
2020,2,A,골목상권,1000394,불광천길,192,95,97
2020,2,A,골목상권,1000393,갈현로7길,398,205,193
2020,2,A,골목상권,1000392,갈현로41길,171,78,93
2020,2,A,골목상권,1000391,갈현로33길,255,149,106
2020,2,A,골목상권,1000390,갈현로1길,66,36,30
2020,2,A,골목상권,1000389,가좌로7길,329,203,126
2020,2,A,골목상권,1000388,한글비석로44길,232,95,137
2020,2,A,골목상권,1000387,한글비석로24길,180,62,118
2020,2,A,골목상권,1000386,한글비석로22길,172,92,80
2020,2,A,골목상권,1000385,석계로1길,605,255,350
2020,2,A,골목상권,1000384,상계로9가길,151,82,69
2020,2,A,골목상권,1000383,상계로1길,334,244,90
2020,2,A,골목상권,1000382,상계로12길,144,90,54
2020,2,A,골목상권,1000381,동일로242길,302,142,160
2020,2,A,골목상권,1000380,동일로192길,429,326,103
2020,2,A,골목상권,1000379,동일로173가길,1230,946,284
2020,2,A,골목상권,1000378,공릉로58길,129,61,68
2020,2,A,골목상권,1000377,해등로16길,285,134,151
2020,2,A,골목상권,1000376,우이천로4다길,125,83,42
2020,2,A,골목상권,1000375,우이천로32길,206,83,123
2020,2,A,골목상권,1000374,시루봉로23길,267,128,139
2020,2,A,골목상권,1000373,삼양로144길,50,24,26
2020,2,A,골목상권,1000372,방학로6가길,167,67,100
2020,2,A,골목상권,1000371,방학로5길,124,87,37
2020,2,A,골목상권,1000370,방학로15길,687,454,233
2020,2,A,골목상권,1000369,방학로10길,67,51,16
2020,2,A,골목상권,1000368,도봉산길,135,64,71
2020,2,A,골목상권,1000367,도봉산4길,27,24,3
2020,2,A,골목상권,1000366,도봉로181길,93,30,63
2020,2,A,골목상권,1000365,도봉로169나길,244,184,60
2020,2,A,골목상권,1000364,도봉로156길,93,62,31
2020,2,A,골목상권,1000363,도봉로152가길,342,311,31
2020,2,A,골목상권,1000362,도봉로147길,161,81,80
2020,2,A,골목상권,1000361,도봉로143길,73,48,25
2020,2,A,골목상권,1000360,도봉로114길,380,143,237
2020,2,A,골목상권,1000359,도봉로109길,276,223,53
2020,2,A,골목상권,1000358,도당로29길,518,292,226
2020,2,A,골목상권,1000357,도당로19길,597,66,531
2020,2,A,골목상권,1000356,도당로13바길,74,35,39
2020,2,A,골목상권,1000355,도당로13가길,36,21,15
2020,2,A,골목상권,1000354,덕릉로60길,177,126,51
2020,2,A,골목상권,1000353,노해로63다길,43,19,24
2020,2,A,골목상권,1000352,노해로60길,136,85,51
2020,2,A,골목상권,1000351,한천로140길,36,25,11
2020,2,A,골목상권,1000350,한천로139가길,108,47,61
2020,2,A,골목상권,1000349,한천로132길,56,31,25
2020,2,A,골목상권,1000348,한천로130길,91,69,22
2020,2,A,골목상권,1000347,한천로124나길,54,23,31
2020,2,A,골목상권,1000346,한천로109길,439,280,159
2020,2,A,골목상권,1000345,인수봉로79길,242,153,89
2020,2,A,골목상권,1000344,인수봉로72길,54,18,36
2020,2,A,골목상권,1000343,인수봉로56길,44,25,19
2020,2,A,골목상권,1000342,오패산로67길,238,89,149
2020,2,A,골목상권,1000341,오패산로52길,105,47,58
2020,2,A,골목상권,1000340,오패산로30길,13,5,8
2020,2,A,골목상권,1000339,수유로12길,281,199,82
2020,2,A,골목상권,1000338,솔샘로65길,284,66,218
2020,2,A,골목상권,1000337,솔매로50길,442,162,280
2020,2,A,골목상권,1000336,솔매로45길,65,32,33
2020,2,A,골목상권,1000335,솔매로41길,67,38,29
2020,2,A,골목상권,1000334,삼양로93길,209,94,115
2020,2,A,골목상권,1000333,삼양로77길,131,58,73
2020,2,A,골목상권,1000332,삼양로54길,295,66,229
2020,2,A,골목상권,1000331,삼양로41길,338,275,63
2020,2,A,골목상권,1000330,삼양로27길,7,4,3
2020,2,A,골목상권,1000329,삼양로24길,26,16,10
2020,2,A,골목상권,1000328,삼양로20길,179,168,11
2020,2,A,골목상권,1000327,삼각산로28길,70,33,37
2020,2,A,골목상권,1000326,도봉로99길,250,155,95
2020,2,A,골목상권,1000325,도봉로8길,6,4,2
2020,2,A,골목상권,1000324,도봉로76길,311,138,173
2020,2,A,골목상권,1000323,도봉로67길,116,57,59
2020,2,A,골목상권,1000322,도봉로45길,112,54,58
2020,2,A,골목상권,1000321,도봉로18길,225,182,43
2020,2,A,골목상권,1000320,도봉로13길,13,8,5
2020,2,A,골목상권,1000319,덕릉로41길,185,105,80
2020,2,A,골목상권,1000318,덕릉로40길,187,95,92
2020,2,A,골목상권,1000317,노해로33길,84,30,54
2020,2,A,골목상권,1000316,노해로23길,70,47,23
2020,2,A,골목상권,1000315,노해로17길,103,56,47
2020,2,A,골목상권,1000314,화랑로40길,71,46,25
2020,2,A,골목상권,1000313,화랑로32길,395,292,103
2020,2,A,골목상권,1000312,화랑로1길,1112,811,301
2020,2,A,골목상권,1000311,화랑로19길,43,19,24
2020,2,A,골목상권,1000310,화랑로14길,99,73,26
2020,2,A,골목상권,1000309,화랑로13길,267,95,172
2020,2,A,골목상권,1000308,한천로76길,132,100,32
2020,2,A,골목상권,1000307,한천로101가길,15,9,6
2020,2,A,골목상권,1000306,창경궁로43길,917,434,483
2020,2,A,골목상권,1000305,지봉로20길,3780,3162,618
2020,2,A,골목상권,1000304,종암로5길,404,201,203
2020,2,A,골목상권,1000303,종암로24가길,81,18,63
2020,2,A,골목상권,1000302,종암로21길,550,344,206
2020,2,A,골목상권,1000301,종암로19길,18269,9427,8842
2020,2,A,골목상권,1000300,종암로16길,140,61,79
2020,2,A,골목상권,1000299,정릉로8길,1407,1165,242
2020,2,A,골목상권,1000298,정릉로27길,75,30,45
2020,2,A,골목상권,1000297,정릉로26길,214,103,111
2020,2,A,골목상권,1000296,장위로50길,343,160,183
2020,2,A,골목상권,1000295,장월로1길,74,19,55
2020,2,A,골목상권,1000294,인촌로6길,195,131,64
2020,2,A,골목상권,1000293,인촌로5길,63,31,32
2020,2,A,골목상권,1000292,인촌로24길,1580,1010,570
2020,2,A,골목상권,1000291,개운사길,150,83,67
2020,2,A,골목상권,1000290,인촌로1길,127,78,49
2020,2,A,골목상권,1000289,인촌로17가길,90,48,42
2020,2,A,골목상권,1000288,오패산로4길,841,540,301
2020,2,A,골목상권,1000287,오패산로3길,310,187,123
2020,2,A,골목상권,1000286,오패산로19길,101,36,65
2020,2,A,골목상권,1000285,안암로5길,960,743,217
2020,2,A,골목상권,1000284,아리랑로4길,595,281,314
2020,2,A,골목상권,1000283,솔샘로6길,74,48,26
2020,2,A,골목상권,1000282,성북로8길,143,88,55
2020,2,A,골목상권,1000281,삼양로8길,147,70,77
2020,2,A,골목상권,1000280,삼선교로16가길,99,42,57
2020,2,A,골목상권,1000279,삼선교로10다길,38,17,21
2020,2,A,골목상권,1000278,삼선교로10길,186,110,76
2020,2,A,골목상권,1000277,보문로32길,267,128,139
2020,2,A,골목상권,1000276,보문로31길,253,128,125
2020,2,A,골목상권,1000275,보문로26길,134,62,72
2020,2,A,골목상권,1000274,보문로13길,1048,741,307
2020,2,A,골목상권,1000273,보국문로16길,181,97,84
2020,2,A,골목상권,1000272,동소문로6길,62,28,34
2020,2,A,골목상권,1000271,동소문로2길,53,21,32
2020,2,A,골목상권,1000270,동소문로26가길,219,122,97
2020,2,A,골목상권,1000269,동소문로15길,209,152,57
2020,2,A,골목상권,1000268,동소문로13길,572,285,287
2020,2,A,골목상권,1000267,돌곶이로8길,117,75,42
2020,2,A,골목상권,1000266,돌곶이로41길,40,13,27
2020,2,A,골목상권,1000265,돌곶이로28길,222,96,126
2020,2,A,골목상권,1000264,돌곶이로27길,103,59,44
2020,2,A,골목상권,1000263,돌곶이로22길,61,34,27
2020,2,A,골목상권,1000262,돌곶이로14길,77,58,19
2020,2,A,골목상권,1000261,길음로7길,14,5,9
2020,2,A,골목상권,1000260,중랑천로10길,207,109,98
2020,2,A,골목상권,1000259,용마산로94길,304,259,45
2020,2,A,골목상권,1000258,용마산로118길,108,63,45
2020,2,A,골목상권,1000257,용마산로112길,114,69,45
2020,2,A,골목상권,1000256,용마산로100길,122,52,70
2020,2,A,골목상권,1000255,신내로7가길,276,115,161
2020,2,A,골목상권,1000254,사가정로54길,122,47,75
2020,2,A,골목상권,1000253,사가정로42길,183,89,94
2020,2,A,골목상권,1000252,봉화산로56길,649,289,360
2020,2,A,골목상권,1000251,봉화산로4길,58,30,28
2020,2,A,골목상권,1000250,봉화산로30길,139,38,101
2020,2,A,골목상권,1000249,봉우재로33길,150,59,91
2020,2,A,골목상권,1000248,면목로78길,93,44,49
2020,2,A,골목상권,1000247,면목로56길,91,53,38
2020,2,A,골목상권,1000246,면목로55길,473,306,167
2020,2,A,골목상권,1000245,면목로49길,109,67,42
2020,2,A,골목상권,1000244,면목로48길,873,544,329
2020,2,A,골목상권,1000243,면목로45길,454,364,90
2020,2,A,골목상권,1000242,면목로33길,86,28,58
2020,2,A,골목상권,1000241,면목로21길,54,37,17
2020,2,A,골목상권,1000240,망우로73길,51,34,17
2020,2,A,골목상권,1000239,망우로68길,107,44,63
2020,2,A,골목상권,1000238,동일로163길,112,67,45
2020,2,A,골목상권,1000237,동일로157길,443,270,173
2020,2,A,골목상권,1000236,동일로149길,870,749,121
2020,2,A,골목상권,1000235,동일로140길,432,314,118
2020,2,A,골목상권,1000234,동일로139길,77,53,24
2020,2,A,골목상권,1000233,동일로139가길,187,81,106
2020,2,A,골목상권,1000232,동일로130길,130,99,31
2020,2,A,골목상권,1000231,동일로123길,145,74,71
2020,2,A,골목상권,1000230,동일로112길,193,120,73
2020,2,A,골목상권,1000229,동일로101길,202,58,144
2020,2,A,골목상권,1000228,동일로100길,328,240,88
2020,2,A,골목상권,1000227,답십리로75길,57,33,24
2020,2,A,골목상권,1000226,공릉로2길,148,69,79
2020,2,A,골목상권,1000225,공릉로12가길,75,50,25
2020,2,A,골목상권,1000224,겸재로54길,131,79,52
2020,2,A,골목상권,1000223,겸재로36길,134,60,74
2020,2,A,골목상권,1000222,겸재로29길,126,74,52
2020,2,A,골목상권,1000221,휘경로3길,127,69,58
2020,2,A,골목상권,1000220,휘경로2길,138,88,50
2020,2,A,골목상권,1000219,휘경로23길,89,56,33
2020,2,A,골목상권,1000218,휘경로14길,113,41,72
2020,2,A,골목상권,1000217,한천로46길,257,101,156
2020,2,A,골목상권,1000216,한천로40길,90,57,33
2020,2,A,골목상권,1000215,한천로33길,203,76,127
2020,2,A,골목상권,1000214,한천로14길,696,440,256
2020,2,A,골목상권,1000213,천호대로97길,878,590,288
2020,2,A,골목상권,1000212,천호대로77길,169,111,58
2020,2,A,골목상권,1000211,천호대로45길,47,38,9
2020,2,A,골목상권,1000210,천호대로17길,2512,1893,619
2020,2,A,골목상권,1000209,천호대로12길,55,35,20
2020,2,A,골목상권,1000208,천장산로7길,74,32,42
2020,2,A,골목상권,1000207,제기로5길,45,39,6
2020,2,A,골목상권,1000206,제기로21길,101,62,39
2020,2,A,골목상권,1000205,전농로4길,274,210,64
2020,2,A,골목상권,1000204,전농로3길,170,120,50
2020,2,A,골목상권,1000203,전농로29길,461,336,125
2020,2,A,골목상권,1000202,장한로8길,438,295,143
2020,2,A,골목상권,1000201,장한로5길,314,189,125
2020,2,A,골목상권,1000200,장한로27길,167,119,48
2020,2,A,골목상권,1000199,장한로27가길,148,81,67
2020,2,A,골목상권,1000198,장한로26길,2436,1696,740
2020,2,A,골목상권,1000197,장한로26가길,122,87,35
2020,2,A,골목상권,1000196,장한로25길,408,210,198
2020,2,A,골목상권,1000195,장한로14길,179,98,81
2020,2,A,골목상권,1000194,이문로42길,48,29,19
2020,2,A,골목상권,1000193,왕산로43길,560,199,361
2020,2,A,골목상권,1000192,왕산로33길,72,30,42
2020,2,A,골목상권,1000191,왕산로32길,129,64,65
2020,2,A,골목상권,1000190,약령시로17길,109,77,32
2020,2,A,골목상권,1000189,서울시립대로4길,404,264,140
2020,2,A,골목상권,1000188,서울시립대로29길,368,263,105
2020,2,A,골목상권,1000187,서울시립대로16길,42,14,28
2020,2,A,골목상권,1000186,사가정로2길,268,177,91
2020,2,A,골목상권,1000185,사가정로23가길,84,46,38
2020,2,A,골목상권,1000184,사가정로13길,180,65,115
2020,2,A,골목상권,1000183,무학로45길,227,141,86
2020,2,A,골목상권,1000182,무학로16길,574,441,133
2020,2,A,골목상권,1000181,망우로21길,96,67,29
2020,2,A,골목상권,1000180,망우로18길,52,17,35
2020,2,A,골목상권,1000179,망우로18가길,114,75,39
2020,2,A,골목상권,1000178,답십리로72길,54,20,34
2020,2,A,골목상권,1000177,답십리로69길,533,270,263
2020,2,A,골목상권,1000176,답십리로68길,287,158,129
2020,2,A,골목상권,1000175,답십리로64길,103,73,30
2020,2,A,골목상권,1000174,답십리로63길,1747,1051,696
2020,2,A,골목상권,1000173,답십리로60길,341,213,128
2020,2,A,골목상권,1000172,답십리로56길,78,39,39
2020,2,A,골목상권,1000171,답십리로23길,47,22,25
2020,2,A,골목상권,1000170,난계로30길,4980,2233,2747
2020,2,A,골목상권,1000169,경희대로4길,41,18,23
2020,2,A,골목상권,1000168,경희대로3길,28,16,12
2020,2,A,골목상권,1000167,천호대로129길,344,207,137
2020,2,A,골목상권,1000166,천호대로123길,625,282,343
2020,2,A,골목상권,1000165,천호대로109길,915,504,411
2020,2,A,골목상권,1000164,자양번영로3길,587,462,125
2020,2,A,골목상권,1000163,자양로53길,170,120,50
2020,2,A,골목상권,1000162,자양로50길,218,121,97
2020,2,A,골목상권,1000161,자양로45길,448,184,264
2020,2,A,골목상권,1000160,자양로26길,141,91,50
2020,2,A,골목상권,1000159,자양로15길,106,45,61
2020,2,A,골목상권,1000158,자양로11길,646,250,396
2020,2,A,골목상권,1000157,용마산로3길,541,431,110
2020,2,A,골목상권,1000156,용마산로21길,396,253,143
2020,2,A,골목상권,1000155,아차산로78길,575,421,154
2020,2,A,골목상권,1000154,아차산로65길,357,214,143
2020,2,A,골목상권,1000153,아차산로55길,243,150,93
2020,2,A,골목상권,1000152,아차산로51길,432,110,322
2020,2,A,골목상권,1000151,아차산로40길,357,207,150
2020,2,A,골목상권,1000150,면목로17길,230,138,92
2020,2,A,골목상권,1000149,뚝섬로64길,239,127,112
2020,2,A,골목상권,1000148,뚝섬로58길,278,141,137
2020,2,A,골목상권,1000147,뚝섬로54길,948,798,150
2020,2,A,골목상권,1000146,뚝섬로48길,228,134,94
2020,2,A,골목상권,1000145,뚝섬로24길,111,66,45
2020,2,A,골목상권,1000144,뚝섬로23길,209,148,61
2020,2,A,골목상권,1000143,동일로24길,42,32,10
2020,2,A,골목상권,1000142,동일로18길,79,54,25
2020,2,A,골목상권,1000141,능동로4길,947,834,113
2020,2,A,골목상권,1000140,능동로3길,71,45,26
2020,2,A,골목상권,1000139,능동로34길,1018,676,342
2020,2,A,골목상권,1000138,능동로19길,133,77,56
2020,2,A,골목상권,1000137,능동로13길,221,109,112
2020,2,A,골목상권,1000136,긴고랑로9길,138,51,87
2020,2,A,골목상권,1000135,긴고랑로8길,947,573,374
2020,2,A,골목상권,1000134,긴고랑로7길,460,353,107
2020,2,A,골목상권,1000133,긴고랑로20길,174,98,76
2020,2,A,골목상권,1000132,광나루로52길,649,395,254
2020,2,A,골목상권,1000131,광나루로40길,242,128,114
2020,2,A,골목상권,1000130,광나루로37길,60,29,31
2020,2,A,골목상권,1000129,광나루로36길,412,169,243
2020,2,A,골목상권,1000128,광나루로24길,25,12,13
2020,2,A,골목상권,1000127,광나루로12길,60,19,41
2020,2,A,골목상권,1000126,한림말길,355,174,181
2020,2,A,골목상권,1000125,한림말3길,3329,1128,2201
2020,2,A,골목상권,1000124,청계천로10나길,4951,3728,1223
2020,2,A,골목상권,1000123,장터길,90,46,44
2020,2,A,골목상권,1000122,용답중앙길,93,66,27
2020,2,A,골목상권,1000121,용답29길,537,360,177
2020,2,A,골목상권,1000120,왕십리로6길,538,350,188
2020,2,A,골목상권,1000119,왕십리로31길,208,95,113
2020,2,A,골목상권,1000118,왕십리로26길,2076,1357,719
2020,2,A,골목상권,1000117,왕십리로21길,164,77,87
2020,2,A,골목상권,1000116,왕십리로14길,997,776,221
2020,2,A,골목상권,1000115,아차산로5길,1871,1041,830
2020,2,A,골목상권,1000114,아차산로15길,3361,2374,987
2020,2,A,골목상권,1000113,아차산로11길,3213,2213,1000
2020,2,A,골목상권,1000112,송정4가길,291,123,168
2020,2,A,골목상권,1000111,송정12라길,94,48,46
2020,2,A,골목상권,1000110,성수일로6길,1342,928,414
2020,2,A,골목상권,1000109,성수이로7길,1442,895,547
2020,2,A,골목상권,1000108,성수이로18길,2988,1968,1020
2020,2,A,골목상권,1000107,성덕정길,227,152,75
2020,2,A,골목상권,1000106,성덕정17길,393,244,149
2020,2,A,골목상권,1000105,서울숲2길,335,196,139
2020,2,A,골목상권,1000104,상원길,1919,1334,585
2020,2,A,골목상권,1000103,상원12길,398,238,160
2020,2,A,골목상권,1000102,사근동길,78,48,30
2020,2,A,골목상권,1000101,무학봉길,22,11,11
2020,2,A,골목상권,1000100,무학봉28길,143,69,74
2020,2,A,골목상권,1000099,무학로6길,1897,382,1515
2020,2,A,골목상권,1000098,무수막길,164,122,42
2020,2,A,골목상권,1000097,매봉길,60,30,30
2020,2,A,골목상권,1000096,마조로1길,30,14,16
2020,2,A,골목상권,1000095,마조로16길,155,93,62
2020,2,A,골목상권,1000094,마장로39길,443,258,185
2020,2,A,골목상권,1000093,마장로27길,197,92,105
2020,2,A,골목상권,1000092,뚝섬로5길,2136,1426,710
2020,2,A,골목상권,1000091,둘레9길,419,255,164
2020,2,A,골목상권,1000090,금호산길,159,83,76
2020,2,A,골목상권,1000089,금호산2길,22,12,10
2020,2,A,골목상권,1000088,고산자로6길,704,495,209
2020,2,A,골목상권,1000087,후암로28길,582,313,269
2020,2,A,골목상권,1000086,효창원로39길,163,87,76
2020,2,A,골목상권,1000085,회나무로13길,90,45,45
2020,2,A,골목상권,1000084,한남대로20길,231,131,100
2020,2,A,골목상권,1000083,한강대로88길,224,138,86
2020,2,A,골목상권,1000082,한강대로7길,722,462,260
2020,2,A,골목상권,1000081,한강대로62길,1047,535,512
2020,2,A,골목상권,1000080,한강대로52길,8713,2847,5866
2020,2,A,골목상권,1000079,한강대로43길,1841,1074,767
2020,2,A,골목상권,1000078,한강대로15길,774,417,357
2020,2,A,골목상권,1000077,한강대로104길,8152,1754,6398
2020,2,A,골목상권,1000076,청파로73길,248,128,120
2020,2,A,골목상권,1000075,청파로71길,1317,727,590
2020,2,A,골목상권,1000074,청파로47나길,259,176,83
2020,2,A,골목상권,1000073,청파로47길,192,87,105
2020,2,A,골목상권,1000072,장문로45길,242,106,136
2020,2,A,골목상권,1000071,이태원로54길,812,552,260
2020,2,A,골목상권,1000070,이태원로27길,567,430,137
2020,2,A,골목상권,1000069,이촌로22길,385,307,78
2020,2,A,골목상권,1000068,원효로89길,1387,969,418
2020,2,A,골목상권,1000067,원효로53길,341,222,119
2020,2,A,골목상권,1000066,원효로41길,243,153,90
2020,2,A,골목상권,1000065,원효로19길,609,435,174
2020,2,A,골목상권,1000064,우사단로4길,308,143,165
2020,2,A,골목상권,1000063,우사단로14길,1987,984,1003
2020,2,A,골목상권,1000062,우사단로10길,570,508,62
2020,2,A,골목상권,1000061,신흥로20길,178,118,60
2020,2,A,골목상권,1000060,소월로20길,151,76,75
2020,2,A,골목상권,1000059,서빙고로71길,432,265,167
2020,2,A,골목상권,1000058,백범로90길,535,288,247
2020,2,A,골목상권,1000057,백범로79길,899,560,339
2020,2,A,골목상권,1000056,두텁바위로1길,1111,483,628
2020,2,A,골목상권,1000055,대사관로34길,606,393,213
2020,2,A,골목상권,1000054,녹사평대로46길,43,19,24
2020,2,A,골목상권,1000053,녹사평대로40나길,46,21,25
2020,2,A,골목상권,1000052,녹사평대로32길,56,31,25
2020,2,A,골목상권,1000051,녹사평대로26길,494,230,264
2020,2,A,골목상권,1000050,녹사평대로11길,107,78,29
2020,2,A,골목상권,1000049,퇴계로90길,463,225,238
2020,2,A,골목상권,1000048,퇴계로8길,438,246,192
2020,2,A,골목상권,1000047,퇴계로56길,569,424,145
2020,2,A,골목상권,1000046,퇴계로46길,1098,613,485
2020,2,A,골목상권,1000045,퇴계로18길,967,435,532
2020,2,A,골목상권,1000044,퇴계로12길,180,103,77
2020,2,A,골목상권,1000043,청구로1길,108,72,36
2020,2,A,골목상권,1000042,청구로17길,485,306,179
2020,2,A,골목상권,1000041,장충단로8길,3778,1997,1781
2020,2,A,골목상권,1000040,삼일대로4길,1571,1113,458
2020,2,A,골목상권,1000039,명동길,7830,4550,3280
2020,2,A,골목상권,1000038,동호로8길,386,160,226
2020,2,A,골목상권,1000037,동호로20길,2429,1304,1125
2020,2,A,골목상권,1000036,동호로15길,1161,835,326
2020,2,A,골목상권,1000035,동호로11길,337,208,129
2020,2,A,골목상권,1000034,동호로10길,1553,857,696
2020,2,A,골목상권,1000033,다산로39길,39,19,20
2020,2,A,골목상권,1000032,다산로38길,674,311,363
2020,2,A,골목상권,1000031,다산로36길,91,55,36
2020,2,A,골목상권,1000030,다산로33길,320,201,119
2020,2,A,골목상권,1000029,난계로21길,128,93,35
2020,2,A,골목상권,1000028,난계로11길,255,170,85
2020,2,A,골목상권,1000027,필운대로1길,202,62,140
2020,2,A,골목상권,1000026,평창길,6654,2605,4049
2020,2,A,골목상권,1000025,통일로12길,13,6,7
2020,2,A,골목상권,1000024,창신길,146,29,117
2020,2,A,골목상권,1000023,창신5길,15,7,8
2020,2,A,골목상권,1000022,창신2길,56,26,30
2020,2,A,골목상권,1000021,창경궁로35길,787,171,616
2020,2,A,골목상권,1000020,지봉로8길,183,90,93
2020,2,A,골목상권,1000019,종로65길,275,157,118
2020,2,A,골목상권,1000018,종로58가길,137,71,66
2020,2,A,골목상권,1000017,종로24길,1011,716,295
2020,2,A,골목상권,1000016,자하문로7길,214,83,131
2020,2,A,골목상권,1000015,이화장길,497,221,276
2020,2,A,골목상권,1000014,율곡로16길,235,143,92
2020,2,A,골목상권,1000013,율곡로10길,313,206,107
2020,2,A,골목상권,1000012,옥인길,58,32,26
2020,2,A,골목상권,1000011,숭인동길,329,133,196
2020,2,A,골목상권,1000010,성균관로5길,148,84,64
2020,2,A,골목상권,1000009,삼청로5길,2703,2626,77
2020,2,A,골목상권,1000008,북촌로5나길,234,113,121
2020,2,A,골목상권,1000007,북촌로5길,503,419,84
2020,2,A,골목상권,1000006,북촌로11길,671,232,439
2020,2,A,골목상권,1000005,백석동길,1797,1066,731
2020,2,A,골목상권,1000004,명륜길,56,32,24
2020,2,A,골목상권,1000003,돈화문로11가길,3686,2700,986
2020,2,A,골목상권,1000002,난계로27길,201,114,87
2020,2,A,골목상권,1000001,계동길,842,388,454
2020,1,U,관광특구,1001496,강남 마이스 관광특구,15904,8904,7000
2020,1,U,관광특구,1001495,잠실 관광특구,24375,14199,10176
2020,1,U,관광특구,1001494,종로?청계 관광특구,32935,17150,15785
2020,1,U,관광특구,1001493,동대문패션타운 관광특구,6054,2958,3096
2020,1,U,관광특구,1001492,명동 남대문 북창동 다동 무교동 관광특구,104830,53674,51156
2020,1,U,관광특구,1001491,이태원 관광특구,5839,3064,2775
2020,1,R,전통시장,1001490,길동복조리시장,430,242,188
2020,1,R,전통시장,1001489,둔촌역전통시장,224,108,116
2020,1,R,전통시장,1001488,성내골목시장,30,18,12
2020,1,R,전통시장,1001487,천호시장,35,19,16
2020,1,R,전통시장,1001486,동서울시장,5,3,2
2020,1,R,전통시장,1001484,양지골목시장,60,36,24
2020,1,R,전통시장,1001483,암사종합시장,95,53,42
2020,1,R,전통시장,1001482,고덕전통시장,935,850,85
2020,1,R,전통시장,1001481,명일골목시장,89,30,59
2020,1,R,전통시장,1001480,새마을시장,208,122,86
2020,1,R,전통시장,1001479,석촌시장,286,99,187
2020,1,R,전통시장,1001478,방이시장,3469,1526,1943
2020,1,R,전통시장,1001477,마천시장,102,70,32
2020,1,R,전통시장,1001476,풍납시장,51,20,31
2020,1,R,전통시장,1001475,강남개포시장,138,84,54
2020,1,R,전통시장,1001474,도곡시장,57,25,32
2020,1,R,전통시장,1001473,청담삼익시장,48,30,18
2020,1,R,전통시장,1001472,논현종합시장,85,43,42
2020,1,R,전통시장,1001471,영동전통시장,242,95,147
2020,1,R,전통시장,1001470,강남시장_강남,58,33,25
2020,1,R,전통시장,1001469,양재시장,35,22,13
2020,1,R,전통시장,1001468,남부종합시장,85,63,22
2020,1,R,전통시장,1001467,우림시장,1,0,1
2020,1,R,전통시장,1001466,미성동도깨비시장,75,16,59
2020,1,R,전통시장,1001463,신림중앙시장,43,27,16
2020,1,R,전통시장,1001462,강남골목시장,168,124,44
2020,1,R,전통시장,1001461,신림종합시장,8,7,1
2020,1,R,전통시장,1001460,관악신사시장,120,63,57
2020,1,R,전통시장,1001459,신원시장,42,21,21
2020,1,R,전통시장,1001458,인헌시장,122,46,76
2020,1,R,전통시장,1001457,봉천중앙시장,154,42,112
2020,1,R,전통시장,1001455,봉일시장,44,23,21
2020,1,R,전통시장,1001454,봉천제일종합시장,6,1,5
2020,1,R,전통시장,1001453,낙성대시장,10,6,4
2020,1,R,전통시장,1001452,중부시장,102,40,62
2020,1,R,전통시장,1001451,사당시장,45,20,25
2020,1,R,전통시장,1001450,남성역골목시장,467,268,199
2020,1,R,전통시장,1001449,남성사계시장,136,59,77
2020,1,R,전통시장,1001448,흑석시장,78,31,47
2020,1,R,전통시장,1001447,상도4동도깨비골목시장,95,49,46
2020,1,R,전통시장,1001446,성대시장,141,55,86
2020,1,R,전통시장,1001445,영도시장,73,6,67
2020,1,R,전통시장,1001444,상도전통시장,239,104,135
2020,1,R,전통시장,1001442,신노량진시장,11,3,8
2020,1,R,전통시장,1001441,본동인정시장,59,41,18
2020,1,R,전통시장,1001440,노량진중앙시장,244,157,87
2020,1,R,전통시장,1001439,대림중앙시장,42,29,13
2020,1,R,전통시장,1001438,우리시장,6,5,1
2020,1,R,전통시장,1001436,사러가시장,57,35,22
2020,1,R,전통시장,1001435,대신시장,12,9,3
2020,1,R,전통시장,1001433,영일시장,155,115,40
2020,1,R,전통시장,1001432,도림시장,6,4,2
2020,1,R,전통시장,1001431,영등포청과시장,23,17,6
2020,1,R,전통시장,1001430,영등포전통시장,2127,1061,1066
2020,1,R,전통시장,1001429,은행나무시장,67,40,27
2020,1,R,전통시장,1001428,박미시장,39,26,13
2020,1,R,전통시장,1001427,현대시장,139,42,97
2020,1,R,전통시장,1001426,대명시장,28,11,17
2020,1,R,전통시장,1001425,푸른터시장,3,2,1
2020,1,R,전통시장,1001424,남문시장,76,47,29
2020,1,R,전통시장,1001423,독산동 우시장,611,476,135
2020,1,R,전통시장,1001422,오류시장,132,21,111
2020,1,R,전통시장,1001421,개봉중앙시장,10,7,3
2020,1,R,전통시장,1001420,고척근린시장,55,19,36
2020,1,R,전통시장,1001418,남구로시장,236,135,101
2020,1,R,전통시장,1001417,구로시장,10,5,5
2020,1,R,전통시장,1001415,방신전통시장,116,81,35
2020,1,R,전통시장,1001414,송화골목시장,119,44,75
2020,1,R,전통시장,1001413,까치산시장,114,35,79
2020,1,R,전통시장,1001412,화곡본동시장,36,16,20
2020,1,R,전통시장,1001411,남부골목시장,156,58,98
2020,1,R,전통시장,1001410,대원종합시장,9,7,2
2020,1,R,전통시장,1001409,화곡중앙골목시장,75,32,43
2020,1,R,전통시장,1001408,신월중앙시장,118,53,65
2020,1,R,전통시장,1001406,신정3동골목시장,123,81,42
2020,1,R,전통시장,1001405,신정2동골목시장,41,13,28
2020,1,R,전통시장,1001404,신정제일시장,38,21,17
2020,1,R,전통시장,1001403,신월7동골목시장,24,16,8
2020,1,R,전통시장,1001402,신월6동골목시장,141,103,38
2020,1,R,전통시장,1001400,신월3동골목시장,12,7,5
2020,1,R,전통시장,1001399,경창시장,53,23,30
2020,1,R,전통시장,1001398,월정로시장,61,42,19
2020,1,R,전통시장,1001397,신영시장,40,13,27
2020,1,R,전통시장,1001396,목4동시장,52,35,17
2020,1,R,전통시장,1001395,목3동시장,148,67,81
2020,1,R,전통시장,1001394,목2동시장,432,251,181
2020,1,R,전통시장,1001393,마포농수산물시장,77,40,37
2020,1,R,전통시장,1001392,동진시장,10,6,4
2020,1,R,전통시장,1001391,망원월드컵시장,190,123,67
2020,1,R,전통시장,1001390,망원시장,173,81,92
2020,1,R,전통시장,1001388,영진시장,29,14,15
2020,1,R,전통시장,1001387,서교시장,24,10,14
2020,1,R,전통시장,1001386,신수시장,34,19,15
2020,1,R,전통시장,1001385,아현시장,803,430,373
2020,1,R,전통시장,1001384,마포시장,11,3,8
2020,1,R,전통시장,1001383,공덕시장,3948,2001,1947
2020,1,R,전통시장,1001382,백련시장,5,3,2
2020,1,R,전통시장,1001381,모래내시장,14,9,5
2020,1,R,전통시장,1001380,포방터시장,35,23,12
2020,1,R,전통시장,1001379,인왕시장,44,7,37
2020,1,R,전통시장,1001378,아현가구거리상점가,45,22,23
2020,1,R,전통시장,1001377,영천시장,35,19,16
2020,1,R,전통시장,1001376,수일시장,7,2,5
2020,1,R,전통시장,1001375,증산종합시장,8,5,3
2020,1,R,전통시장,1001374,대림골목시장,237,46,191
2020,1,R,전통시장,1001373,신응암시장,17,10,7
2020,1,R,전통시장,1001372,녹번시장,22,9,13
2020,1,R,전통시장,1001371,대조시장,15,7,8
2020,1,R,전통시장,1001370,역촌중앙시장,9,3,6
2020,1,R,전통시장,1001369,갈현시장,287,186,101
2020,1,R,전통시장,1001368,연서시장,206,144,62
2020,1,R,전통시장,1001367,상계중앙시장,105,59,46
2020,1,R,전통시장,1001366,상계시장,8,2,6
2020,1,R,전통시장,1001365,공릉동도깨비시장,98,47,51
2020,1,R,전통시장,1001364,방학동도깨비시장,39,16,23
2020,1,R,전통시장,1001363,쌍문역골목시장,61,14,47
2020,1,R,전통시장,1001362,백운시장,33,14,19
2020,1,R,전통시장,1001361,신도봉시장,5,5,0
2020,1,R,전통시장,1001360,창동골목시장,84,47,37
2020,1,R,전통시장,1001359,창동신창시장,104,40,64
2020,1,R,전통시장,1001358,수유북부시장,20,14,6
2020,1,R,전통시장,1001357,장미원골목시장,911,571,340
2020,1,R,전통시장,1001356,수유중앙시장,13,8,5
2020,1,R,전통시장,1001355,강북종합시장,23,9,14
2020,1,R,전통시장,1001354,우이시장,69,61,8
2020,1,R,전통시장,1001353,수유전통시장,231,55,176
2020,1,R,전통시장,1001352,번동북부골목시장,50,25,25
2020,1,R,전통시장,1001351,솔샘시장,73,30,43
2020,1,R,전통시장,1001350,숭인시장,62,27,35
2020,1,R,전통시장,1001349,방천골목시장,92,55,37
2020,1,R,전통시장,1001348,동북시장,121,49,72
2020,1,R,전통시장,1001347,석관황금시장,191,157,34
2020,1,R,전통시장,1001345,새석관시장,3,1,2
2020,1,R,전통시장,1001343,장위전통시장,40,20,20
2020,1,R,전통시장,1001342,밤나무골시장,17,5,12
2020,1,R,전통시장,1001341,길음시장,91,19,72
2020,1,R,전통시장,1001340,정릉시장,131,72,59
2020,1,R,전통시장,1001339,정릉아리랑시장,22,7,15
2020,1,R,전통시장,1001338,돈암제일시장,97,22,75
2020,1,R,전통시장,1001337,유영시장,31,20,11
2020,1,R,전통시장,1001336,우림골목시장,344,118,226
2020,1,R,전통시장,1001335,묵1동도깨비시장,35,24,11
2020,1,R,전통시장,1001334,태능시장,81,34,47
2020,1,R,전통시장,1001333,중화제일시장,69,30,39
2020,1,R,전통시장,1001332,사가정시장,86,28,58
2020,1,R,전통시장,1001331,면목골목시장,45,21,24
2020,1,R,전통시장,1001330,동원시장,224,109,115
2020,1,R,전통시장,1001329,동부골목시장,179,59,120
2020,1,R,전통시장,1001327,이경시장,16,8,8
2020,1,R,전통시장,1001326,회기시장,55,17,38
2020,1,R,전통시장,1001325,청량리청과물시장,12,9,3
2020,1,R,전통시장,1001324,전곡시장,77,42,35
2020,1,R,전통시장,1001323,답십리시장,93,40,53
2020,1,R,전통시장,1001322,동부시장,14,9,5
2020,1,R,전통시장,1001321,답십리현대시장,36,31,5
2020,1,R,전통시장,1001320,전농로터리시장,7,3,4
2020,1,R,전통시장,1001319,청량리종합시장,13,8,5
2020,1,R,전통시장,1001318,청량리전통시장,9,7,2
2020,1,R,전통시장,1001316,서울약령시장,1171,642,529
2020,1,R,전통시장,1001315,동서시장,5,3,2
2020,1,R,전통시장,1001314,경동시장,130,61,69
2020,1,R,전통시장,1001313,청량리수산시장,20,11,9
2020,1,R,전통시장,1001312,용두시장,4,2,2
2020,1,R,전통시장,1001309,조양시장,31,19,12
2020,1,R,전통시장,1001308,영동교골목시장,41,30,11
2020,1,R,전통시장,1001307,능동로골목시장,56,42,14
2020,1,R,전통시장,1001306,노룬산골목시장,23,13,10
2020,1,R,전통시장,1001305,자양종합시장,14,10,4
2020,1,R,전통시장,1001304,자양골목시장,54,36,18
2020,1,R,전통시장,1001303,신성골목시장,19,6,13
2020,1,R,전통시장,1001302,면곡골목시장,49,35,14
2020,1,R,전통시장,1001301,중곡제일시장,111,68,43
2020,1,R,전통시장,1001300,화양제일골목시장,43,11,32
2020,1,R,전통시장,1001299,한아름시장,40,29,11
2020,1,R,전통시장,1001298,성동용답상가시장,66,33,33
2020,1,R,전통시장,1001297,뚝도시장,45,17,28
2020,1,R,전통시장,1001296,금남시장,36,13,23
2020,1,R,전통시장,1001295,행당시장,314,140,174
2020,1,R,전통시장,1001294,마장축산물시장,532,358,174
2020,1,R,전통시장,1001293,보광시장,31,12,19
2020,1,R,전통시장,1001292,이태원제일시장,2,1,1
2020,1,R,전통시장,1001291,이태원시장,32,20,12
2020,1,R,전통시장,1001290,이촌종합시장,109,78,31
2020,1,R,전통시장,1001289,용문전통시장,19,10,9
2020,1,R,전통시장,1001288,만리시장,12,9,3
2020,1,R,전통시장,1001287,신흥시장,4,1,3
2020,1,R,전통시장,1001286,후암시장,15,14,1
2020,1,R,전통시장,1001285,합동(새벽)시장,365,209,156
2020,1,R,전통시장,1001284,서울중앙시장,451,320,131
2020,1,R,전통시장,1001283,백학시장,95,43,52
2020,1,R,전통시장,1001282,약수시장,271,105,166
2020,1,R,전통시장,1001281,청평화시장,120,50,70
2020,1,R,전통시장,1001280,제일평화시장,53,29,24
2020,1,R,전통시장,1001279,동평화시장,178,121,57
2020,1,R,전통시장,1001278,남평화시장,5,3,2
2020,1,R,전통시장,1001277,방산종합시장,1190,736,454
2020,1,R,전통시장,1001276,평화시장,906,614,292
2020,1,R,전통시장,1001275,인현시장,167,123,44
2020,1,R,전통시장,1001274,신중부시장,3089,921,2168
2020,1,R,전통시장,1001273,남대문시장,8186,3966,4220
2020,1,R,전통시장,1001272,신설종합시장,50,37,13
2020,1,R,전통시장,1001271,동묘시장,474,223,251
2020,1,R,전통시장,1001270,창신골목시장,13,7,6
2020,1,R,전통시장,1001269,동문시장,3,1,2
2020,1,R,전통시장,1001268,충신시장,77,40,37
2020,1,R,전통시장,1001267,종로신진시장,158,89,69
2020,1,R,전통시장,1001266,동대문종합시장,1319,965,354
2020,1,R,전통시장,1001265,광장시장,444,301,143
2020,1,R,전통시장,1001264,통인시장,59,29,30
2020,1,D,발달상권,1001263,서울 노원구 노원역_3,418,159,259
2020,1,D,발달상권,1001262,서울 노원구 노원역_2,274,126,148
2020,1,D,발달상권,1001261,서울 노원구 노원역_1,336,86,250
2020,1,D,발달상권,1001260,창동역,1003,570,433
2020,1,D,발달상권,1001259,서울 강북구 수유역_3,70,36,34
2020,1,D,발달상권,1001258,등나무근린공원 주변,65,19,46
2020,1,D,발달상권,1001257,서울 강북구 수유역_2,2284,1108,1176
2020,1,D,발달상권,1001256,서울 강북구 수유역_1,831,408,423
2020,1,D,발달상권,1001255,서울 은평구 연신내역_3,108,20,88
2020,1,D,발달상권,1001254,서울 은평구 연신내역_2,555,168,387
2020,1,D,발달상권,1001253,서울 은평구 연신내역_1,70,25,45
2020,1,D,발달상권,1001252,서울 성북구 미아삼거리역_2,322,144,178
2020,1,D,발달상권,1001251,서울 강북구 미아삼거리역_1,140,86,54
2020,1,D,발달상권,1001250,서울 은평구 불광역_3,67,24,43
2020,1,D,발달상권,1001249,서울 은평구 불광역_2,116,39,77
2020,1,D,발달상권,1001248,서울 은평구 불광역_1,180,73,107
2020,1,D,발달상권,1001247,미아사거리_2,102,47,55
2020,1,D,발달상권,1001246,미아사거리_1,210,68,142
2020,1,D,발달상권,1001245,서울 성북구 성신여대입구역,2865,1629,1236
2020,1,D,발달상권,1001244,경희대학교,70,24,46
2020,1,D,발달상권,1001243,서울 성북구 안암역,59,28,31
2020,1,D,발달상권,1001242,혜화역 대학로_3,477,210,267
2020,1,D,발달상권,1001241,혜화역 대학로_2,334,256,78
2020,1,D,발달상권,1001240,혜화역 대학로_1,1230,573,657
2020,1,D,발달상권,1001239,디지털미디어시티,6727,3880,2847
2020,1,D,발달상권,1001238,서울 동대문구 청량리역,776,413,363
2020,1,D,발달상권,1001237,서울 종로구 경복궁역_2,239,107,132
2020,1,D,발달상권,1001236,서울 종로구 안국역_2,810,409,401
2020,1,D,발달상권,1001235,서울 종로구 안국역_1,8804,7324,1480
2020,1,D,발달상권,1001234,서울 종로구 경복궁역_1,599,413,186
2020,1,D,발달상권,1001233,서울 종로구 종로3가역_3,2136,1442,694
2020,1,D,발달상권,1001232,서울 종로구 종로3가역_2,1823,948,875
2020,1,D,발달상권,1001231,서울 동대문구 신설동역_2,5440,2247,3193
2020,1,D,발달상권,1001230,인사동,26072,14829,11243
2020,1,D,발달상권,1001229,서울 종로구 종로5가역_4,1358,810,548
2020,1,D,발달상권,1001228,서울 종로구 종로5가역_3,1766,1160,606
2020,1,D,발달상권,1001227,종로구청,20709,10947,9762
2020,1,D,발달상권,1001226,서울 종로구 종로5가역_2,16173,10184,5989
2020,1,D,발달상권,1001225,신설동역,118,54,64
2020,1,D,발달상권,1001224,서울 동대문구 신설동역_1,1543,677,866
2020,1,D,발달상권,1001223,서울 종로구 광화문역_2,27999,17199,10800
2020,1,D,발달상권,1001222,동묘앞역,223,138,85
2020,1,D,발달상권,1001221,장안동사거리,1587,632,955
2020,1,D,발달상권,1001220,서울 종로구 동대문역_2,748,244,504
2020,1,D,발달상권,1001219,서울 종로구 동대문역_1,28,17,11
2020,1,D,발달상권,1001218,동대문시장_2,195,123,72
2020,1,D,발달상권,1001217,서울 종로구 종로5가역_1,22,9,13
2020,1,D,발달상권,1001216,서울 종로구 종로3가역_1,2657,1167,1490
2020,1,D,발달상권,1001215,서울 종로구 광화문역_1,12759,8498,4261
2020,1,D,발달상권,1001214,종각역,10396,8086,2310
2020,1,D,발달상권,1001213,종각역 젊음의 거리,13040,3576,9464
2020,1,D,발달상권,1001212,서대문구 서대문역_1,99,67,32
2020,1,D,발달상권,1001211,동대문시장_1,1663,493,1170
2020,1,D,발달상권,1001210,시청역_2,14646,9603,5043
2020,1,D,발달상권,1001209,서울시청,9257,4890,4367
2020,1,D,발달상권,1001208,서울 중구 을지로3가역_2,3181,2166,1015
2020,1,D,발달상권,1001207,서울 중구 신당역_2,939,534,405
2020,1,D,발달상권,1001206,서대문구 서대문역_2,1486,1018,468
2020,1,D,발달상권,1001205,동대문역사문화공원역,3166,2548,618
2020,1,D,발달상권,1001204,서울 중구 을지로3가역_1,4549,2258,2291
2020,1,D,발달상권,1001203,명동거리,8147,4244,3903
2020,1,D,발달상권,1001202,롯데백화점,27149,9657,17492
2020,1,D,발달상권,1001201,서울 중구 신당역_1,277,142,135
2020,1,D,발달상권,1001200,북창동,5197,3160,2037
2020,1,D,발달상권,1001199,서울 중구 충무로역_2,16329,7851,8478
2020,1,D,발달상권,1001198,서울 강서구 송정역,335,140,195
2020,1,D,발달상권,1001197,장한평역_2,1492,995,497
2020,1,D,발달상권,1001196,시청역_1,24904,15705,9199
2020,1,D,발달상권,1001195,왕십리역_2,233,102,131
2020,1,D,발달상권,1001194,서울 강서구 발산역,983,431,552
2020,1,D,발달상권,1001193,장한평역_1,1129,748,381
2020,1,D,발달상권,1001192,서울 중구 충무로역_1,3743,2160,1583
2020,1,D,발달상권,1001191,왕십리역_1,8,2,6
2020,1,D,발달상권,1001190,장한평역,3644,2178,1466
2020,1,D,발달상권,1001189,서울 중구 명동역,3595,1952,1643
2020,1,D,발달상권,1001188,장충동 족발거리,2100,985,1115
2020,1,D,발달상권,1001187,한양시장,55,30,25
2020,1,D,발달상권,1001186,서울 서대문구 이대역,380,160,220
2020,1,D,발달상권,1001185,서울 서대문구 신촌역,924,404,520
2020,1,D,발달상권,1001184,서울 마포구 홍대입구역_3,659,386,273
2020,1,D,발달상권,1001183,서울 마포구 홍대입구역_2,977,535,442
2020,1,D,발달상권,1001182,홍익대학교 주변,8725,5062,3663
2020,1,D,발달상권,1001181,서울 광진구 군자역,621,342,279
2020,1,D,발달상권,1001180,신촌역,4403,2012,2391
2020,1,D,발달상권,1001179,강서구청,4278,2468,1810
2020,1,D,발달상권,1001178,서울 마포구 홍대입구역_1,1618,826,792
2020,1,D,발달상권,1001177,서울 중구 약수역_2,210,91,119
2020,1,D,발달상권,1001176,서울 중구 약수역_1,24,6,18
2020,1,D,발달상권,1001175,서울 강동구 고덕역,1359,916,443
2020,1,D,발달상권,1001174,등촌역,64,37,27
2020,1,D,발달상권,1001173,서울 강동구 명일역,671,252,419
2020,1,D,발달상권,1001172,어린이대공원역,41,17,24
2020,1,D,발달상권,1001171,서울 마포구 공덕역_2,3697,2404,1293
2020,1,D,발달상권,1001170,공덕역,2092,1198,894
2020,1,D,발달상권,1001169,서울 용산구 숙대입구역,3807,1436,2371
2020,1,D,발달상권,1001168,남영역,4055,2796,1259
2020,1,D,발달상권,1001167,서울 마포구 공덕역_1,2420,796,1624
2020,1,D,발달상권,1001166,서울 마포구 마포역_2,10151,6130,4021
2020,1,D,발달상권,1001165,서울 광진구 건대입구역_2,529,268,261
2020,1,D,발달상권,1001164,서울 마포구 마포역_1,3369,2292,1077
2020,1,D,발달상권,1001163,서울 강동구 천호역_2,1208,565,643
2020,1,D,발달상권,1001162,서울 광진구 건대입구역_1,109,52,57
2020,1,D,발달상권,1001161,건대입구역,24,11,13
2020,1,D,발달상권,1001160,서울 광진구 구의역,928,584,344
2020,1,D,발달상권,1001159,서울 강동구 천호역,259,93,166
2020,1,D,발달상권,1001158,당산역_2,1429,1069,360
2020,1,D,발달상권,1001157,서울 강동구 천호역_1,138,57,81
2020,1,D,발달상권,1001156,서울 강동구 길동역,2628,1190,1438
2020,1,D,발달상권,1001155,용산 전자상가_5,1976,1461,515
2020,1,D,발달상권,1001154,용산 전자상가_4,248,182,66
2020,1,D,발달상권,1001153,당산역_1,310,186,124
2020,1,D,발달상권,1001152,서울 광진구 강변역,1337,859,478
2020,1,D,발달상권,1001151,용산 전자상가_3,1752,1311,441
2020,1,D,발달상권,1001150,서울 용산구 이태원역,452,292,160
2020,1,D,발달상권,1001149,한남오거리,823,524,299
2020,1,D,발달상권,1001148,목동사거리,41,13,28
2020,1,D,발달상권,1001147,용산 전자상가_2,392,317,75
2020,1,D,발달상권,1001146,용산구청,1526,755,771
2020,1,D,발달상권,1001145,용산 전자상가_1,3893,2851,1042
2020,1,D,발달상권,1001144,국회의사당역_2,19439,11619,7820
2020,1,D,발달상권,1001143,서울 용산구 신용산역,979,675,304
2020,1,D,발달상권,1001142,국회의사당역_1,4563,3517,1046
2020,1,D,발달상권,1001141,압구정 로데오거리_2,7107,2323,4784
2020,1,D,발달상권,1001140,서울 강남구 압구정역,9345,4345,5000
2020,1,D,발달상권,1001139,서울 영등포구 영등포구청역,449,275,174
2020,1,D,발달상권,1001138,압구정 로데오거리_1,14564,7168,7396
2020,1,D,발달상권,1001137,서울 강동구 둔촌동역,250,102,148
2020,1,D,발달상권,1001136,오목교역,125,72,53
2020,1,D,발달상권,1001135,신사동 가로수길,14671,7582,7089
2020,1,D,발달상권,1001134,서울 영등포구 여의도역_2,33585,23274,10311
2020,1,D,발달상권,1001133,청담사거리_3,1376,693,683
2020,1,D,발달상권,1001132,영등포유통상가,1504,962,542
2020,1,D,발달상권,1001131,청담역_2,4142,3212,930
2020,1,D,발달상권,1001130,청담역_1,4062,2913,1149
2020,1,D,발달상권,1001129,청담사거리_2,1289,759,530
2020,1,D,발달상권,1001128,청담사거리_1,529,295,234
2020,1,D,발달상권,1001127,서울 영등포구 여의도역_1,27015,17171,9844
2020,1,D,발달상권,1001126,서울 양천구 신정네거리역_2,28,18,10
2020,1,D,발달상권,1001125,학동사거리_2,2498,1332,1166
2020,1,D,발달상권,1001124,서울 영등포구 영등포시장역,411,246,165
2020,1,D,발달상권,1001123,학동사거리_1,4075,2555,1520
2020,1,D,발달상권,1001122,여의도 시범아파트앞,10435,6976,3459
2020,1,D,발달상권,1001121,영등포역_3,121,70,51
2020,1,D,발달상권,1001120,도산공원사거리_1,4075,1954,2121
2020,1,D,발달상권,1001119,영등포역_2,583,245,338
2020,1,D,발달상권,1001118,문래동 주민센터,6184,3312,2872
2020,1,D,발달상권,1001117,강남구 신사역_2,6953,3586,3367
2020,1,D,발달상권,1001116,영등포역_1,77,27,50
2020,1,D,발달상권,1001115,서울 강남구 강남구청역_2,3172,1916,1256
2020,1,D,발달상권,1001114,강남구 신사역_1,1108,570,538
2020,1,D,발달상권,1001113,서울 동작구 노량진1동_1,40,25,15
2020,1,D,발달상권,1001112,서울 강남구 학동역_3,3152,1780,1372
2020,1,D,발달상권,1001111,서울 강남구 강남구청역_1,3516,2335,1181
2020,1,D,발달상권,1001110,잠실역,42527,22605,19922
2020,1,D,발달상권,1001109,강남구 논현역_4,4927,2720,2207
2020,1,D,발달상권,1001108,학동역,1014,616,398
2020,1,D,발달상권,1001107,방이동 먹자골목,6881,4444,2437
2020,1,D,발달상권,1001106,서울 강남구 학동역_2,2510,1674,836
2020,1,D,발달상권,1001105,서울 동작구 노량진역,436,252,184
2020,1,D,발달상권,1001104,삼성역_3,52277,41226,11051
2020,1,D,발달상권,1001103,코엑스,15904,8904,7000
2020,1,D,발달상권,1001102,서울 강남구 학동역_1,1691,1037,654
2020,1,D,발달상권,1001101,선정릉역_2,3758,2684,1074
2020,1,D,발달상권,1001100,강남구 논현역_3,2466,700,1766
2020,1,D,발달상권,1001099,포스코사거리_2,16526,9641,6885
2020,1,D,발달상권,1001098,포스코사거리_1,22702,15610,7092
2020,1,D,발달상권,1001097,잠실역 롯데월드,2247,1185,1062
2020,1,D,발달상권,1001096,신도림역,1674,907,767
2020,1,D,발달상권,1001095,강남구 논현역_2,9009,5256,3753
2020,1,D,발달상권,1001094,선정릉역_1,2392,1492,900
2020,1,D,발달상권,1001093,신천역,4789,2992,1797
2020,1,D,발달상권,1001092,강남구 논현역_1,2284,1208,1076
2020,1,D,발달상권,1001091,삼성역_2,7062,3420,3642
2020,1,D,발달상권,1001090,삼정역_2,1162,721,441
2020,1,D,발달상권,1001089,삼정역_1,2277,1123,1154
2020,1,D,발달상권,1001088,삼성역_1,18695,12565,6130
2020,1,D,발달상권,1001087,서울 강남구 선릉역_2,40183,20392,19791
2020,1,D,발달상권,1001086,고속터미널역,2010,1612,398
2020,1,D,발달상권,1001085,서울 서초구 강남역,19954,10752,9202
2020,1,D,발달상권,1001084,서울 강남구 선릉역_1,21572,9107,12465
2020,1,D,발달상권,1001083,서울 송파구 석촌역_2,597,380,217
2020,1,D,발달상권,1001082,선릉역_2,26260,16412,9848
2020,1,D,발달상권,1001081,서울 강남구 역삼역_2,19179,15530,3649
2020,1,D,발달상권,1001080,서울 송파구 석촌역_1,168,96,72
2020,1,D,발달상권,1001079,석촌역,170,135,35
2020,1,D,발달상권,1001078,서울 강남구 강남역_2,9449,4629,4820
2020,1,D,발달상권,1001077,선릉역_1,16454,10830,5624
2020,1,D,발달상권,1001076,구로역,201,101,100
2020,1,D,발달상권,1001075,역삼역_2,10137,4381,5756
2020,1,D,발달상권,1001074,대림역_2,5179,3395,1784
2020,1,D,발달상권,1001073,서울 강남구 역삼역_1,22546,15049,7497
2020,1,D,발달상권,1001072,신대방삼거리역,259,129,130
2020,1,D,발달상권,1001071,서울 강남구 한티역,673,371,302
2020,1,D,발달상권,1001070,은마아파트입구사거리_4,570,252,318
2020,1,D,발달상권,1001069,은마아파트입구사거리_3,103,45,58
2020,1,D,발달상권,1001068,은마아파트입구사거리_2,15650,5160,10490
2020,1,D,발달상권,1001067,오류동역,2297,1736,561
2020,1,D,발달상권,1001066,서울 강남구 강남역,27566,14310,13256
2020,1,D,발달상권,1001065,은마아파트입구사거리_1,277,92,185
2020,1,D,발달상권,1001064,대림역_1,340,205,135
2020,1,D,발달상권,1001063,교대역_4,6267,3940,2327
2020,1,D,발달상권,1001062,서울 강남구 강남역_1,25938,14288,11650
2020,1,D,발달상권,1001061,방배동카페골목,374,218,156
2020,1,D,발달상권,1001059,교대역_3,1005,649,356
2020,1,D,발달상권,1001058,역삼역_1,10667,5507,5160
2020,1,D,발달상권,1001057,교대역_2,3971,2510,1461
2020,1,D,발달상권,1001056,서울 송파구 가락시장역,5421,3249,2172
2020,1,D,발달상권,1001055,서울 서초구 서초역,1858,988,870
2020,1,D,발달상권,1001054,서울 강남구 대치역_2,1139,629,510
2020,1,D,발달상권,1001053,서울 강남구 대치역_1,102,38,64
2020,1,D,발달상권,1001052,뱅뱅사거리_2,12301,8384,3917
2020,1,D,발달상권,1001051,보라매공원,2417,1455,962
2020,1,D,발달상권,1001050,교대역_1,17722,8352,9370
2020,1,D,발달상권,1001049,개봉동 현대아파트 인근,271,126,145
2020,1,D,발달상권,1001048,뱅뱅사거리,7114,4891,2223
2020,1,D,발달상권,1001047,뱅뱅사거리_1,4820,3658,1162
2020,1,D,발달상권,1001046,서울 관악구 신림역_4,332,165,167
2020,1,D,발달상권,1001045,동작구 총신대입구역_1,327,125,202
2020,1,D,발달상권,1001044,양재역_3,9025,5664,3361
2020,1,D,발달상권,1001043,동작구 총신대입구역_2,1633,741,892
2020,1,D,발달상권,1001042,서울 서초구 남부터미널역_3,3060,1217,1843
2020,1,D,발달상권,1001041,서울 강남구 수서역,12418,6339,6079
2020,1,D,발달상권,1001040,서울 관악구 신림역_3,77,20,57
2020,1,D,발달상권,1001039,서울 서초구 남부터미널역_2,3012,1965,1047
2020,1,D,발달상권,1001038,구로디지탈1단지,43655,28446,15209
2020,1,D,발달상권,1001037,양재역,904,474,430
2020,1,D,발달상권,1001036,문정역,88,52,36
2020,1,D,발달상권,1001035,매봉역,5760,4107,1653
2020,1,D,발달상권,1001034,서울 서초구 방배역,1690,910,780
2020,1,D,발달상권,1001033,서울 서초구 남부터미널역_1,2033,1323,710
2020,1,D,발달상권,1001032,서울 관악구 신림역_2,166,63,103
2020,1,D,발달상권,1001031,서울 관악구 신림역_1,615,316,299
2020,1,D,발달상권,1001030,양재역_2,2634,1725,909
2020,1,D,발달상권,1001029,양재역_1,515,305,210
2020,1,D,발달상권,1001028,서울 관악구 서울대입구역_2,57,28,29
2020,1,D,발달상권,1001027,가산디지털단지역_3,22935,14390,8545
2020,1,D,발달상권,1001026,구로디지털단지역,91,67,24
2020,1,D,발달상권,1001025,서울 관악구 서울대입구역_1,1502,797,705
2020,1,D,발달상권,1001024,관악구 사당역_1,5523,2253,3270
2020,1,D,발달상권,1001023,가산디지털단지역_2,25194,16241,8953
2020,1,D,발달상권,1001022,관악구 사당역_2,744,453,291
2020,1,D,발달상권,1001021,가산디지털단지역_1,18317,12138,6179
2020,1,D,발달상권,1001020,장지역,4411,3129,1282
2020,1,D,발달상권,1001019,포이사거리_1,192,141,51
2020,1,D,발달상권,1001018,포이사거리_2,7673,5359,2314
2020,1,D,발달상권,1001017,관악구 사당역_3,1538,1135,403
2020,1,D,발달상권,1001016,서울 관악구 대학동_1,662,558,104
2020,1,D,발달상권,1001015,서울 금천구 독산1동_1,716,485,231
2020,1,D,발달상권,1001014,양재동 꽃시장,1540,858,682
2020,1,D,발달상권,1001013,양재 화물트럭터미널앞_2,843,619,224
2020,1,D,발달상권,1001012,양재 화물트럭터미널앞_1,1944,1643,301
2020,1,D,발달상권,1001011,서울 금천구 시흥1동_4,486,164,322
2020,1,A,골목상권,1001010,풍성로37가길,128,57,71
2020,1,A,골목상권,1001009,천호옛길,420,288,132
2020,1,A,골목상권,1001008,천호옛14길,177,93,84
2020,1,A,골목상권,1001007,천호대로219길,486,338,148
2020,1,A,골목상권,1001006,천호대로197길,239,168,71
2020,1,A,골목상권,1001005,천호대로187길,371,200,171
2020,1,A,골목상권,1001004,천호대로170길,303,177,126
2020,1,A,골목상권,1001003,천호대로162길,286,149,137
2020,1,A,골목상권,1001002,천중로51길,761,536,225
2020,1,A,골목상권,1001001,천중로39길,574,375,199
2020,1,A,골목상권,1001000,진황도로47길,131,63,68
2020,1,A,골목상권,1000999,진황도로27길,298,174,124
2020,1,A,골목상권,1000998,올림픽로98길,257,169,88
2020,1,A,골목상권,1000997,올림픽로80길,152,54,98
2020,1,A,골목상권,1000996,올림픽로78길,115,58,57
2020,1,A,골목상권,1000995,올림픽로77길,210,114,96
2020,1,A,골목상권,1000994,올림픽로71길,184,101,83
2020,1,A,골목상권,1000993,올림픽로48길,1847,1272,575
2020,1,A,골목상권,1000992,양재대로96길,197,131,66
2020,1,A,골목상권,1000991,양재대로95길,602,324,278
2020,1,A,골목상권,1000990,양재대로91길,358,230,128
2020,1,A,골목상권,1000989,양재대로133길,189,122,67
2020,1,A,골목상권,1000988,양재대로124길,435,258,177
2020,1,A,골목상권,1000987,양재대로116길,75,41,34
2020,1,A,골목상권,1000986,양재대로101길,677,313,364
2020,1,A,골목상권,1000985,암사길,112,70,42
2020,1,A,골목상권,1000984,성안로3길,5508,4242,1266
2020,1,A,골목상권,1000983,성내로5길,1005,650,355
2020,1,A,골목상권,1000982,상일로5길,172,124,48
2020,1,A,골목상권,1000981,상암로5길,271,99,172
2020,1,A,골목상권,1000980,상암로51길,302,122,180
2020,1,A,골목상권,1000979,상암로4길,232,147,85
2020,1,A,골목상권,1000978,상암로14길,432,261,171
2020,1,A,골목상권,1000977,명일로13길,302,182,120
2020,1,A,골목상권,1000976,동남로85길,635,344,291
2020,1,A,골목상권,1000975,동남로82길,108,64,44
2020,1,A,골목상권,1000974,동남로65길,297,202,95
2020,1,A,골목상권,1000973,구천면로42길,87,52,35
2020,1,A,골목상권,1000972,구천면로41길,442,228,214
2020,1,A,골목상권,1000971,구천면로36길,32,14,18
2020,1,A,골목상권,1000970,고덕로61길,137,93,44
2020,1,A,골목상권,1000969,고덕로25길,143,91,52
2020,1,A,골목상권,1000968,고덕로10길,738,335,403
2020,1,A,골목상권,1000967,강동대로53길,1092,726,366
2020,1,A,골목상권,1000966,풍성로25길,84,43,41
2020,1,A,골목상권,1000965,오금로46길,711,359,352
2020,1,A,골목상권,1000964,오금로36길,1133,803,330
2020,1,A,골목상권,1000963,오금로11길,1427,884,543
2020,1,A,골목상권,1000962,양재대로72길,245,124,121
2020,1,A,골목상권,1000961,양재대로71길,1999,1458,541
2020,1,A,골목상권,1000960,양재대로64길,1212,705,507
2020,1,A,골목상권,1000959,양재대로62길,3230,2137,1093
2020,1,A,골목상권,1000958,송파대로30길,2240,1393,847
2020,1,A,골목상권,1000957,송이로36길,2096,1409,687
2020,1,A,골목상권,1000956,송이로32길,1295,733,562
2020,1,A,골목상권,1000955,송이로23길,1850,1269,581
2020,1,A,골목상권,1000954,삼전로13길,1420,916,504
2020,1,A,골목상권,1000953,백제고분로50길,1209,796,413
2020,1,A,골목상권,1000952,백제고분로46길,665,472,193
2020,1,A,골목상권,1000951,백제고분로45길,1349,869,480
2020,1,A,골목상권,1000950,백제고분로42길,590,289,301
2020,1,A,골목상권,1000949,백제고분로39길,566,393,173
2020,1,A,골목상권,1000948,백제고분로34길,1779,1368,411
2020,1,A,골목상권,1000947,백제고분로33길,921,574,347
2020,1,A,골목상권,1000946,백제고분로32길,725,407,318
2020,1,A,골목상권,1000945,백제고분로31길,1708,1370,338
2020,1,A,골목상권,1000944,백제고분로22길,1371,955,416
2020,1,A,골목상권,1000943,백제고분로21길,483,309,174
2020,1,A,골목상권,1000942,마천로51길,417,245,172
2020,1,A,골목상권,1000941,동남로20길,2463,1773,690
2020,1,A,골목상권,1000940,거마로20길,503,229,274
2020,1,A,골목상권,1000939,학동로77길,1851,1119,732
2020,1,A,골목상권,1000938,학동로6길,1447,977,470
2020,1,A,골목상권,1000937,학동로56길,2421,1533,888
2020,1,A,골목상권,1000936,학동로38길,1862,891,971
2020,1,A,골목상권,1000935,테헤란로81길,1637,791,846
2020,1,A,골목상권,1000934,일원로9길,590,334,256
2020,1,A,골목상권,1000933,일원로3길,513,237,276
2020,1,A,골목상권,1000932,영동대로65길,1175,692,483
2020,1,A,골목상권,1000931,영동대로112길,9367,7734,1633
2020,1,A,골목상권,1000930,언주로81길,5810,3989,1821
2020,1,A,골목상권,1000929,압구정로2길,1937,1352,585
2020,1,A,골목상권,1000928,선릉로18길,466,366,100
2020,1,A,골목상권,1000927,선릉로146길,1123,536,587
2020,1,A,골목상권,1000926,선릉로133길,739,434,305
2020,1,A,골목상권,1000925,선릉로132길,1305,645,660
2020,1,A,골목상권,1000924,선릉로121길,2263,1243,1020
2020,1,A,골목상권,1000923,삼성로75길,1814,1262,552
2020,1,A,골목상권,1000922,삼성로69길,2064,1086,978
2020,1,A,골목상권,1000921,삼성로64길,2957,1473,1484
2020,1,A,골목상권,1000920,삼성로63길,1079,554,525
2020,1,A,골목상권,1000919,삼성로57길,3231,1896,1335
2020,1,A,골목상권,1000918,삼성로147길,190,88,102
2020,1,A,골목상권,1000917,삼성로115길,839,429,410
2020,1,A,골목상권,1000916,봉은사로68길,1265,789,476
2020,1,A,골목상권,1000915,봉은사로57길,638,409,229
2020,1,A,골목상권,1000914,봉은사로43길,2978,1692,1286
2020,1,A,골목상권,1000913,봉은사로29길,1860,1203,657
2020,1,A,골목상권,1000912,봉은사로109길,2837,2093,744
2020,1,A,골목상권,1000911,도산대로89길,1284,730,554
2020,1,A,골목상권,1000910,도산대로81길,3094,1363,1731
2020,1,A,골목상권,1000909,도산대로50길,2685,1863,822
2020,1,A,골목상권,1000908,도산대로38길,1043,622,421
2020,1,A,골목상권,1000907,도산대로30길,3153,1611,1542
2020,1,A,골목상권,1000906,도산대로23길,425,176,249
2020,1,A,골목상권,1000905,도산대로15길,123,65,58
2020,1,A,골목상권,1000904,도곡로37길,7206,4518,2688
2020,1,A,골목상권,1000903,논현로8길,1081,701,380
2020,1,A,골목상권,1000902,논현로63길,2139,1352,787
2020,1,A,골목상권,1000901,논현로28길,2736,1826,910
2020,1,A,골목상권,1000900,논현로26길,17916,5148,12768
2020,1,A,골목상권,1000899,논현로159길,109,49,60
2020,1,A,골목상권,1000898,논현로139길,3565,2123,1442
2020,1,A,골목상권,1000897,논현로123길,162,106,56
2020,1,A,골목상권,1000896,논현로115길,2866,1752,1114
2020,1,A,골목상권,1000895,논현로10길,454,271,183
2020,1,A,골목상권,1000894,논현로106길,1488,1027,461
2020,1,A,골목상권,1000893,남부순환로365길,691,445,246
2020,1,A,골목상권,1000892,개포로82길,103,51,52
2020,1,A,골목상권,1000891,개포로28길,589,445,144
2020,1,A,골목상권,1000890,개포로20길,647,400,247
2020,1,A,골목상권,1000889,개포로17길,961,659,302
2020,1,A,골목상권,1000888,강남대로140길,1433,810,623
2020,1,A,골목상권,1000887,강남대로136길,5070,3655,1415
2020,1,A,골목상권,1000886,강남대로118길,218,91,127
2020,1,A,골목상권,1000885,서초중앙로8길,21671,11288,10383
2020,1,A,골목상권,1000884,방배중앙로21길,7153,2605,4548
2020,1,A,골목상권,1000883,효령로72길,3428,2690,738
2020,1,A,골목상권,1000882,효령로34길,1015,653,362
2020,1,A,골목상권,1000881,효령로31길,2710,2198,512
2020,1,A,골목상권,1000880,효령로23길,1492,964,528
2020,1,A,골목상권,1000879,청두곶길,1446,795,651
2020,1,A,골목상권,1000878,주흥길,164,111,53
2020,1,A,골목상권,1000877,주흥15길,834,539,295
2020,1,A,골목상권,1000876,언남길,1128,742,386
2020,1,A,골목상권,1000875,신반포로45길,1192,625,567
2020,1,A,골목상권,1000874,서초대로8길,2598,644,1954
2020,1,A,골목상권,1000873,서초대로64길,829,489,340
2020,1,A,골목상권,1000872,서초대로4길,847,478,369
2020,1,A,골목상권,1000871,서초대로25길,2073,1591,482
2020,1,A,골목상권,1000870,서초대로23길,2098,1239,859
2020,1,A,골목상권,1000869,서초대로15길,467,253,214
2020,1,A,골목상권,1000868,사평대로57길,65,33,32
2020,1,A,골목상권,1000867,사평대로26길,509,346,163
2020,1,A,골목상권,1000866,사평대로22길,1697,1052,645
2020,1,A,골목상권,1000865,사임당로17길,1939,1273,666
2020,1,A,골목상권,1000864,방배로42길,861,707,154
2020,1,A,골목상권,1000863,방배로35길,1137,711,426
2020,1,A,골목상권,1000862,방배로18길,873,535,338
2020,1,A,골목상권,1000861,반포대로9길,538,288,250
2020,1,A,골목상권,1000860,바우뫼로39길,2648,1935,713
2020,1,A,골목상권,1000859,마방로2길,3582,2570,1012
2020,1,A,골목상권,1000858,방배천로4안길,959,401,558
2020,1,A,골목상권,1000857,동산로19길,1276,633,643
2020,1,A,골목상권,1000856,동산로10길,2158,1493,665
2020,1,A,골목상권,1000855,동광로39길,1227,825,402
2020,1,A,골목상권,1000854,동광로1길,2565,1862,703
2020,1,A,골목상권,1000853,동광로12길,1237,610,627
2020,1,A,골목상권,1000852,논현로27길,2808,2146,662
2020,1,A,골목상권,1000851,논현로1길,1227,780,447
2020,1,A,골목상권,1000850,남부순환로339길,1451,978,473
2020,1,A,골목상권,1000849,남부순환로325길,1477,1061,416
2020,1,A,골목상권,1000848,남부순환로317길,2386,1532,854
2020,1,A,골목상권,1000847,고무래로8길,5479,3568,1911
2020,1,A,골목상권,1000846,강남대로8길,1850,1231,619
2020,1,A,골목상권,1000845,강남대로34길,1734,1204,530
2020,1,A,골목상권,1000844,강남대로23길,2897,1993,904
2020,1,A,골목상권,1000843,소담길,14,4,10
2020,1,A,골목상권,1000842,원신길,22,11,11
2020,1,A,골목상권,1000840,양산길,11,3,8
2020,1,A,골목상권,1000839,호암로24길,1218,1084,134
2020,1,A,골목상권,1000838,호암로20길,186,77,109
2020,1,A,골목상권,1000837,행운길,557,428,129
2020,1,A,골목상권,1000836,행운1길,250,151,99
2020,1,A,골목상권,1000835,청림3길,167,58,109
2020,1,A,골목상권,1000834,청룡길,404,224,180
2020,1,A,골목상권,1000833,청룡8길,222,53,169
2020,1,A,골목상권,1000832,중앙길,99,30,69
2020,1,A,골목상권,1000831,조원중앙로2길,921,694,227
2020,1,A,골목상권,1000830,조원로18길,179,92,87
2020,1,A,골목상권,1000829,조원로10길,397,215,182
2020,1,A,골목상권,1000828,장군봉2길,201,115,86
2020,1,A,골목상권,1000827,장군봉1길,326,166,160
2020,1,A,골목상권,1000826,인헌길,115,61,54
2020,1,A,골목상권,1000825,은천로25길,44,21,23
2020,1,A,골목상권,1000824,양녕로6길,205,124,81
2020,1,A,골목상권,1000823,신원로3길,180,103,77
2020,1,A,골목상권,1000822,신사로20길,121,93,28
2020,1,A,골목상권,1000821,신림로65길,228,175,53
2020,1,A,골목상권,1000820,신림로64길,113,45,68
2020,1,A,골목상권,1000819,신림로48길,75,49,26
2020,1,A,골목상권,1000818,신림로38길,147,90,57
2020,1,A,골목상권,1000817,신림로28길,442,283,159
2020,1,A,골목상권,1000816,신림로11길,284,183,101
2020,1,A,골목상권,1000815,신림동길,669,435,234
2020,1,A,골목상권,1000814,승방길,251,141,110
2020,1,A,골목상권,1000813,서림7길,116,58,58
2020,1,A,골목상권,1000812,봉천로33길,211,131,80
2020,1,A,골목상권,1000811,봉천로13길,241,86,155
2020,1,A,골목상권,1000810,복은길,405,229,176
2020,1,A,골목상권,1000809,법원단지길,16,5,11
2020,1,A,골목상권,1000808,법원단지9길,163,102,61
2020,1,A,골목상권,1000807,미성5길,309,154,155
2020,1,A,골목상권,1000806,대학길,80,45,35
2020,1,A,골목상권,1000805,대학14길,61,31,30
2020,1,A,골목상권,1000804,당곡길,227,117,110
2020,1,A,골목상권,1000803,남현길,117,28,89
2020,1,A,골목상권,1000802,남현3길,372,256,116
2020,1,A,골목상권,1000801,남현2길,568,398,170
2020,1,A,골목상권,1000800,남부순환로248길,404,213,191
2020,1,A,골목상권,1000799,남부순환로234길,126,81,45
2020,1,A,골목상권,1000798,남부순환로172길,450,316,134
2020,1,A,골목상권,1000797,남부순환로161길,347,223,124
2020,1,A,골목상권,1000796,남부순환로151길,788,369,419
2020,1,A,골목상권,1000795,남부순환로142길,418,252,166
2020,1,A,골목상권,1000794,난향길,206,89,117
2020,1,A,골목상권,1000793,난우길,217,121,96
2020,1,A,골목상권,1000792,난곡로74길,2179,1754,425
2020,1,A,골목상권,1000791,난곡로34길,47,19,28
2020,1,A,골목상권,1000790,난곡로26길,120,85,35
2020,1,A,골목상권,1000789,난곡로24길,89,34,55
2020,1,A,골목상권,1000788,낙성대역길,431,230,201
2020,1,A,골목상권,1000787,국회단지길,1430,396,1034
2020,1,A,골목상권,1000786,구암길,228,72,156
2020,1,A,골목상권,1000785,관천로22길,194,117,77
2020,1,A,골목상권,1000784,관천로15길,236,149,87
2020,1,A,골목상권,1000783,관악로30길,140,51,89
2020,1,A,골목상권,1000782,관악로28길,122,39,83
2020,1,A,골목상권,1000781,관악로14길,109,42,67
2020,1,A,골목상권,1000780,관악로10길,1482,1050,432
2020,1,A,골목상권,1000779,흑석로9길,110,76,34
2020,1,A,골목상권,1000778,흑석로13길,77,33,44
2020,1,A,골목상권,1000777,장승배기로27길,260,135,125
2020,1,A,골목상권,1000776,장승배기로19길,518,409,109
2020,1,A,골목상권,1000775,장승배기로10길,223,90,133
2020,1,A,골목상권,1000774,여의대방로46길,1238,733,505
2020,1,A,골목상권,1000773,여의대방로24길,16249,10586,5663
2020,1,A,골목상권,1000772,여의대방로22카길,346,202,144
2020,1,A,골목상권,1000771,여의대방로22나길,188,95,93
2020,1,A,골목상권,1000770,여의대방로22길,241,128,113
2020,1,A,골목상권,1000769,양녕로26길,92,49,43
2020,1,A,골목상권,1000768,신대방길,191,90,101
2020,1,A,골목상권,1000767,성대로29길,297,143,154
2020,1,A,골목상권,1000766,성대로1길,87,43,44
2020,1,A,골목상권,1000765,서달로8가길,83,34,49
2020,1,A,골목상권,1000764,서달로15길,42,14,28
2020,1,A,골목상권,1000763,서달로14길,21,7,14
2020,1,A,골목상권,1000762,서달로10길,51,28,23
2020,1,A,골목상권,1000761,상도로62길,332,179,153
2020,1,A,골목상권,1000760,상도로61길,187,67,120
2020,1,A,골목상권,1000759,상도로47길,601,288,313
2020,1,A,골목상권,1000758,상도로37길,128,65,63
2020,1,A,골목상권,1000757,상도로15길,320,121,199
2020,1,A,골목상권,1000756,사당로8길,131,70,61
2020,1,A,골목상권,1000755,사당로30길,514,180,334
2020,1,A,골목상권,1000754,사당로2차길,324,216,108
2020,1,A,골목상권,1000753,사당로29길,128,78,50
2020,1,A,골목상권,1000752,사당로26길,321,199,122
2020,1,A,골목상권,1000751,사당로23나길,36,21,15
2020,1,A,골목상권,1000749,사당로20길,103,53,50
2020,1,A,골목상권,1000748,사당로16길,116,36,80
2020,1,A,골목상권,1000747,사당로16가길,237,147,90
2020,1,A,골목상권,1000746,만양로8길,824,512,312
2020,1,A,골목상권,1000745,만양로14길,47,29,18
2020,1,A,골목상권,1000744,등용로14길,409,134,275
2020,1,A,골목상권,1000743,동작대로7길,182,84,98
2020,1,A,골목상권,1000742,동작대로35길,190,87,103
2020,1,A,골목상권,1000741,동작대로33길,170,88,82
2020,1,A,골목상권,1000740,동작대로29길,224,49,175
2020,1,A,골목상권,1000739,동작대로17길,806,386,420
2020,1,A,골목상권,1000738,대방동2길,281,134,147
2020,1,A,골목상권,1000737,대방동27길,465,223,242
2020,1,A,골목상권,1000736,노량진로6길,307,204,103
2020,1,A,골목상권,1000735,국사봉길,138,79,59
2020,1,A,골목상권,1000734,국사봉2길,55,34,21
2020,1,A,골목상권,1000733,국사봉1길,85,52,33
2020,1,A,골목상권,1000732,영신로9길,3221,1646,1575
2020,1,A,골목상권,1000731,영등포로84길,1933,673,1260
2020,1,A,골목상권,1000730,영등포로80길,96,48,48
2020,1,A,골목상권,1000729,영등포로62길,118,85,33
2020,1,A,골목상권,1000728,영등포로35길,340,192,148
2020,1,A,골목상권,1000727,영등포로27길,301,189,112
2020,1,A,골목상권,1000726,영등포로25길,493,363,130
2020,1,A,골목상권,1000725,여의대방로61길,514,400,114
2020,1,A,골목상권,1000724,여의대방로43나길,859,661,198
2020,1,A,골목상권,1000723,여의대방로39길,193,112,81
2020,1,A,골목상권,1000722,여의대방로35길,197,65,132
2020,1,A,골목상권,1000721,양평로28길,847,707,140
2020,1,A,골목상권,1000720,양평로22라길,555,299,256
2020,1,A,골목상권,1000719,양평로19길,748,436,312
2020,1,A,골목상권,1000718,신길로60길,260,196,64
2020,1,A,골목상권,1000717,신길로42길,501,270,231
2020,1,A,골목상권,1000716,신길로42가길,210,90,120
2020,1,A,골목상권,1000715,신길로39길,56,32,24
2020,1,A,골목상권,1000714,신길로17길,676,289,387
2020,1,A,골목상권,1000713,선유서로28길,208,110,98
2020,1,A,골목상권,1000712,선유서로25길,1697,1284,413
2020,1,A,골목상권,1000711,선유서로24길,114,70,44
2020,1,A,골목상권,1000710,선유로55길,416,273,143
2020,1,A,골목상권,1000709,디지털로74길,13,8,5
2020,1,A,골목상권,1000708,디지털로57길,1036,639,397
2020,1,A,골목상권,1000707,디지털로37길,172,55,117
2020,1,A,골목상권,1000706,도신로62길,227,173,54
2020,1,A,골목상권,1000705,도신로60길,124,51,73
2020,1,A,골목상권,1000704,도신로29길,108,49,59
2020,1,A,골목상권,1000703,도신로15길,437,238,199
2020,1,A,골목상권,1000702,도림천로21길,236,157,79
2020,1,A,골목상권,1000701,도림로63길,53,41,12
2020,1,A,골목상권,1000700,도림로147길,334,255,79
2020,1,A,골목상권,1000699,도림로112길,30,19,11
2020,1,A,골목상권,1000698,대림로8길,234,113,121
2020,1,A,골목상권,1000697,대림로7길,49,23,26
2020,1,A,골목상권,1000696,대림로44길,411,289,122
2020,1,A,골목상권,1000695,대림로34길,201,139,62
2020,1,A,골목상권,1000694,대림로31길,454,281,173
2020,1,A,골목상권,1000693,대림로29길,964,624,340
2020,1,A,골목상권,1000692,대림로22길,190,98,92
2020,1,A,골목상권,1000691,당산로46길,698,529,169
2020,1,A,골목상권,1000690,당산로38길,676,471,205
2020,1,A,골목상권,1000689,당산로37길,2439,1483,956
2020,1,A,골목상권,1000688,당산로31길,1481,749,732
2020,1,A,골목상권,1000687,국회대로56길,3275,1590,1685
2020,1,A,골목상권,1000686,경인로90길,282,210,72
2020,1,A,골목상권,1000685,경인로80길,1007,706,301
2020,1,A,골목상권,1000684,경인로77길,741,512,229
2020,1,A,골목상권,1000683,가마산로61길,47,35,12
2020,1,A,골목상권,1000682,시흥대로94길,446,164,282
2020,1,A,골목상권,1000681,시흥대로84길,178,103,75
2020,1,A,골목상권,1000680,시흥대로68길,549,219,330
2020,1,A,골목상권,1000679,시흥대로63길,1016,542,474
2020,1,A,골목상권,1000678,시흥대로62가길,86,59,27
2020,1,A,골목상권,1000677,시흥대로36길,288,173,115
2020,1,A,골목상권,1000676,시흥대로22길,259,143,116
2020,1,A,골목상권,1000675,시흥대로153길,92,55,37
2020,1,A,골목상권,1000674,시흥대로150길,421,278,143
2020,1,A,골목상권,1000673,시흥대로141길,214,142,72
2020,1,A,골목상권,1000672,시흥대로138길,341,246,95
2020,1,A,골목상권,1000671,시흥대로120길,192,117,75
2020,1,A,골목상권,1000670,벚꽃로56길,301,260,41
2020,1,A,골목상권,1000669,범안로17길,4567,2830,1737
2020,1,A,골목상권,1000668,범안로11길,1498,819,679
2020,1,A,골목상권,1000667,문성로5길,379,199,180
2020,1,A,골목상권,1000666,독산로85길,68,34,34
2020,1,A,골목상권,1000665,독산로78다길,195,124,71
2020,1,A,골목상권,1000664,독산로70길,74,31,43
2020,1,A,골목상권,1000663,독산로64길,186,152,34
2020,1,A,골목상권,1000662,독산로50길,27,6,21
2020,1,A,골목상권,1000661,독산로40길,219,75,144
2020,1,A,골목상권,1000660,독산로108길,1619,1443,176
2020,1,A,골목상권,1000659,남부순환로112길,96,66,30
2020,1,A,골목상권,1000658,금하로24길,132,72,60
2020,1,A,골목상권,1000657,금하로1길,227,175,52
2020,1,A,골목상권,1000656,금하로14길,96,65,31
2020,1,A,골목상권,1000655,가산로5길,499,350,149
2020,1,A,골목상권,1000654,가산로3길,999,756,243
2020,1,A,골목상권,1000653,중앙로1길,960,704,256
2020,1,A,골목상권,1000652,중앙로15길,171,106,65
2020,1,A,골목상권,1000651,우마길,43,19,24
2020,1,A,골목상권,1000650,오류로8길,442,219,223
2020,1,A,골목상권,1000649,신도림로13길,148,100,48
2020,1,A,골목상권,1000648,새말로18길,933,549,384
2020,1,A,골목상권,1000647,부일로1길,356,321,35
2020,1,A,골목상권,1000646,부일로15길,156,107,49
2020,1,A,골목상권,1000645,부일로11길,281,115,166
2020,1,A,골목상권,1000644,디지털로32길,815,435,380
2020,1,A,골목상권,1000643,디지털로32가길,2221,1322,899
2020,1,A,골목상권,1000642,디지털로27길,26,20,6
2020,1,A,골목상권,1000641,도림로6길,160,93,67
2020,1,A,골목상권,1000640,도림로12길,186,124,62
2020,1,A,골목상권,1000639,남부순환로97길,101,48,53
2020,1,A,골목상권,1000638,구로중앙로8길,107,41,66
2020,1,A,골목상권,1000637,구로중앙로7길,86,42,44
2020,1,A,골목상권,1000636,구로중앙로42길,403,284,119
2020,1,A,골목상권,1000635,구로중앙로34길,189,149,40
2020,1,A,골목상권,1000634,구로중앙로28길,470,226,244
2020,1,A,골목상권,1000633,구로중앙로19길,666,398,268
2020,1,A,골목상권,1000632,구로동로8길,298,153,145
2020,1,A,골목상권,1000631,구로동로7길,115,71,44
2020,1,A,골목상권,1000630,구로동로42길,131,75,56
2020,1,A,골목상권,1000629,구로동로41길,119,79,40
2020,1,A,골목상권,1000628,구로동로38길,625,240,385
2020,1,A,골목상권,1000627,구로동로28길,42,18,24
2020,1,A,골목상권,1000626,구로동로15길,88,50,38
2020,1,A,골목상권,1000625,공원로6가길,1158,755,403
2020,1,A,골목상권,1000624,고척로52길,40,27,13
2020,1,A,골목상권,1000623,고척로27다길,169,99,70
2020,1,A,골목상권,1000622,고척로27길,309,167,142
2020,1,A,골목상권,1000621,고척로21나길,369,197,172
2020,1,A,골목상권,1000620,경인로47길,657,264,393
2020,1,A,골목상권,1000619,경인로35길,364,232,132
2020,1,A,골목상권,1000618,경인로31길,130,61,69
2020,1,A,골목상권,1000617,경인로15길,259,93,166
2020,1,A,골목상권,1000616,개봉로3길,273,139,134
2020,1,A,골목상권,1000615,개봉로2길,186,99,87
2020,1,A,골목상권,1000614,개봉로23가길,826,590,236
2020,1,A,골목상권,1000613,개봉로20길,3082,1346,1736
2020,1,A,골목상권,1000612,개봉로1길,187,126,61
2020,1,A,골목상권,1000611,개봉로17다길,2362,1606,756
2020,1,A,골목상권,1000610,개봉로17길,1304,418,886
2020,1,A,골목상권,1000609,개봉로11길,181,97,84
2020,1,A,골목상권,1000608,화곡로64길,1128,686,442
2020,1,A,골목상권,1000607,화곡로59길,316,232,84
2020,1,A,골목상권,1000606,화곡로44나길,625,559,66
2020,1,A,골목상권,1000605,화곡로31길,618,375,243
2020,1,A,골목상권,1000604,화곡로20길,355,193,162
2020,1,A,골목상권,1000603,화곡로13길,368,249,119
2020,1,A,골목상권,1000602,초원로16길,523,369,154
2020,1,A,골목상권,1000601,초록마을로8길,116,68,48
2020,1,A,골목상권,1000600,초록마을로3길,439,355,84
2020,1,A,골목상권,1000599,월정로20길,135,31,104
2020,1,A,골목상권,1000598,우장산로6길,486,298,188
2020,1,A,골목상권,1000597,양천로73가길,468,360,108
2020,1,A,골목상권,1000596,양천로71길,1203,752,451
2020,1,A,골목상권,1000595,양천로49길,342,232,110
2020,1,A,골목상권,1000594,양천로26길,479,377,102
2020,1,A,골목상권,1000593,양천로24길,186,100,86
2020,1,A,골목상권,1000592,양천로24가길,207,113,94
2020,1,A,골목상권,1000591,양천로14길,257,143,114
2020,1,A,골목상권,1000590,방화대로6라길,653,413,240
2020,1,A,골목상권,1000589,방화대로21길,390,243,147
2020,1,A,골목상권,1000588,등촌로5길,1524,514,1010
2020,1,A,골목상권,1000587,등촌로55길,432,323,109
2020,1,A,골목상권,1000586,등촌로51길,239,137,102
2020,1,A,골목상권,1000585,등촌로39길,313,146,167
2020,1,A,골목상권,1000584,등촌로13길,183,128,55
2020,1,A,골목상권,1000583,남부순환로11길,307,201,106
2020,1,A,골목상권,1000582,까치산로4길,189,112,77
2020,1,A,골목상권,1000581,국회대로7길,215,101,114
2020,1,A,골목상권,1000580,공항대로8길,276,172,104
2020,1,A,골목상권,1000579,공항대로61길,547,415,132
2020,1,A,골목상권,1000578,공항대로59다길,1037,645,392
2020,1,A,골목상권,1000577,공항대로59길,654,454,200
2020,1,A,골목상권,1000576,공항대로55길,900,577,323
2020,1,A,골목상권,1000575,공항대로42길,514,323,191
2020,1,A,골목상권,1000574,공항대로38길,92,49,43
2020,1,A,골목상권,1000573,곰달래로60길,221,146,75
2020,1,A,골목상권,1000572,곰달래로53길,130,89,41
2020,1,A,골목상권,1000571,곰달래로47길,333,218,115
2020,1,A,골목상권,1000570,곰달래로31길,120,78,42
2020,1,A,골목상권,1000569,곰달래로25길,245,139,106
2020,1,A,골목상권,1000568,개화동로25길,351,201,150
2020,1,A,골목상권,1000567,개화동로23길,857,669,188
2020,1,A,골목상권,1000566,강서로8길,214,125,89
2020,1,A,골목상권,1000565,강서로5라길,245,176,69
2020,1,A,골목상권,1000564,강서로5나길,360,221,139
2020,1,A,골목상권,1000563,강서로5가길,182,98,84
2020,1,A,골목상권,1000562,강서로47라길,207,150,57
2020,1,A,골목상권,1000561,강서로47길,327,146,181
2020,1,A,골목상권,1000560,강서로45다길,243,178,65
2020,1,A,골목상권,1000559,강서로45길,101,43,58
2020,1,A,골목상권,1000558,강서로35길,280,120,160
2020,1,A,골목상권,1000557,강서로29길,384,230,154
2020,1,A,골목상권,1000556,강서로18길,676,545,131
2020,1,A,골목상권,1000555,강서로17가길,554,386,168
2020,1,A,골목상권,1000554,강서로15길,261,152,109
2020,1,A,골목상권,1000553,가로공원로80길,270,175,95
2020,1,A,골목상권,1000552,가로공원로76가길,168,91,77
2020,1,A,골목상권,1000551,화곡로4길,421,219,202
2020,1,A,골목상권,1000550,화곡로3길,351,177,174
2020,1,A,골목상권,1000549,지양로7길,245,105,140
2020,1,A,골목상권,1000548,중앙로55길,592,261,331
2020,1,A,골목상권,1000547,중앙로51길,283,178,105
2020,1,A,골목상권,1000546,중앙로47길,94,40,54
2020,1,A,골목상권,1000545,중앙로45길,1386,1342,44
2020,1,A,골목상권,1000544,중앙로36길,133,49,84
2020,1,A,골목상권,1000543,중앙로32길,145,87,58
2020,1,A,골목상권,1000542,중앙로25길,97,61,36
2020,1,A,골목상권,1000541,은행정로7길,472,183,289
2020,1,A,골목상권,1000540,은행정로5길,109,57,52
2020,1,A,골목상권,1000539,오목로5길,120,85,35
2020,1,A,골목상권,1000538,오목로3길,375,296,79
2020,1,A,골목상권,1000537,오목로30길,220,125,95
2020,1,A,골목상권,1000536,오목로23길,401,155,246
2020,1,A,골목상권,1000535,신월로20길,47,30,17
2020,1,A,골목상권,1000534,신월로15길,357,184,173
2020,1,A,골목상권,1000533,신목로6길,582,383,199
2020,1,A,골목상권,1000532,신목로5길,645,416,229
2020,1,A,골목상권,1000531,신목로2길,386,255,131
2020,1,A,골목상권,1000530,목동중앙서로8가길,317,200,117
2020,1,A,골목상권,1000529,목동중앙서로7길,75,52,23
2020,1,A,골목상권,1000528,목동중앙북로8길,171,102,69
2020,1,A,골목상권,1000527,목동중앙북로16길,488,190,298
2020,1,A,골목상권,1000526,목동중앙본로7길,131,70,61
2020,1,A,골목상권,1000525,목동중앙로3길,157,95,62
2020,1,A,골목상권,1000524,목동중앙로13나길,346,248,98
2020,1,A,골목상권,1000523,목동중앙남로3가길,190,108,82
2020,1,A,골목상권,1000522,목동로9길,768,479,289
2020,1,A,골목상권,1000521,목동로19길,351,190,161
2020,1,A,골목상권,1000520,목동동로8길,184,106,78
2020,1,A,골목상권,1000519,목동동로12길,335,228,107
2020,1,A,골목상권,1000518,목동남로4길,797,494,303
2020,1,A,골목상권,1000517,남부순환로88길,328,124,204
2020,1,A,골목상권,1000516,남부순환로79길,142,74,68
2020,1,A,골목상권,1000515,남부순환로70길,165,101,64
2020,1,A,골목상권,1000514,남부순환로58길,282,179,103
2020,1,A,골목상권,1000513,남부순환로40길,122,46,76
2020,1,A,골목상권,1000512,남부순환로33길,179,116,63
2020,1,A,골목상권,1000511,곰달래로5길,211,125,86
2020,1,A,골목상권,1000510,곰달래로3길,313,213,100
2020,1,A,골목상권,1000509,곰달래로2길,610,344,266
2020,1,A,골목상권,1000508,곰달래로10길,543,449,94
2020,1,A,골목상권,1000507,가로공원로58길,91,54,37
2020,1,A,골목상권,1000506,효창원로93길,243,99,144
2020,1,A,골목상권,1000505,토정로37길,431,166,265
2020,1,A,골목상권,1000504,월드컵로8길,939,462,477
2020,1,A,골목상권,1000503,월드컵로7길,759,308,451
2020,1,A,골목상권,1000502,월드컵로36길,461,286,175
2020,1,A,골목상권,1000501,월드컵로25길,309,125,184
2020,1,A,골목상권,1000500,월드컵로19길,284,181,103
2020,1,A,골목상권,1000499,월드컵로16길,1538,929,609
2020,1,A,골목상권,1000498,월드컵로11길,421,153,268
2020,1,A,골목상권,1000497,월드컵로10길,1102,654,448
2020,1,A,골목상권,1000496,와우산로3길,257,176,81
2020,1,A,골목상권,1000495,와우산로29길,78,30,48
2020,1,A,골목상권,1000494,와우산로29가길,989,653,336
2020,1,A,골목상권,1000493,양화진길,676,412,264
2020,1,A,골목상권,1000492,양화로1길,544,248,296
2020,1,A,골목상권,1000491,양화로11길,2761,1012,1749
2020,1,A,골목상권,1000490,신촌로30길,109,64,45
2020,1,A,골목상권,1000489,신촌로28가길,59,19,40
2020,1,A,골목상권,1000488,신촌로12길,197,95,102
2020,1,A,골목상권,1000487,숭문길,1467,1016,451
2020,1,A,골목상권,1000486,숭문8길,109,65,44
2020,1,A,골목상권,1000485,성지3길,338,228,110
2020,1,A,골목상권,1000484,성산로4길,855,546,309
2020,1,A,골목상권,1000483,성미산로32길,243,172,71
2020,1,A,골목상권,1000482,성미산로1길,554,299,255
2020,1,A,골목상권,1000481,성미산로11길,1114,807,307
2020,1,A,골목상권,1000480,백범로16길,1908,1298,610
2020,1,A,골목상권,1000479,방울내로9안길,619,351,268
2020,1,A,골목상권,1000478,모래내로7길,91,63,28
2020,1,A,골목상권,1000477,매봉산로2길,806,601,205
2020,1,A,골목상권,1000476,망원로2길,282,190,92
2020,1,A,골목상권,1000475,망원로11길,144,73,71
2020,1,A,골목상권,1000474,만리재옛길,1190,687,503
2020,1,A,골목상권,1000473,마포대로4길,674,365,309
2020,1,A,골목상권,1000472,마포대로20길,483,258,225
2020,1,A,골목상권,1000471,마포대로12길,78,39,39
2020,1,A,골목상권,1000470,동교로38길,464,247,217
2020,1,A,골목상권,1000469,동교로27길,1172,795,377
2020,1,A,골목상권,1000468,동교로25길,1378,581,797
2020,1,A,골목상권,1000467,동교로19길,1207,739,468
2020,1,A,골목상권,1000466,동교로17길,405,240,165
2020,1,A,골목상권,1000465,독막로8길,441,274,167
2020,1,A,골목상권,1000464,독막로32길,487,240,247
2020,1,A,골목상권,1000463,독막로22길,91,61,30
2020,1,A,골목상권,1000462,도화길,56,32,24
2020,1,A,골목상권,1000461,도화4길,825,292,533
2020,1,A,골목상권,1000460,대흥로28길,50,17,33
2020,1,A,골목상권,1000459,대흥로21길,372,188,184
2020,1,A,골목상권,1000458,광성로6길,295,169,126
2020,1,A,골목상권,1000457,홍제내길,565,201,364
2020,1,A,골목상권,1000456,홍연길,79,47,32
2020,1,A,골목상권,1000455,통일로39길,67,32,35
2020,1,A,골목상권,1000454,통일로37길,611,407,204
2020,1,A,골목상권,1000453,통일로11길,97,46,51
2020,1,A,골목상권,1000452,충정로6길,3185,1879,1306
2020,1,A,골목상권,1000451,충정로4길,2044,1298,746
2020,1,A,골목상권,1000450,증가로6길,326,277,49
2020,1,A,골목상권,1000449,증가로23나길,902,441,461
2020,1,A,골목상권,1000448,증가로20가길,336,99,237
2020,1,A,골목상권,1000447,증가로10길,1463,1123,340
2020,1,A,골목상권,1000446,응암로1길,621,380,241
2020,1,A,골목상권,1000445,연희로10길,3448,3135,313
2020,1,A,골목상권,1000444,신촌로37길,52,25,27
2020,1,A,골목상권,1000443,수색로8길,1090,905,185
2020,1,A,골목상권,1000442,세무서길,164,78,86
2020,1,A,골목상권,1000441,세무서2길,186,77,109
2020,1,A,골목상권,1000440,세검정로1길,109,37,72
2020,1,A,골목상권,1000439,북아현로4길,350,225,125
2020,1,A,골목상권,1000438,모래내로15길,74,54,20
2020,1,A,골목상권,1000437,명지대길,107,58,49
2020,1,A,골목상권,1000436,독립문로8길,679,422,257
2020,1,A,골목상권,1000435,가재울로6길,168,108,60
2020,1,A,골목상권,1000434,통일로92길,186,72,114
2020,1,A,골목상권,1000433,통일로87길,255,130,125
2020,1,A,골목상권,1000432,통일로78길,172,60,112
2020,1,A,골목상권,1000431,통일로69길,107,55,52
2020,1,A,골목상권,1000430,진흥로1길,310,165,145
2020,1,A,골목상권,1000429,진흥로12길,392,144,248
2020,1,A,골목상권,1000428,증산서길,334,189,145
2020,1,A,골목상권,1000427,증산로9길,606,525,81
2020,1,A,골목상권,1000426,증산로5길,508,308,200
2020,1,A,골목상권,1000425,증산로21길,237,122,115
2020,1,A,골목상권,1000424,증산로17길,161,110,51
2020,1,A,골목상권,1000423,증산로15길,398,297,101
2020,1,A,골목상권,1000422,증산로13길,79,42,37
2020,1,A,골목상권,1000421,응암로34길,231,118,113
2020,1,A,골목상권,1000420,응암로22길,130,53,77
2020,1,A,골목상권,1000419,응암로14길,99,50,49
2020,1,A,골목상권,1000418,응암로13길,156,44,112
2020,1,A,골목상권,1000417,응암로12길,67,32,35
2020,1,A,골목상권,1000416,은평로8길,275,194,81
2020,1,A,골목상권,1000415,은평로3길,242,110,132
2020,1,A,골목상권,1000414,은평로20길,9,2,7
2020,1,A,골목상권,1000413,은평로13길,655,283,372
2020,1,A,골목상권,1000412,은평로10길,246,148,98
2020,1,A,골목상권,1000411,연서로5길,647,303,344
2020,1,A,골목상권,1000410,연서로41길,64,33,31
2020,1,A,골목상권,1000409,연서로3길,119,51,68
2020,1,A,골목상권,1000408,연서로34길,1310,709,601
2020,1,A,골목상권,1000407,연서로33길,109,49,60
2020,1,A,골목상권,1000406,연서로29길,100,60,40
2020,1,A,골목상권,1000405,연서로28길,226,118,108
2020,1,A,골목상권,1000404,연서로27길,339,148,191
2020,1,A,골목상권,1000403,연서로21길,684,486,198
2020,1,A,골목상권,1000402,연서로17길,540,162,378
2020,1,A,골목상권,1000401,연서로16길,121,66,55
2020,1,A,골목상권,1000400,연서로13길,218,135,83
2020,1,A,골목상권,1000399,연서로11길,640,263,377
2020,1,A,골목상권,1000398,역말로9길,159,82,77
2020,1,A,골목상권,1000397,수색로18길,128,93,35
2020,1,A,골목상권,1000396,서오릉로8길,160,104,56
2020,1,A,골목상권,1000395,서오릉로21길,153,56,97
2020,1,A,골목상권,1000394,불광천길,192,95,97
2020,1,A,골목상권,1000393,갈현로7길,398,205,193
2020,1,A,골목상권,1000392,갈현로41길,171,78,93
2020,1,A,골목상권,1000391,갈현로33길,255,149,106
2020,1,A,골목상권,1000390,갈현로1길,66,36,30
2020,1,A,골목상권,1000389,가좌로7길,329,203,126
2020,1,A,골목상권,1000388,한글비석로44길,232,95,137
2020,1,A,골목상권,1000387,한글비석로24길,180,62,118
2020,1,A,골목상권,1000386,한글비석로22길,172,92,80
2020,1,A,골목상권,1000385,석계로1길,605,255,350
2020,1,A,골목상권,1000384,상계로9가길,151,82,69
2020,1,A,골목상권,1000383,상계로1길,334,244,90
2020,1,A,골목상권,1000382,상계로12길,144,90,54
2020,1,A,골목상권,1000381,동일로242길,302,142,160
2020,1,A,골목상권,1000380,동일로192길,429,326,103
2020,1,A,골목상권,1000379,동일로173가길,1230,946,284
2020,1,A,골목상권,1000378,공릉로58길,129,61,68
2020,1,A,골목상권,1000377,해등로16길,285,134,151
2020,1,A,골목상권,1000376,우이천로4다길,125,83,42
2020,1,A,골목상권,1000375,우이천로32길,206,83,123
2020,1,A,골목상권,1000374,시루봉로23길,267,128,139
2020,1,A,골목상권,1000373,삼양로144길,50,24,26
2020,1,A,골목상권,1000372,방학로6가길,167,67,100
2020,1,A,골목상권,1000371,방학로5길,124,87,37
2020,1,A,골목상권,1000370,방학로15길,687,454,233
2020,1,A,골목상권,1000369,방학로10길,67,51,16
2020,1,A,골목상권,1000368,도봉산길,135,64,71
2020,1,A,골목상권,1000367,도봉산4길,27,24,3
2020,1,A,골목상권,1000366,도봉로181길,93,30,63
2020,1,A,골목상권,1000365,도봉로169나길,244,184,60
2020,1,A,골목상권,1000364,도봉로156길,93,62,31
2020,1,A,골목상권,1000363,도봉로152가길,342,311,31
2020,1,A,골목상권,1000362,도봉로147길,161,81,80
2020,1,A,골목상권,1000361,도봉로143길,73,48,25
2020,1,A,골목상권,1000360,도봉로114길,380,143,237
2020,1,A,골목상권,1000359,도봉로109길,276,223,53
2020,1,A,골목상권,1000358,도당로29길,518,292,226
2020,1,A,골목상권,1000357,도당로19길,597,66,531
2020,1,A,골목상권,1000356,도당로13바길,74,35,39
2020,1,A,골목상권,1000355,도당로13가길,36,21,15
2020,1,A,골목상권,1000354,덕릉로60길,177,126,51
2020,1,A,골목상권,1000353,노해로63다길,43,19,24
2020,1,A,골목상권,1000352,노해로60길,136,85,51
2020,1,A,골목상권,1000351,한천로140길,36,25,11
2020,1,A,골목상권,1000350,한천로139가길,108,47,61
2020,1,A,골목상권,1000349,한천로132길,56,31,25
2020,1,A,골목상권,1000348,한천로130길,91,69,22
2020,1,A,골목상권,1000347,한천로124나길,54,23,31
2020,1,A,골목상권,1000346,한천로109길,439,280,159
2020,1,A,골목상권,1000345,인수봉로79길,242,153,89
2020,1,A,골목상권,1000344,인수봉로72길,54,18,36
2020,1,A,골목상권,1000343,인수봉로56길,44,25,19
2020,1,A,골목상권,1000342,오패산로67길,238,89,149
2020,1,A,골목상권,1000341,오패산로52길,105,47,58
2020,1,A,골목상권,1000340,오패산로30길,13,5,8
2020,1,A,골목상권,1000339,수유로12길,281,199,82
2020,1,A,골목상권,1000338,솔샘로65길,284,66,218
2020,1,A,골목상권,1000337,솔매로50길,442,162,280
2020,1,A,골목상권,1000336,솔매로45길,65,32,33
2020,1,A,골목상권,1000335,솔매로41길,67,38,29
2020,1,A,골목상권,1000334,삼양로93길,209,94,115
2020,1,A,골목상권,1000333,삼양로77길,131,58,73
2020,1,A,골목상권,1000332,삼양로54길,295,66,229
2020,1,A,골목상권,1000331,삼양로41길,338,275,63
2020,1,A,골목상권,1000330,삼양로27길,7,4,3
2020,1,A,골목상권,1000329,삼양로24길,26,16,10
2020,1,A,골목상권,1000328,삼양로20길,179,168,11
2020,1,A,골목상권,1000327,삼각산로28길,70,33,37
2020,1,A,골목상권,1000326,도봉로99길,250,155,95
2020,1,A,골목상권,1000325,도봉로8길,6,4,2
2020,1,A,골목상권,1000324,도봉로76길,311,138,173
2020,1,A,골목상권,1000323,도봉로67길,116,57,59
2020,1,A,골목상권,1000322,도봉로45길,112,54,58
2020,1,A,골목상권,1000321,도봉로18길,225,182,43
2020,1,A,골목상권,1000320,도봉로13길,13,8,5
2020,1,A,골목상권,1000319,덕릉로41길,185,105,80
2020,1,A,골목상권,1000318,덕릉로40길,187,95,92
2020,1,A,골목상권,1000317,노해로33길,84,30,54
2020,1,A,골목상권,1000316,노해로23길,70,47,23
2020,1,A,골목상권,1000315,노해로17길,103,56,47
2020,1,A,골목상권,1000314,화랑로40길,71,46,25
2020,1,A,골목상권,1000313,화랑로32길,395,292,103
2020,1,A,골목상권,1000312,화랑로1길,1112,811,301
2020,1,A,골목상권,1000311,화랑로19길,43,19,24
2020,1,A,골목상권,1000310,화랑로14길,99,73,26
2020,1,A,골목상권,1000309,화랑로13길,267,95,172
2020,1,A,골목상권,1000308,한천로76길,132,100,32
2020,1,A,골목상권,1000307,한천로101가길,15,9,6
2020,1,A,골목상권,1000306,창경궁로43길,917,434,483
2020,1,A,골목상권,1000305,지봉로20길,3780,3162,618
2020,1,A,골목상권,1000304,종암로5길,404,201,203
2020,1,A,골목상권,1000303,종암로24가길,81,18,63
2020,1,A,골목상권,1000302,종암로21길,550,344,206
2020,1,A,골목상권,1000301,종암로19길,18269,9427,8842
2020,1,A,골목상권,1000300,종암로16길,140,61,79
2020,1,A,골목상권,1000299,정릉로8길,1407,1165,242
2020,1,A,골목상권,1000298,정릉로27길,75,30,45
2020,1,A,골목상권,1000297,정릉로26길,214,103,111
2020,1,A,골목상권,1000296,장위로50길,343,160,183
2020,1,A,골목상권,1000295,장월로1길,74,19,55
2020,1,A,골목상권,1000294,인촌로6길,195,131,64
2020,1,A,골목상권,1000293,인촌로5길,63,31,32
2020,1,A,골목상권,1000292,인촌로24길,1580,1010,570
2020,1,A,골목상권,1000291,개운사길,150,83,67
2020,1,A,골목상권,1000290,인촌로1길,127,78,49
2020,1,A,골목상권,1000289,인촌로17가길,90,48,42
2020,1,A,골목상권,1000288,오패산로4길,841,540,301
2020,1,A,골목상권,1000287,오패산로3길,310,187,123
2020,1,A,골목상권,1000286,오패산로19길,101,36,65
2020,1,A,골목상권,1000285,안암로5길,960,743,217
2020,1,A,골목상권,1000284,아리랑로4길,595,281,314
2020,1,A,골목상권,1000283,솔샘로6길,74,48,26
2020,1,A,골목상권,1000282,성북로8길,143,88,55
2020,1,A,골목상권,1000281,삼양로8길,147,70,77
2020,1,A,골목상권,1000280,삼선교로16가길,99,42,57
2020,1,A,골목상권,1000279,삼선교로10다길,38,17,21
2020,1,A,골목상권,1000278,삼선교로10길,186,110,76
2020,1,A,골목상권,1000277,보문로32길,267,128,139
2020,1,A,골목상권,1000276,보문로31길,253,128,125
2020,1,A,골목상권,1000275,보문로26길,134,62,72
2020,1,A,골목상권,1000274,보문로13길,1048,741,307
2020,1,A,골목상권,1000273,보국문로16길,181,97,84
2020,1,A,골목상권,1000272,동소문로6길,62,28,34
2020,1,A,골목상권,1000271,동소문로2길,53,21,32
2020,1,A,골목상권,1000270,동소문로26가길,219,122,97
2020,1,A,골목상권,1000269,동소문로15길,209,152,57
2020,1,A,골목상권,1000268,동소문로13길,572,285,287
2020,1,A,골목상권,1000267,돌곶이로8길,117,75,42
2020,1,A,골목상권,1000266,돌곶이로41길,40,13,27
2020,1,A,골목상권,1000265,돌곶이로28길,222,96,126
2020,1,A,골목상권,1000264,돌곶이로27길,103,59,44
2020,1,A,골목상권,1000263,돌곶이로22길,61,34,27
2020,1,A,골목상권,1000262,돌곶이로14길,77,58,19
2020,1,A,골목상권,1000261,길음로7길,14,5,9
2020,1,A,골목상권,1000260,중랑천로10길,207,109,98
2020,1,A,골목상권,1000259,용마산로94길,304,259,45
2020,1,A,골목상권,1000258,용마산로118길,108,63,45
2020,1,A,골목상권,1000257,용마산로112길,114,69,45
2020,1,A,골목상권,1000256,용마산로100길,122,52,70
2020,1,A,골목상권,1000255,신내로7가길,276,115,161
2020,1,A,골목상권,1000254,사가정로54길,122,47,75
2020,1,A,골목상권,1000253,사가정로42길,183,89,94
2020,1,A,골목상권,1000252,봉화산로56길,649,289,360
2020,1,A,골목상권,1000251,봉화산로4길,58,30,28
2020,1,A,골목상권,1000250,봉화산로30길,139,38,101
2020,1,A,골목상권,1000249,봉우재로33길,150,59,91
2020,1,A,골목상권,1000248,면목로78길,93,44,49
2020,1,A,골목상권,1000247,면목로56길,91,53,38
2020,1,A,골목상권,1000246,면목로55길,473,306,167
2020,1,A,골목상권,1000245,면목로49길,109,67,42
2020,1,A,골목상권,1000244,면목로48길,873,544,329
2020,1,A,골목상권,1000243,면목로45길,454,364,90
2020,1,A,골목상권,1000242,면목로33길,86,28,58
2020,1,A,골목상권,1000241,면목로21길,54,37,17
2020,1,A,골목상권,1000240,망우로73길,51,34,17
2020,1,A,골목상권,1000239,망우로68길,107,44,63
2020,1,A,골목상권,1000238,동일로163길,112,67,45
2020,1,A,골목상권,1000237,동일로157길,443,270,173
2020,1,A,골목상권,1000236,동일로149길,870,749,121
2020,1,A,골목상권,1000235,동일로140길,432,314,118
2020,1,A,골목상권,1000234,동일로139길,77,53,24
2020,1,A,골목상권,1000233,동일로139가길,187,81,106
2020,1,A,골목상권,1000232,동일로130길,130,99,31
2020,1,A,골목상권,1000231,동일로123길,145,74,71
2020,1,A,골목상권,1000230,동일로112길,193,120,73
2020,1,A,골목상권,1000229,동일로101길,202,58,144
2020,1,A,골목상권,1000228,동일로100길,328,240,88
2020,1,A,골목상권,1000227,답십리로75길,57,33,24
2020,1,A,골목상권,1000226,공릉로2길,148,69,79
2020,1,A,골목상권,1000225,공릉로12가길,75,50,25
2020,1,A,골목상권,1000224,겸재로54길,131,79,52
2020,1,A,골목상권,1000223,겸재로36길,134,60,74
2020,1,A,골목상권,1000222,겸재로29길,126,74,52
2020,1,A,골목상권,1000221,휘경로3길,127,69,58
2020,1,A,골목상권,1000220,휘경로2길,138,88,50
2020,1,A,골목상권,1000219,휘경로23길,89,56,33
2020,1,A,골목상권,1000218,휘경로14길,113,41,72
2020,1,A,골목상권,1000217,한천로46길,257,101,156
2020,1,A,골목상권,1000216,한천로40길,90,57,33
2020,1,A,골목상권,1000215,한천로33길,203,76,127
2020,1,A,골목상권,1000214,한천로14길,696,440,256
2020,1,A,골목상권,1000213,천호대로97길,878,590,288
2020,1,A,골목상권,1000212,천호대로77길,169,111,58
2020,1,A,골목상권,1000211,천호대로45길,47,38,9
2020,1,A,골목상권,1000210,천호대로17길,2512,1893,619
2020,1,A,골목상권,1000209,천호대로12길,55,35,20
2020,1,A,골목상권,1000208,천장산로7길,74,32,42
2020,1,A,골목상권,1000207,제기로5길,45,39,6
2020,1,A,골목상권,1000206,제기로21길,101,62,39
2020,1,A,골목상권,1000205,전농로4길,274,210,64
2020,1,A,골목상권,1000204,전농로3길,170,120,50
2020,1,A,골목상권,1000203,전농로29길,461,336,125
2020,1,A,골목상권,1000202,장한로8길,438,295,143
2020,1,A,골목상권,1000201,장한로5길,314,189,125
2020,1,A,골목상권,1000200,장한로27길,167,119,48
2020,1,A,골목상권,1000199,장한로27가길,148,81,67
2020,1,A,골목상권,1000198,장한로26길,2436,1696,740
2020,1,A,골목상권,1000197,장한로26가길,122,87,35
2020,1,A,골목상권,1000196,장한로25길,408,210,198
2020,1,A,골목상권,1000195,장한로14길,179,98,81
2020,1,A,골목상권,1000194,이문로42길,48,29,19
2020,1,A,골목상권,1000193,왕산로43길,560,199,361
2020,1,A,골목상권,1000192,왕산로33길,72,30,42
2020,1,A,골목상권,1000191,왕산로32길,129,64,65
2020,1,A,골목상권,1000190,약령시로17길,109,77,32
2020,1,A,골목상권,1000189,서울시립대로4길,404,264,140
2020,1,A,골목상권,1000188,서울시립대로29길,368,263,105
2020,1,A,골목상권,1000187,서울시립대로16길,42,14,28
2020,1,A,골목상권,1000186,사가정로2길,268,177,91
2020,1,A,골목상권,1000185,사가정로23가길,84,46,38
2020,1,A,골목상권,1000184,사가정로13길,180,65,115
2020,1,A,골목상권,1000183,무학로45길,227,141,86
2020,1,A,골목상권,1000182,무학로16길,574,441,133
2020,1,A,골목상권,1000181,망우로21길,96,67,29
2020,1,A,골목상권,1000180,망우로18길,52,17,35
2020,1,A,골목상권,1000179,망우로18가길,114,75,39
2020,1,A,골목상권,1000178,답십리로72길,54,20,34
2020,1,A,골목상권,1000177,답십리로69길,533,270,263
2020,1,A,골목상권,1000176,답십리로68길,287,158,129
2020,1,A,골목상권,1000175,답십리로64길,103,73,30
2020,1,A,골목상권,1000174,답십리로63길,1747,1051,696
2020,1,A,골목상권,1000173,답십리로60길,341,213,128
2020,1,A,골목상권,1000172,답십리로56길,78,39,39
2020,1,A,골목상권,1000171,답십리로23길,47,22,25
2020,1,A,골목상권,1000170,난계로30길,4980,2233,2747
2020,1,A,골목상권,1000169,경희대로4길,41,18,23
2020,1,A,골목상권,1000168,경희대로3길,28,16,12
2020,1,A,골목상권,1000167,천호대로129길,344,207,137
2020,1,A,골목상권,1000166,천호대로123길,625,282,343
2020,1,A,골목상권,1000165,천호대로109길,915,504,411
2020,1,A,골목상권,1000164,자양번영로3길,587,462,125
2020,1,A,골목상권,1000163,자양로53길,170,120,50
2020,1,A,골목상권,1000162,자양로50길,218,121,97
2020,1,A,골목상권,1000161,자양로45길,448,184,264
2020,1,A,골목상권,1000160,자양로26길,141,91,50
2020,1,A,골목상권,1000159,자양로15길,106,45,61
2020,1,A,골목상권,1000158,자양로11길,646,250,396
2020,1,A,골목상권,1000157,용마산로3길,541,431,110
2020,1,A,골목상권,1000156,용마산로21길,396,253,143
2020,1,A,골목상권,1000155,아차산로78길,575,421,154
2020,1,A,골목상권,1000154,아차산로65길,357,214,143
2020,1,A,골목상권,1000153,아차산로55길,243,150,93
2020,1,A,골목상권,1000152,아차산로51길,432,110,322
2020,1,A,골목상권,1000151,아차산로40길,357,207,150
2020,1,A,골목상권,1000150,면목로17길,230,138,92
2020,1,A,골목상권,1000149,뚝섬로64길,239,127,112
2020,1,A,골목상권,1000148,뚝섬로58길,278,141,137
2020,1,A,골목상권,1000147,뚝섬로54길,948,798,150
2020,1,A,골목상권,1000146,뚝섬로48길,228,134,94
2020,1,A,골목상권,1000145,뚝섬로24길,111,66,45
2020,1,A,골목상권,1000144,뚝섬로23길,209,148,61
2020,1,A,골목상권,1000143,동일로24길,42,32,10
2020,1,A,골목상권,1000142,동일로18길,79,54,25
2020,1,A,골목상권,1000141,능동로4길,947,834,113
2020,1,A,골목상권,1000140,능동로3길,71,45,26
2020,1,A,골목상권,1000139,능동로34길,1018,676,342
2020,1,A,골목상권,1000138,능동로19길,133,77,56
2020,1,A,골목상권,1000137,능동로13길,221,109,112
2020,1,A,골목상권,1000136,긴고랑로9길,138,51,87
2020,1,A,골목상권,1000135,긴고랑로8길,947,573,374
2020,1,A,골목상권,1000134,긴고랑로7길,460,353,107
2020,1,A,골목상권,1000133,긴고랑로20길,174,98,76
2020,1,A,골목상권,1000132,광나루로52길,649,395,254
2020,1,A,골목상권,1000131,광나루로40길,242,128,114
2020,1,A,골목상권,1000130,광나루로37길,60,29,31
2020,1,A,골목상권,1000129,광나루로36길,412,169,243
2020,1,A,골목상권,1000128,광나루로24길,25,12,13
2020,1,A,골목상권,1000127,광나루로12길,60,19,41
2020,1,A,골목상권,1000126,한림말길,355,174,181
2020,1,A,골목상권,1000125,한림말3길,3329,1128,2201
2020,1,A,골목상권,1000124,청계천로10나길,4951,3728,1223
2020,1,A,골목상권,1000123,장터길,90,46,44
2020,1,A,골목상권,1000122,용답중앙길,93,66,27
2020,1,A,골목상권,1000121,용답29길,537,360,177
2020,1,A,골목상권,1000120,왕십리로6길,538,350,188
2020,1,A,골목상권,1000119,왕십리로31길,208,95,113
2020,1,A,골목상권,1000118,왕십리로26길,2076,1357,719
2020,1,A,골목상권,1000117,왕십리로21길,164,77,87
2020,1,A,골목상권,1000116,왕십리로14길,997,776,221
2020,1,A,골목상권,1000115,아차산로5길,1871,1041,830
2020,1,A,골목상권,1000114,아차산로15길,3361,2374,987
2020,1,A,골목상권,1000113,아차산로11길,3213,2213,1000
2020,1,A,골목상권,1000112,송정4가길,291,123,168
2020,1,A,골목상권,1000111,송정12라길,94,48,46
2020,1,A,골목상권,1000110,성수일로6길,1342,928,414
2020,1,A,골목상권,1000109,성수이로7길,1442,895,547
2020,1,A,골목상권,1000108,성수이로18길,2988,1968,1020
2020,1,A,골목상권,1000107,성덕정길,227,152,75
2020,1,A,골목상권,1000106,성덕정17길,393,244,149
2020,1,A,골목상권,1000105,서울숲2길,335,196,139
2020,1,A,골목상권,1000104,상원길,1919,1334,585
2020,1,A,골목상권,1000103,상원12길,398,238,160
2020,1,A,골목상권,1000102,사근동길,78,48,30
2020,1,A,골목상권,1000101,무학봉길,22,11,11
2020,1,A,골목상권,1000100,무학봉28길,143,69,74
2020,1,A,골목상권,1000099,무학로6길,1897,382,1515
2020,1,A,골목상권,1000098,무수막길,164,122,42
2020,1,A,골목상권,1000097,매봉길,60,30,30
2020,1,A,골목상권,1000096,마조로1길,30,14,16
2020,1,A,골목상권,1000095,마조로16길,155,93,62
2020,1,A,골목상권,1000094,마장로39길,443,258,185
2020,1,A,골목상권,1000093,마장로27길,197,92,105
2020,1,A,골목상권,1000092,뚝섬로5길,2136,1426,710
2020,1,A,골목상권,1000091,둘레9길,419,255,164
2020,1,A,골목상권,1000090,금호산길,159,83,76
2020,1,A,골목상권,1000089,금호산2길,22,12,10
2020,1,A,골목상권,1000088,고산자로6길,704,495,209
2020,1,A,골목상권,1000087,후암로28길,582,313,269
2020,1,A,골목상권,1000086,효창원로39길,163,87,76
2020,1,A,골목상권,1000085,회나무로13길,90,45,45
2020,1,A,골목상권,1000084,한남대로20길,231,131,100
2020,1,A,골목상권,1000083,한강대로88길,224,138,86
2020,1,A,골목상권,1000082,한강대로7길,722,462,260
2020,1,A,골목상권,1000081,한강대로62길,1047,535,512
2020,1,A,골목상권,1000080,한강대로52길,8713,2847,5866
2020,1,A,골목상권,1000079,한강대로43길,1841,1074,767
2020,1,A,골목상권,1000078,한강대로15길,774,417,357
2020,1,A,골목상권,1000077,한강대로104길,8152,1754,6398
2020,1,A,골목상권,1000076,청파로73길,248,128,120
2020,1,A,골목상권,1000075,청파로71길,1317,727,590
2020,1,A,골목상권,1000074,청파로47나길,259,176,83
2020,1,A,골목상권,1000073,청파로47길,192,87,105
2020,1,A,골목상권,1000072,장문로45길,242,106,136
2020,1,A,골목상권,1000071,이태원로54길,812,552,260
2020,1,A,골목상권,1000070,이태원로27길,567,430,137
2020,1,A,골목상권,1000069,이촌로22길,385,307,78
2020,1,A,골목상권,1000068,원효로89길,1387,969,418
2020,1,A,골목상권,1000067,원효로53길,341,222,119
2020,1,A,골목상권,1000066,원효로41길,243,153,90
2020,1,A,골목상권,1000065,원효로19길,609,435,174
2020,1,A,골목상권,1000064,우사단로4길,308,143,165
2020,1,A,골목상권,1000063,우사단로14길,1987,984,1003
2020,1,A,골목상권,1000062,우사단로10길,570,508,62
2020,1,A,골목상권,1000061,신흥로20길,178,118,60
2020,1,A,골목상권,1000060,소월로20길,151,76,75
2020,1,A,골목상권,1000059,서빙고로71길,432,265,167
2020,1,A,골목상권,1000058,백범로90길,535,288,247
2020,1,A,골목상권,1000057,백범로79길,899,560,339
2020,1,A,골목상권,1000056,두텁바위로1길,1111,483,628
2020,1,A,골목상권,1000055,대사관로34길,606,393,213
2020,1,A,골목상권,1000054,녹사평대로46길,43,19,24
2020,1,A,골목상권,1000053,녹사평대로40나길,46,21,25
2020,1,A,골목상권,1000052,녹사평대로32길,56,31,25
2020,1,A,골목상권,1000051,녹사평대로26길,494,230,264
2020,1,A,골목상권,1000050,녹사평대로11길,107,78,29
2020,1,A,골목상권,1000049,퇴계로90길,463,225,238
2020,1,A,골목상권,1000048,퇴계로8길,438,246,192
2020,1,A,골목상권,1000047,퇴계로56길,569,424,145
2020,1,A,골목상권,1000046,퇴계로46길,1098,613,485
2020,1,A,골목상권,1000045,퇴계로18길,967,435,532
2020,1,A,골목상권,1000044,퇴계로12길,180,103,77
2020,1,A,골목상권,1000043,청구로1길,108,72,36
2020,1,A,골목상권,1000042,청구로17길,485,306,179
2020,1,A,골목상권,1000041,장충단로8길,3778,1997,1781
2020,1,A,골목상권,1000040,삼일대로4길,1571,1113,458
2020,1,A,골목상권,1000039,명동길,7830,4550,3280
2020,1,A,골목상권,1000038,동호로8길,386,160,226
2020,1,A,골목상권,1000037,동호로20길,2429,1304,1125
2020,1,A,골목상권,1000036,동호로15길,1161,835,326
2020,1,A,골목상권,1000035,동호로11길,337,208,129
2020,1,A,골목상권,1000034,동호로10길,1553,857,696
2020,1,A,골목상권,1000033,다산로39길,39,19,20
2020,1,A,골목상권,1000032,다산로38길,674,311,363
2020,1,A,골목상권,1000031,다산로36길,91,55,36
2020,1,A,골목상권,1000030,다산로33길,320,201,119
2020,1,A,골목상권,1000029,난계로21길,128,93,35
2020,1,A,골목상권,1000028,난계로11길,255,170,85
2020,1,A,골목상권,1000027,필운대로1길,202,62,140
2020,1,A,골목상권,1000026,평창길,6654,2605,4049
2020,1,A,골목상권,1000025,통일로12길,13,6,7
2020,1,A,골목상권,1000024,창신길,146,29,117
2020,1,A,골목상권,1000023,창신5길,15,7,8
2020,1,A,골목상권,1000022,창신2길,56,26,30
2020,1,A,골목상권,1000021,창경궁로35길,787,171,616
2020,1,A,골목상권,1000020,지봉로8길,183,90,93
2020,1,A,골목상권,1000019,종로65길,275,157,118
2020,1,A,골목상권,1000018,종로58가길,137,71,66
2020,1,A,골목상권,1000017,종로24길,1011,716,295
2020,1,A,골목상권,1000016,자하문로7길,214,83,131
2020,1,A,골목상권,1000015,이화장길,497,221,276
2020,1,A,골목상권,1000014,율곡로16길,235,143,92
2020,1,A,골목상권,1000013,율곡로10길,313,206,107
2020,1,A,골목상권,1000012,옥인길,58,32,26
2020,1,A,골목상권,1000011,숭인동길,329,133,196
2020,1,A,골목상권,1000010,성균관로5길,148,84,64
2020,1,A,골목상권,1000009,삼청로5길,2703,2626,77
2020,1,A,골목상권,1000008,북촌로5나길,234,113,121
2020,1,A,골목상권,1000007,북촌로5길,503,419,84
2020,1,A,골목상권,1000006,북촌로11길,671,232,439
2020,1,A,골목상권,1000005,백석동길,1797,1066,731
2020,1,A,골목상권,1000004,명륜길,56,32,24
2020,1,A,골목상권,1000003,돈화문로11가길,3686,2700,986
2020,1,A,골목상권,1000002,난계로27길,201,114,87
2020,1,A,골목상권,1000001,계동길,842,388,454
2019,4,U,관광특구,1001496,강남 마이스 관광특구,15904,8904,7000
2019,4,U,관광특구,1001495,잠실 관광특구,24375,14199,10176
2019,4,U,관광특구,1001494,종로?청계 관광특구,32935,17150,15785
2019,4,U,관광특구,1001493,동대문패션타운 관광특구,6054,2958,3096
2019,4,U,관광특구,1001492,명동 남대문 북창동 다동 무교동 관광특구,104830,53674,51156
2019,4,U,관광특구,1001491,이태원 관광특구,5839,3064,2775
2019,4,R,전통시장,1001490,길동복조리시장,430,242,188
2019,4,R,전통시장,1001489,둔촌역전통시장,224,108,116
2019,4,R,전통시장,1001488,성내골목시장,30,18,12
2019,4,R,전통시장,1001487,천호시장,35,19,16
2019,4,R,전통시장,1001486,동서울시장,5,3,2
2019,4,R,전통시장,1001484,양지골목시장,60,36,24
2019,4,R,전통시장,1001483,암사종합시장,95,53,42
2019,4,R,전통시장,1001482,고덕전통시장,935,850,85
2019,4,R,전통시장,1001481,명일골목시장,89,30,59
2019,4,R,전통시장,1001480,새마을시장,208,122,86
2019,4,R,전통시장,1001479,석촌시장,286,99,187
2019,4,R,전통시장,1001478,방이시장,3469,1526,1943
2019,4,R,전통시장,1001477,마천시장,102,70,32
2019,4,R,전통시장,1001476,풍납시장,51,20,31
2019,4,R,전통시장,1001475,강남개포시장,138,84,54
2019,4,R,전통시장,1001474,도곡시장,57,25,32
2019,4,R,전통시장,1001473,청담삼익시장,48,30,18
2019,4,R,전통시장,1001472,논현종합시장,85,43,42
2019,4,R,전통시장,1001471,영동전통시장,242,95,147
2019,4,R,전통시장,1001470,강남시장_강남,58,33,25
2019,4,R,전통시장,1001469,양재시장,35,22,13
2019,4,R,전통시장,1001468,남부종합시장,85,63,22
2019,4,R,전통시장,1001467,우림시장,1,0,1
2019,4,R,전통시장,1001466,미성동도깨비시장,75,16,59
2019,4,R,전통시장,1001463,신림중앙시장,43,27,16
2019,4,R,전통시장,1001462,강남골목시장,168,124,44
2019,4,R,전통시장,1001461,신림종합시장,8,7,1
2019,4,R,전통시장,1001460,관악신사시장,120,63,57
2019,4,R,전통시장,1001459,신원시장,42,21,21
2019,4,R,전통시장,1001458,인헌시장,122,46,76
2019,4,R,전통시장,1001457,봉천중앙시장,154,42,112
2019,4,R,전통시장,1001455,봉일시장,44,23,21
2019,4,R,전통시장,1001454,봉천제일종합시장,6,1,5
2019,4,R,전통시장,1001453,낙성대시장,10,6,4
2019,4,R,전통시장,1001452,중부시장,102,40,62
2019,4,R,전통시장,1001451,사당시장,45,20,25
2019,4,R,전통시장,1001450,남성역골목시장,467,268,199
2019,4,R,전통시장,1001449,남성사계시장,136,59,77
2019,4,R,전통시장,1001448,흑석시장,78,31,47
2019,4,R,전통시장,1001447,상도4동도깨비골목시장,95,49,46
2019,4,R,전통시장,1001446,성대시장,141,55,86
2019,4,R,전통시장,1001445,영도시장,73,6,67
2019,4,R,전통시장,1001444,상도전통시장,239,104,135
2019,4,R,전통시장,1001442,신노량진시장,11,3,8
2019,4,R,전통시장,1001441,본동인정시장,59,41,18
2019,4,R,전통시장,1001440,노량진중앙시장,244,157,87
2019,4,R,전통시장,1001439,대림중앙시장,42,29,13
2019,4,R,전통시장,1001438,우리시장,6,5,1
2019,4,R,전통시장,1001436,사러가시장,57,35,22
2019,4,R,전통시장,1001435,대신시장,12,9,3
2019,4,R,전통시장,1001433,영일시장,155,115,40
2019,4,R,전통시장,1001432,도림시장,6,4,2
2019,4,R,전통시장,1001431,영등포청과시장,23,17,6
2019,4,R,전통시장,1001430,영등포전통시장,2127,1061,1066
2019,4,R,전통시장,1001429,은행나무시장,67,40,27
2019,4,R,전통시장,1001428,박미시장,39,26,13
2019,4,R,전통시장,1001427,현대시장,139,42,97
2019,4,R,전통시장,1001426,대명시장,28,11,17
2019,4,R,전통시장,1001425,푸른터시장,3,2,1
2019,4,R,전통시장,1001424,남문시장,76,47,29
2019,4,R,전통시장,1001423,독산동 우시장,611,476,135
2019,4,R,전통시장,1001422,오류시장,132,21,111
2019,4,R,전통시장,1001421,개봉중앙시장,10,7,3
2019,4,R,전통시장,1001420,고척근린시장,55,19,36
2019,4,R,전통시장,1001418,남구로시장,236,135,101
2019,4,R,전통시장,1001417,구로시장,10,5,5
2019,4,R,전통시장,1001415,방신전통시장,116,81,35
2019,4,R,전통시장,1001414,송화골목시장,119,44,75
2019,4,R,전통시장,1001413,까치산시장,114,35,79
2019,4,R,전통시장,1001412,화곡본동시장,36,16,20
2019,4,R,전통시장,1001411,남부골목시장,156,58,98
2019,4,R,전통시장,1001410,대원종합시장,9,7,2
2019,4,R,전통시장,1001409,화곡중앙골목시장,75,32,43
2019,4,R,전통시장,1001408,신월중앙시장,118,53,65
2019,4,R,전통시장,1001406,신정3동골목시장,123,81,42
2019,4,R,전통시장,1001405,신정2동골목시장,41,13,28
2019,4,R,전통시장,1001404,신정제일시장,38,21,17
2019,4,R,전통시장,1001403,신월7동골목시장,24,16,8
2019,4,R,전통시장,1001402,신월6동골목시장,141,103,38
2019,4,R,전통시장,1001400,신월3동골목시장,12,7,5
2019,4,R,전통시장,1001399,경창시장,53,23,30
2019,4,R,전통시장,1001398,월정로시장,61,42,19
2019,4,R,전통시장,1001397,신영시장,40,13,27
2019,4,R,전통시장,1001396,목4동시장,52,35,17
2019,4,R,전통시장,1001395,목3동시장,148,67,81
2019,4,R,전통시장,1001394,목2동시장,432,251,181
2019,4,R,전통시장,1001393,마포농수산물시장,77,40,37
2019,4,R,전통시장,1001392,동진시장,10,6,4
2019,4,R,전통시장,1001391,망원월드컵시장,190,123,67
2019,4,R,전통시장,1001390,망원시장,173,81,92
2019,4,R,전통시장,1001388,영진시장,29,14,15
2019,4,R,전통시장,1001387,서교시장,24,10,14
2019,4,R,전통시장,1001386,신수시장,34,19,15
2019,4,R,전통시장,1001385,아현시장,803,430,373
2019,4,R,전통시장,1001384,마포시장,11,3,8
2019,4,R,전통시장,1001383,공덕시장,3948,2001,1947
2019,4,R,전통시장,1001382,백련시장,5,3,2
2019,4,R,전통시장,1001381,모래내시장,14,9,5
2019,4,R,전통시장,1001380,포방터시장,35,23,12
2019,4,R,전통시장,1001379,인왕시장,44,7,37
2019,4,R,전통시장,1001378,아현가구거리상점가,45,22,23
2019,4,R,전통시장,1001377,영천시장,35,19,16
2019,4,R,전통시장,1001376,수일시장,7,2,5
2019,4,R,전통시장,1001375,증산종합시장,8,5,3
2019,4,R,전통시장,1001374,대림골목시장,237,46,191
2019,4,R,전통시장,1001373,신응암시장,17,10,7
2019,4,R,전통시장,1001372,녹번시장,22,9,13
2019,4,R,전통시장,1001371,대조시장,15,7,8
2019,4,R,전통시장,1001370,역촌중앙시장,9,3,6
2019,4,R,전통시장,1001369,갈현시장,287,186,101
2019,4,R,전통시장,1001368,연서시장,206,144,62
2019,4,R,전통시장,1001367,상계중앙시장,105,59,46
2019,4,R,전통시장,1001366,상계시장,8,2,6
2019,4,R,전통시장,1001365,공릉동도깨비시장,98,47,51
2019,4,R,전통시장,1001364,방학동도깨비시장,39,16,23
2019,4,R,전통시장,1001363,쌍문역골목시장,61,14,47
2019,4,R,전통시장,1001362,백운시장,33,14,19
2019,4,R,전통시장,1001361,신도봉시장,5,5,0
2019,4,R,전통시장,1001360,창동골목시장,84,47,37
2019,4,R,전통시장,1001359,창동신창시장,104,40,64
2019,4,R,전통시장,1001358,수유북부시장,20,14,6
2019,4,R,전통시장,1001357,장미원골목시장,911,571,340
2019,4,R,전통시장,1001356,수유중앙시장,13,8,5
2019,4,R,전통시장,1001355,강북종합시장,23,9,14
2019,4,R,전통시장,1001354,우이시장,69,61,8
2019,4,R,전통시장,1001353,수유전통시장,231,55,176
2019,4,R,전통시장,1001352,번동북부골목시장,50,25,25
2019,4,R,전통시장,1001351,솔샘시장,73,30,43
2019,4,R,전통시장,1001350,숭인시장,62,27,35
2019,4,R,전통시장,1001349,방천골목시장,92,55,37
2019,4,R,전통시장,1001348,동북시장,121,49,72
2019,4,R,전통시장,1001347,석관황금시장,191,157,34
2019,4,R,전통시장,1001345,새석관시장,3,1,2
2019,4,R,전통시장,1001343,장위전통시장,40,20,20
2019,4,R,전통시장,1001342,밤나무골시장,17,5,12
2019,4,R,전통시장,1001341,길음시장,91,19,72
2019,4,R,전통시장,1001340,정릉시장,131,72,59
2019,4,R,전통시장,1001339,정릉아리랑시장,22,7,15
2019,4,R,전통시장,1001338,돈암제일시장,97,22,75
2019,4,R,전통시장,1001337,유영시장,31,20,11
2019,4,R,전통시장,1001336,우림골목시장,344,118,226
2019,4,R,전통시장,1001335,묵1동도깨비시장,35,24,11
2019,4,R,전통시장,1001334,태능시장,81,34,47
2019,4,R,전통시장,1001333,중화제일시장,69,30,39
2019,4,R,전통시장,1001332,사가정시장,86,28,58
2019,4,R,전통시장,1001331,면목골목시장,45,21,24
2019,4,R,전통시장,1001330,동원시장,224,109,115
2019,4,R,전통시장,1001329,동부골목시장,179,59,120
2019,4,R,전통시장,1001327,이경시장,16,8,8
2019,4,R,전통시장,1001326,회기시장,55,17,38
2019,4,R,전통시장,1001325,청량리청과물시장,12,9,3
2019,4,R,전통시장,1001324,전곡시장,77,42,35
2019,4,R,전통시장,1001323,답십리시장,93,40,53
2019,4,R,전통시장,1001322,동부시장,14,9,5
2019,4,R,전통시장,1001321,답십리현대시장,36,31,5
2019,4,R,전통시장,1001320,전농로터리시장,7,3,4
2019,4,R,전통시장,1001319,청량리종합시장,13,8,5
2019,4,R,전통시장,1001318,청량리전통시장,9,7,2
2019,4,R,전통시장,1001316,서울약령시장,1171,642,529
2019,4,R,전통시장,1001315,동서시장,5,3,2
2019,4,R,전통시장,1001314,경동시장,130,61,69
2019,4,R,전통시장,1001313,청량리수산시장,20,11,9
2019,4,R,전통시장,1001312,용두시장,4,2,2
2019,4,R,전통시장,1001309,조양시장,31,19,12
2019,4,R,전통시장,1001308,영동교골목시장,41,30,11
2019,4,R,전통시장,1001307,능동로골목시장,56,42,14
2019,4,R,전통시장,1001306,노룬산골목시장,23,13,10
2019,4,R,전통시장,1001305,자양종합시장,14,10,4
2019,4,R,전통시장,1001304,자양골목시장,54,36,18
2019,4,R,전통시장,1001303,신성골목시장,19,6,13
2019,4,R,전통시장,1001302,면곡골목시장,49,35,14
2019,4,R,전통시장,1001301,중곡제일시장,111,68,43
2019,4,R,전통시장,1001300,화양제일골목시장,43,11,32
2019,4,R,전통시장,1001299,한아름시장,40,29,11
2019,4,R,전통시장,1001298,성동용답상가시장,66,33,33
2019,4,R,전통시장,1001297,뚝도시장,45,17,28
2019,4,R,전통시장,1001296,금남시장,36,13,23
2019,4,R,전통시장,1001295,행당시장,314,140,174
2019,4,R,전통시장,1001294,마장축산물시장,532,358,174
2019,4,R,전통시장,1001293,보광시장,31,12,19
2019,4,R,전통시장,1001292,이태원제일시장,2,1,1
2019,4,R,전통시장,1001291,이태원시장,32,20,12
2019,4,R,전통시장,1001290,이촌종합시장,109,78,31
2019,4,R,전통시장,1001289,용문전통시장,19,10,9
2019,4,R,전통시장,1001288,만리시장,12,9,3
2019,4,R,전통시장,1001287,신흥시장,4,1,3
2019,4,R,전통시장,1001286,후암시장,15,14,1
2019,4,R,전통시장,1001285,합동(새벽)시장,365,209,156
2019,4,R,전통시장,1001284,서울중앙시장,451,320,131
2019,4,R,전통시장,1001283,백학시장,95,43,52
2019,4,R,전통시장,1001282,약수시장,271,105,166
2019,4,R,전통시장,1001281,청평화시장,120,50,70
2019,4,R,전통시장,1001280,제일평화시장,53,29,24
2019,4,R,전통시장,1001279,동평화시장,178,121,57
2019,4,R,전통시장,1001278,남평화시장,5,3,2
2019,4,R,전통시장,1001277,방산종합시장,1190,736,454
2019,4,R,전통시장,1001276,평화시장,906,614,292
2019,4,R,전통시장,1001275,인현시장,167,123,44
2019,4,R,전통시장,1001274,신중부시장,3089,921,2168
2019,4,R,전통시장,1001273,남대문시장,8186,3966,4220
2019,4,R,전통시장,1001272,신설종합시장,50,37,13
2019,4,R,전통시장,1001271,동묘시장,474,223,251
2019,4,R,전통시장,1001270,창신골목시장,13,7,6
2019,4,R,전통시장,1001269,동문시장,3,1,2
2019,4,R,전통시장,1001268,충신시장,77,40,37
2019,4,R,전통시장,1001267,종로신진시장,158,89,69
2019,4,R,전통시장,1001266,동대문종합시장,1319,965,354
2019,4,R,전통시장,1001265,광장시장,444,301,143
2019,4,R,전통시장,1001264,통인시장,59,29,30
2019,4,D,발달상권,1001263,서울 노원구 노원역_3,418,159,259
2019,4,D,발달상권,1001262,서울 노원구 노원역_2,274,126,148
2019,4,D,발달상권,1001261,서울 노원구 노원역_1,336,86,250
2019,4,D,발달상권,1001260,창동역,1003,570,433
2019,4,D,발달상권,1001259,서울 강북구 수유역_3,70,36,34
2019,4,D,발달상권,1001258,등나무근린공원 주변,65,19,46
2019,4,D,발달상권,1001257,서울 강북구 수유역_2,2284,1108,1176
2019,4,D,발달상권,1001256,서울 강북구 수유역_1,831,408,423
2019,4,D,발달상권,1001255,서울 은평구 연신내역_3,108,20,88
2019,4,D,발달상권,1001254,서울 은평구 연신내역_2,555,168,387
2019,4,D,발달상권,1001253,서울 은평구 연신내역_1,70,25,45
2019,4,D,발달상권,1001252,서울 성북구 미아삼거리역_2,322,144,178
2019,4,D,발달상권,1001251,서울 강북구 미아삼거리역_1,140,86,54
2019,4,D,발달상권,1001250,서울 은평구 불광역_3,67,24,43
2019,4,D,발달상권,1001249,서울 은평구 불광역_2,116,39,77
2019,4,D,발달상권,1001248,서울 은평구 불광역_1,180,73,107
2019,4,D,발달상권,1001247,미아사거리_2,102,47,55
2019,4,D,발달상권,1001246,미아사거리_1,210,68,142
2019,4,D,발달상권,1001245,서울 성북구 성신여대입구역,2865,1629,1236
2019,4,D,발달상권,1001244,경희대학교,70,24,46
2019,4,D,발달상권,1001243,서울 성북구 안암역,59,28,31
2019,4,D,발달상권,1001242,혜화역 대학로_3,477,210,267
2019,4,D,발달상권,1001241,혜화역 대학로_2,334,256,78
2019,4,D,발달상권,1001240,혜화역 대학로_1,1230,573,657
2019,4,D,발달상권,1001239,디지털미디어시티,6727,3880,2847
2019,4,D,발달상권,1001238,서울 동대문구 청량리역,776,413,363
2019,4,D,발달상권,1001237,서울 종로구 경복궁역_2,239,107,132
2019,4,D,발달상권,1001236,서울 종로구 안국역_2,810,409,401
2019,4,D,발달상권,1001235,서울 종로구 안국역_1,8804,7324,1480
2019,4,D,발달상권,1001234,서울 종로구 경복궁역_1,599,413,186
2019,4,D,발달상권,1001233,서울 종로구 종로3가역_3,2136,1442,694
2019,4,D,발달상권,1001232,서울 종로구 종로3가역_2,1823,948,875
2019,4,D,발달상권,1001231,서울 동대문구 신설동역_2,5440,2247,3193
2019,4,D,발달상권,1001230,인사동,26072,14829,11243
2019,4,D,발달상권,1001229,서울 종로구 종로5가역_4,1358,810,548
2019,4,D,발달상권,1001228,서울 종로구 종로5가역_3,1766,1160,606
2019,4,D,발달상권,1001227,종로구청,20709,10947,9762
2019,4,D,발달상권,1001226,서울 종로구 종로5가역_2,16173,10184,5989
2019,4,D,발달상권,1001225,신설동역,118,54,64
2019,4,D,발달상권,1001224,서울 동대문구 신설동역_1,1543,677,866
2019,4,D,발달상권,1001223,서울 종로구 광화문역_2,27999,17199,10800
2019,4,D,발달상권,1001222,동묘앞역,223,138,85
2019,4,D,발달상권,1001221,장안동사거리,1587,632,955
2019,4,D,발달상권,1001220,서울 종로구 동대문역_2,748,244,504
2019,4,D,발달상권,1001219,서울 종로구 동대문역_1,28,17,11
2019,4,D,발달상권,1001218,동대문시장_2,195,123,72
2019,4,D,발달상권,1001217,서울 종로구 종로5가역_1,22,9,13
2019,4,D,발달상권,1001216,서울 종로구 종로3가역_1,2657,1167,1490
2019,4,D,발달상권,1001215,서울 종로구 광화문역_1,12759,8498,4261
2019,4,D,발달상권,1001214,종각역,10396,8086,2310
2019,4,D,발달상권,1001213,종각역 젊음의 거리,13040,3576,9464
2019,4,D,발달상권,1001212,서대문구 서대문역_1,99,67,32
2019,4,D,발달상권,1001211,동대문시장_1,1663,493,1170
2019,4,D,발달상권,1001210,시청역_2,14646,9603,5043
2019,4,D,발달상권,1001209,서울시청,9257,4890,4367
2019,4,D,발달상권,1001208,서울 중구 을지로3가역_2,3181,2166,1015
2019,4,D,발달상권,1001207,서울 중구 신당역_2,939,534,405
2019,4,D,발달상권,1001206,서대문구 서대문역_2,1486,1018,468
2019,4,D,발달상권,1001205,동대문역사문화공원역,3166,2548,618
2019,4,D,발달상권,1001204,서울 중구 을지로3가역_1,4549,2258,2291
2019,4,D,발달상권,1001203,명동거리,8147,4244,3903
2019,4,D,발달상권,1001202,롯데백화점,27149,9657,17492
2019,4,D,발달상권,1001201,서울 중구 신당역_1,277,142,135
2019,4,D,발달상권,1001200,북창동,5197,3160,2037
2019,4,D,발달상권,1001199,서울 중구 충무로역_2,16329,7851,8478
2019,4,D,발달상권,1001198,서울 강서구 송정역,335,140,195
2019,4,D,발달상권,1001197,장한평역_2,1492,995,497
2019,4,D,발달상권,1001196,시청역_1,24904,15705,9199
2019,4,D,발달상권,1001195,왕십리역_2,233,102,131
2019,4,D,발달상권,1001194,서울 강서구 발산역,983,431,552
2019,4,D,발달상권,1001193,장한평역_1,1129,748,381
2019,4,D,발달상권,1001192,서울 중구 충무로역_1,3743,2160,1583
2019,4,D,발달상권,1001191,왕십리역_1,8,2,6
2019,4,D,발달상권,1001190,장한평역,3644,2178,1466
2019,4,D,발달상권,1001189,서울 중구 명동역,3595,1952,1643
2019,4,D,발달상권,1001188,장충동 족발거리,2100,985,1115
2019,4,D,발달상권,1001187,한양시장,55,30,25
2019,4,D,발달상권,1001186,서울 서대문구 이대역,380,160,220
2019,4,D,발달상권,1001185,서울 서대문구 신촌역,924,404,520
2019,4,D,발달상권,1001184,서울 마포구 홍대입구역_3,659,386,273
2019,4,D,발달상권,1001183,서울 마포구 홍대입구역_2,977,535,442
2019,4,D,발달상권,1001182,홍익대학교 주변,8725,5062,3663
2019,4,D,발달상권,1001181,서울 광진구 군자역,621,342,279
2019,4,D,발달상권,1001180,신촌역,4403,2012,2391
2019,4,D,발달상권,1001179,강서구청,4278,2468,1810
2019,4,D,발달상권,1001178,서울 마포구 홍대입구역_1,1618,826,792
2019,4,D,발달상권,1001177,서울 중구 약수역_2,210,91,119
2019,4,D,발달상권,1001176,서울 중구 약수역_1,24,6,18
2019,4,D,발달상권,1001175,서울 강동구 고덕역,1359,916,443
2019,4,D,발달상권,1001174,등촌역,64,37,27
2019,4,D,발달상권,1001173,서울 강동구 명일역,671,252,419
2019,4,D,발달상권,1001172,어린이대공원역,41,17,24
2019,4,D,발달상권,1001171,서울 마포구 공덕역_2,3697,2404,1293
2019,4,D,발달상권,1001170,공덕역,2092,1198,894
2019,4,D,발달상권,1001169,서울 용산구 숙대입구역,3807,1436,2371
2019,4,D,발달상권,1001168,남영역,4055,2796,1259
2019,4,D,발달상권,1001167,서울 마포구 공덕역_1,2420,796,1624
2019,4,D,발달상권,1001166,서울 마포구 마포역_2,10151,6130,4021
2019,4,D,발달상권,1001165,서울 광진구 건대입구역_2,529,268,261
2019,4,D,발달상권,1001164,서울 마포구 마포역_1,3369,2292,1077
2019,4,D,발달상권,1001163,서울 강동구 천호역_2,1208,565,643
2019,4,D,발달상권,1001162,서울 광진구 건대입구역_1,109,52,57
2019,4,D,발달상권,1001161,건대입구역,24,11,13
2019,4,D,발달상권,1001160,서울 광진구 구의역,928,584,344
2019,4,D,발달상권,1001159,서울 강동구 천호역,259,93,166
2019,4,D,발달상권,1001158,당산역_2,1429,1069,360
2019,4,D,발달상권,1001157,서울 강동구 천호역_1,138,57,81
2019,4,D,발달상권,1001156,서울 강동구 길동역,2628,1190,1438
2019,4,D,발달상권,1001155,용산 전자상가_5,1976,1461,515
2019,4,D,발달상권,1001154,용산 전자상가_4,248,182,66
2019,4,D,발달상권,1001153,당산역_1,310,186,124
2019,4,D,발달상권,1001152,서울 광진구 강변역,1337,859,478
2019,4,D,발달상권,1001151,용산 전자상가_3,1752,1311,441
2019,4,D,발달상권,1001150,서울 용산구 이태원역,452,292,160
2019,4,D,발달상권,1001149,한남오거리,823,524,299
2019,4,D,발달상권,1001148,목동사거리,41,13,28
2019,4,D,발달상권,1001147,용산 전자상가_2,392,317,75
2019,4,D,발달상권,1001146,용산구청,1526,755,771
2019,4,D,발달상권,1001145,용산 전자상가_1,3893,2851,1042
2019,4,D,발달상권,1001144,국회의사당역_2,19439,11619,7820
2019,4,D,발달상권,1001143,서울 용산구 신용산역,979,675,304
2019,4,D,발달상권,1001142,국회의사당역_1,4563,3517,1046
2019,4,D,발달상권,1001141,압구정 로데오거리_2,7107,2323,4784
2019,4,D,발달상권,1001140,서울 강남구 압구정역,9345,4345,5000
2019,4,D,발달상권,1001139,서울 영등포구 영등포구청역,449,275,174
2019,4,D,발달상권,1001138,압구정 로데오거리_1,14564,7168,7396
2019,4,D,발달상권,1001137,서울 강동구 둔촌동역,250,102,148
2019,4,D,발달상권,1001136,오목교역,125,72,53
2019,4,D,발달상권,1001135,신사동 가로수길,14671,7582,7089
2019,4,D,발달상권,1001134,서울 영등포구 여의도역_2,33585,23274,10311
2019,4,D,발달상권,1001133,청담사거리_3,1376,693,683
2019,4,D,발달상권,1001132,영등포유통상가,1504,962,542
2019,4,D,발달상권,1001131,청담역_2,4142,3212,930
2019,4,D,발달상권,1001130,청담역_1,4062,2913,1149
2019,4,D,발달상권,1001129,청담사거리_2,1289,759,530
2019,4,D,발달상권,1001128,청담사거리_1,529,295,234
2019,4,D,발달상권,1001127,서울 영등포구 여의도역_1,27015,17171,9844
2019,4,D,발달상권,1001126,서울 양천구 신정네거리역_2,28,18,10
2019,4,D,발달상권,1001125,학동사거리_2,2498,1332,1166
2019,4,D,발달상권,1001124,서울 영등포구 영등포시장역,411,246,165
2019,4,D,발달상권,1001123,학동사거리_1,4075,2555,1520
2019,4,D,발달상권,1001122,여의도 시범아파트앞,10435,6976,3459
2019,4,D,발달상권,1001121,영등포역_3,121,70,51
2019,4,D,발달상권,1001120,도산공원사거리_1,4075,1954,2121
2019,4,D,발달상권,1001119,영등포역_2,583,245,338
2019,4,D,발달상권,1001118,문래동 주민센터,6184,3312,2872
2019,4,D,발달상권,1001117,강남구 신사역_2,6953,3586,3367
2019,4,D,발달상권,1001116,영등포역_1,77,27,50
2019,4,D,발달상권,1001115,서울 강남구 강남구청역_2,3172,1916,1256
2019,4,D,발달상권,1001114,강남구 신사역_1,1108,570,538
2019,4,D,발달상권,1001113,서울 동작구 노량진1동_1,40,25,15
2019,4,D,발달상권,1001112,서울 강남구 학동역_3,3152,1780,1372
2019,4,D,발달상권,1001111,서울 강남구 강남구청역_1,3516,2335,1181
2019,4,D,발달상권,1001110,잠실역,42527,22605,19922
2019,4,D,발달상권,1001109,강남구 논현역_4,4927,2720,2207
2019,4,D,발달상권,1001108,학동역,1014,616,398
2019,4,D,발달상권,1001107,방이동 먹자골목,6881,4444,2437
2019,4,D,발달상권,1001106,서울 강남구 학동역_2,2510,1674,836
2019,4,D,발달상권,1001105,서울 동작구 노량진역,436,252,184
2019,4,D,발달상권,1001104,삼성역_3,52277,41226,11051
2019,4,D,발달상권,1001103,코엑스,15904,8904,7000
2019,4,D,발달상권,1001102,서울 강남구 학동역_1,1691,1037,654
2019,4,D,발달상권,1001101,선정릉역_2,3758,2684,1074
2019,4,D,발달상권,1001100,강남구 논현역_3,2466,700,1766
2019,4,D,발달상권,1001099,포스코사거리_2,16526,9641,6885
2019,4,D,발달상권,1001098,포스코사거리_1,22702,15610,7092
2019,4,D,발달상권,1001097,잠실역 롯데월드,2247,1185,1062
2019,4,D,발달상권,1001096,신도림역,1674,907,767
2019,4,D,발달상권,1001095,강남구 논현역_2,9009,5256,3753
2019,4,D,발달상권,1001094,선정릉역_1,2392,1492,900
2019,4,D,발달상권,1001093,신천역,4789,2992,1797
2019,4,D,발달상권,1001092,강남구 논현역_1,2284,1208,1076
2019,4,D,발달상권,1001091,삼성역_2,7062,3420,3642
2019,4,D,발달상권,1001090,삼정역_2,1162,721,441
2019,4,D,발달상권,1001089,삼정역_1,2277,1123,1154
2019,4,D,발달상권,1001088,삼성역_1,18695,12565,6130
2019,4,D,발달상권,1001087,서울 강남구 선릉역_2,40183,20392,19791
2019,4,D,발달상권,1001086,고속터미널역,2010,1612,398
2019,4,D,발달상권,1001085,서울 서초구 강남역,19954,10752,9202
2019,4,D,발달상권,1001084,서울 강남구 선릉역_1,21572,9107,12465
2019,4,D,발달상권,1001083,서울 송파구 석촌역_2,597,380,217
2019,4,D,발달상권,1001082,선릉역_2,26260,16412,9848
2019,4,D,발달상권,1001081,서울 강남구 역삼역_2,19179,15530,3649
2019,4,D,발달상권,1001080,서울 송파구 석촌역_1,168,96,72
2019,4,D,발달상권,1001079,석촌역,170,135,35
2019,4,D,발달상권,1001078,서울 강남구 강남역_2,9449,4629,4820
2019,4,D,발달상권,1001077,선릉역_1,16454,10830,5624
2019,4,D,발달상권,1001076,구로역,201,101,100
2019,4,D,발달상권,1001075,역삼역_2,10137,4381,5756
2019,4,D,발달상권,1001074,대림역_2,5179,3395,1784
2019,4,D,발달상권,1001073,서울 강남구 역삼역_1,22546,15049,7497
2019,4,D,발달상권,1001072,신대방삼거리역,259,129,130
2019,4,D,발달상권,1001071,서울 강남구 한티역,673,371,302
2019,4,D,발달상권,1001070,은마아파트입구사거리_4,570,252,318
2019,4,D,발달상권,1001069,은마아파트입구사거리_3,103,45,58
2019,4,D,발달상권,1001068,은마아파트입구사거리_2,15650,5160,10490
2019,4,D,발달상권,1001067,오류동역,2297,1736,561
2019,4,D,발달상권,1001066,서울 강남구 강남역,27566,14310,13256
2019,4,D,발달상권,1001065,은마아파트입구사거리_1,277,92,185
2019,4,D,발달상권,1001064,대림역_1,340,205,135
2019,4,D,발달상권,1001063,교대역_4,6267,3940,2327
2019,4,D,발달상권,1001062,서울 강남구 강남역_1,25938,14288,11650
2019,4,D,발달상권,1001061,방배동카페골목,374,218,156
2019,4,D,발달상권,1001059,교대역_3,1005,649,356
2019,4,D,발달상권,1001058,역삼역_1,10667,5507,5160
2019,4,D,발달상권,1001057,교대역_2,3971,2510,1461
2019,4,D,발달상권,1001056,서울 송파구 가락시장역,5421,3249,2172
2019,4,D,발달상권,1001055,서울 서초구 서초역,1858,988,870
2019,4,D,발달상권,1001054,서울 강남구 대치역_2,1139,629,510
2019,4,D,발달상권,1001053,서울 강남구 대치역_1,102,38,64
2019,4,D,발달상권,1001052,뱅뱅사거리_2,12301,8384,3917
2019,4,D,발달상권,1001051,보라매공원,2417,1455,962
2019,4,D,발달상권,1001050,교대역_1,17722,8352,9370
2019,4,D,발달상권,1001049,개봉동 현대아파트 인근,271,126,145
2019,4,D,발달상권,1001048,뱅뱅사거리,7114,4891,2223
2019,4,D,발달상권,1001047,뱅뱅사거리_1,4820,3658,1162
2019,4,D,발달상권,1001046,서울 관악구 신림역_4,332,165,167
2019,4,D,발달상권,1001045,동작구 총신대입구역_1,327,125,202
2019,4,D,발달상권,1001044,양재역_3,9025,5664,3361
2019,4,D,발달상권,1001043,동작구 총신대입구역_2,1633,741,892
2019,4,D,발달상권,1001042,서울 서초구 남부터미널역_3,3060,1217,1843
2019,4,D,발달상권,1001041,서울 강남구 수서역,12418,6339,6079
2019,4,D,발달상권,1001040,서울 관악구 신림역_3,77,20,57
2019,4,D,발달상권,1001039,서울 서초구 남부터미널역_2,3012,1965,1047
2019,4,D,발달상권,1001038,구로디지탈1단지,43655,28446,15209
2019,4,D,발달상권,1001037,양재역,904,474,430
2019,4,D,발달상권,1001036,문정역,88,52,36
2019,4,D,발달상권,1001035,매봉역,5760,4107,1653
2019,4,D,발달상권,1001034,서울 서초구 방배역,1690,910,780
2019,4,D,발달상권,1001033,서울 서초구 남부터미널역_1,2033,1323,710
2019,4,D,발달상권,1001032,서울 관악구 신림역_2,166,63,103
2019,4,D,발달상권,1001031,서울 관악구 신림역_1,615,316,299
2019,4,D,발달상권,1001030,양재역_2,2634,1725,909
2019,4,D,발달상권,1001029,양재역_1,515,305,210
2019,4,D,발달상권,1001028,서울 관악구 서울대입구역_2,57,28,29
2019,4,D,발달상권,1001027,가산디지털단지역_3,22935,14390,8545
2019,4,D,발달상권,1001026,구로디지털단지역,91,67,24
2019,4,D,발달상권,1001025,서울 관악구 서울대입구역_1,1502,797,705
2019,4,D,발달상권,1001024,관악구 사당역_1,5523,2253,3270
2019,4,D,발달상권,1001023,가산디지털단지역_2,25194,16241,8953
2019,4,D,발달상권,1001022,관악구 사당역_2,744,453,291
2019,4,D,발달상권,1001021,가산디지털단지역_1,18317,12138,6179
2019,4,D,발달상권,1001020,장지역,4411,3129,1282
2019,4,D,발달상권,1001019,포이사거리_1,192,141,51
2019,4,D,발달상권,1001018,포이사거리_2,7673,5359,2314
2019,4,D,발달상권,1001017,관악구 사당역_3,1538,1135,403
2019,4,D,발달상권,1001016,서울 관악구 대학동_1,662,558,104
2019,4,D,발달상권,1001015,서울 금천구 독산1동_1,716,485,231
2019,4,D,발달상권,1001014,양재동 꽃시장,1540,858,682
2019,4,D,발달상권,1001013,양재 화물트럭터미널앞_2,843,619,224
2019,4,D,발달상권,1001012,양재 화물트럭터미널앞_1,1944,1643,301
2019,4,D,발달상권,1001011,서울 금천구 시흥1동_4,486,164,322
2019,4,A,골목상권,1001010,풍성로37가길,128,57,71
2019,4,A,골목상권,1001009,천호옛길,420,288,132
2019,4,A,골목상권,1001008,천호옛14길,177,93,84
2019,4,A,골목상권,1001007,천호대로219길,486,338,148
2019,4,A,골목상권,1001006,천호대로197길,239,168,71
2019,4,A,골목상권,1001005,천호대로187길,371,200,171
2019,4,A,골목상권,1001004,천호대로170길,303,177,126
2019,4,A,골목상권,1001003,천호대로162길,286,149,137
2019,4,A,골목상권,1001002,천중로51길,761,536,225
2019,4,A,골목상권,1001001,천중로39길,574,375,199
2019,4,A,골목상권,1001000,진황도로47길,131,63,68
2019,4,A,골목상권,1000999,진황도로27길,298,174,124
2019,4,A,골목상권,1000998,올림픽로98길,257,169,88
2019,4,A,골목상권,1000997,올림픽로80길,152,54,98
2019,4,A,골목상권,1000996,올림픽로78길,115,58,57
2019,4,A,골목상권,1000995,올림픽로77길,210,114,96
2019,4,A,골목상권,1000994,올림픽로71길,184,101,83
2019,4,A,골목상권,1000993,올림픽로48길,1847,1272,575
2019,4,A,골목상권,1000992,양재대로96길,197,131,66
2019,4,A,골목상권,1000991,양재대로95길,602,324,278
2019,4,A,골목상권,1000990,양재대로91길,358,230,128
2019,4,A,골목상권,1000989,양재대로133길,189,122,67
2019,4,A,골목상권,1000988,양재대로124길,435,258,177
2019,4,A,골목상권,1000987,양재대로116길,75,41,34
2019,4,A,골목상권,1000986,양재대로101길,677,313,364
2019,4,A,골목상권,1000985,암사길,112,70,42
2019,4,A,골목상권,1000984,성안로3길,5508,4242,1266
2019,4,A,골목상권,1000983,성내로5길,1005,650,355
2019,4,A,골목상권,1000982,상일로5길,172,124,48
2019,4,A,골목상권,1000981,상암로5길,271,99,172
2019,4,A,골목상권,1000980,상암로51길,302,122,180
2019,4,A,골목상권,1000979,상암로4길,232,147,85
2019,4,A,골목상권,1000978,상암로14길,432,261,171
2019,4,A,골목상권,1000977,명일로13길,302,182,120
2019,4,A,골목상권,1000976,동남로85길,635,344,291
2019,4,A,골목상권,1000975,동남로82길,108,64,44
2019,4,A,골목상권,1000974,동남로65길,297,202,95
2019,4,A,골목상권,1000973,구천면로42길,87,52,35
2019,4,A,골목상권,1000972,구천면로41길,442,228,214
2019,4,A,골목상권,1000971,구천면로36길,32,14,18
2019,4,A,골목상권,1000970,고덕로61길,137,93,44
2019,4,A,골목상권,1000969,고덕로25길,143,91,52
2019,4,A,골목상권,1000968,고덕로10길,738,335,403
2019,4,A,골목상권,1000967,강동대로53길,1092,726,366
2019,4,A,골목상권,1000966,풍성로25길,84,43,41
2019,4,A,골목상권,1000965,오금로46길,711,359,352
2019,4,A,골목상권,1000964,오금로36길,1133,803,330
2019,4,A,골목상권,1000963,오금로11길,1427,884,543
2019,4,A,골목상권,1000962,양재대로72길,245,124,121
2019,4,A,골목상권,1000961,양재대로71길,1999,1458,541
2019,4,A,골목상권,1000960,양재대로64길,1212,705,507
2019,4,A,골목상권,1000959,양재대로62길,3230,2137,1093
2019,4,A,골목상권,1000958,송파대로30길,2240,1393,847
2019,4,A,골목상권,1000957,송이로36길,2096,1409,687
2019,4,A,골목상권,1000956,송이로32길,1295,733,562
2019,4,A,골목상권,1000955,송이로23길,1850,1269,581
2019,4,A,골목상권,1000954,삼전로13길,1420,916,504
2019,4,A,골목상권,1000953,백제고분로50길,1209,796,413
2019,4,A,골목상권,1000952,백제고분로46길,665,472,193
2019,4,A,골목상권,1000951,백제고분로45길,1349,869,480
2019,4,A,골목상권,1000950,백제고분로42길,590,289,301
2019,4,A,골목상권,1000949,백제고분로39길,566,393,173
2019,4,A,골목상권,1000948,백제고분로34길,1779,1368,411
2019,4,A,골목상권,1000947,백제고분로33길,921,574,347
2019,4,A,골목상권,1000946,백제고분로32길,725,407,318
2019,4,A,골목상권,1000945,백제고분로31길,1708,1370,338
2019,4,A,골목상권,1000944,백제고분로22길,1371,955,416
2019,4,A,골목상권,1000943,백제고분로21길,483,309,174
2019,4,A,골목상권,1000942,마천로51길,417,245,172
2019,4,A,골목상권,1000941,동남로20길,2463,1773,690
2019,4,A,골목상권,1000940,거마로20길,503,229,274
2019,4,A,골목상권,1000939,학동로77길,1851,1119,732
2019,4,A,골목상권,1000938,학동로6길,1447,977,470
2019,4,A,골목상권,1000937,학동로56길,2421,1533,888
2019,4,A,골목상권,1000936,학동로38길,1862,891,971
2019,4,A,골목상권,1000935,테헤란로81길,1637,791,846
2019,4,A,골목상권,1000934,일원로9길,590,334,256
2019,4,A,골목상권,1000933,일원로3길,513,237,276
2019,4,A,골목상권,1000932,영동대로65길,1175,692,483
2019,4,A,골목상권,1000931,영동대로112길,9367,7734,1633
2019,4,A,골목상권,1000930,언주로81길,5810,3989,1821
2019,4,A,골목상권,1000929,압구정로2길,1937,1352,585
2019,4,A,골목상권,1000928,선릉로18길,466,366,100
2019,4,A,골목상권,1000927,선릉로146길,1123,536,587
2019,4,A,골목상권,1000926,선릉로133길,739,434,305
2019,4,A,골목상권,1000925,선릉로132길,1305,645,660
2019,4,A,골목상권,1000924,선릉로121길,2263,1243,1020
2019,4,A,골목상권,1000923,삼성로75길,1814,1262,552
2019,4,A,골목상권,1000922,삼성로69길,2064,1086,978
2019,4,A,골목상권,1000921,삼성로64길,2957,1473,1484
2019,4,A,골목상권,1000920,삼성로63길,1079,554,525
2019,4,A,골목상권,1000919,삼성로57길,3231,1896,1335
2019,4,A,골목상권,1000918,삼성로147길,190,88,102
2019,4,A,골목상권,1000917,삼성로115길,839,429,410
2019,4,A,골목상권,1000916,봉은사로68길,1265,789,476
2019,4,A,골목상권,1000915,봉은사로57길,638,409,229
2019,4,A,골목상권,1000914,봉은사로43길,2978,1692,1286
2019,4,A,골목상권,1000913,봉은사로29길,1860,1203,657
2019,4,A,골목상권,1000912,봉은사로109길,2837,2093,744
2019,4,A,골목상권,1000911,도산대로89길,1284,730,554
2019,4,A,골목상권,1000910,도산대로81길,3094,1363,1731
2019,4,A,골목상권,1000909,도산대로50길,2685,1863,822
2019,4,A,골목상권,1000908,도산대로38길,1043,622,421
2019,4,A,골목상권,1000907,도산대로30길,3153,1611,1542
2019,4,A,골목상권,1000906,도산대로23길,425,176,249
2019,4,A,골목상권,1000905,도산대로15길,123,65,58
2019,4,A,골목상권,1000904,도곡로37길,7206,4518,2688
2019,4,A,골목상권,1000903,논현로8길,1081,701,380
2019,4,A,골목상권,1000902,논현로63길,2139,1352,787
2019,4,A,골목상권,1000901,논현로28길,2736,1826,910
2019,4,A,골목상권,1000900,논현로26길,17916,5148,12768
2019,4,A,골목상권,1000899,논현로159길,109,49,60
2019,4,A,골목상권,1000898,논현로139길,3565,2123,1442
2019,4,A,골목상권,1000897,논현로123길,162,106,56
2019,4,A,골목상권,1000896,논현로115길,2866,1752,1114
2019,4,A,골목상권,1000895,논현로10길,454,271,183
2019,4,A,골목상권,1000894,논현로106길,1488,1027,461
2019,4,A,골목상권,1000893,남부순환로365길,691,445,246
2019,4,A,골목상권,1000892,개포로82길,103,51,52
2019,4,A,골목상권,1000891,개포로28길,589,445,144
2019,4,A,골목상권,1000890,개포로20길,647,400,247
2019,4,A,골목상권,1000889,개포로17길,961,659,302
2019,4,A,골목상권,1000888,강남대로140길,1433,810,623
2019,4,A,골목상권,1000887,강남대로136길,5070,3655,1415
2019,4,A,골목상권,1000886,강남대로118길,218,91,127
2019,4,A,골목상권,1000885,서초중앙로8길,21671,11288,10383
2019,4,A,골목상권,1000884,방배중앙로21길,7153,2605,4548
2019,4,A,골목상권,1000883,효령로72길,3428,2690,738
2019,4,A,골목상권,1000882,효령로34길,1015,653,362
2019,4,A,골목상권,1000881,효령로31길,2710,2198,512
2019,4,A,골목상권,1000880,효령로23길,1492,964,528
2019,4,A,골목상권,1000879,청두곶길,1446,795,651
2019,4,A,골목상권,1000878,주흥길,164,111,53
2019,4,A,골목상권,1000877,주흥15길,834,539,295
2019,4,A,골목상권,1000876,언남길,1128,742,386
2019,4,A,골목상권,1000875,신반포로45길,1192,625,567
2019,4,A,골목상권,1000874,서초대로8길,2598,644,1954
2019,4,A,골목상권,1000873,서초대로64길,829,489,340
2019,4,A,골목상권,1000872,서초대로4길,847,478,369
2019,4,A,골목상권,1000871,서초대로25길,2073,1591,482
2019,4,A,골목상권,1000870,서초대로23길,2098,1239,859
2019,4,A,골목상권,1000869,서초대로15길,467,253,214
2019,4,A,골목상권,1000868,사평대로57길,65,33,32
2019,4,A,골목상권,1000867,사평대로26길,509,346,163
2019,4,A,골목상권,1000866,사평대로22길,1697,1052,645
2019,4,A,골목상권,1000865,사임당로17길,1939,1273,666
2019,4,A,골목상권,1000864,방배로42길,861,707,154
2019,4,A,골목상권,1000863,방배로35길,1137,711,426
2019,4,A,골목상권,1000862,방배로18길,873,535,338
2019,4,A,골목상권,1000861,반포대로9길,538,288,250
2019,4,A,골목상권,1000860,바우뫼로39길,2648,1935,713
2019,4,A,골목상권,1000859,마방로2길,3582,2570,1012
2019,4,A,골목상권,1000858,방배천로4안길,959,401,558
2019,4,A,골목상권,1000857,동산로19길,1276,633,643
2019,4,A,골목상권,1000856,동산로10길,2158,1493,665
2019,4,A,골목상권,1000855,동광로39길,1227,825,402
2019,4,A,골목상권,1000854,동광로1길,2565,1862,703
2019,4,A,골목상권,1000853,동광로12길,1237,610,627
2019,4,A,골목상권,1000852,논현로27길,2808,2146,662
2019,4,A,골목상권,1000851,논현로1길,1227,780,447
2019,4,A,골목상권,1000850,남부순환로339길,1451,978,473
2019,4,A,골목상권,1000849,남부순환로325길,1477,1061,416
2019,4,A,골목상권,1000848,남부순환로317길,2386,1532,854
2019,4,A,골목상권,1000847,고무래로8길,5479,3568,1911
2019,4,A,골목상권,1000846,강남대로8길,1850,1231,619
2019,4,A,골목상권,1000845,강남대로34길,1734,1204,530
2019,4,A,골목상권,1000844,강남대로23길,2897,1993,904
2019,4,A,골목상권,1000843,소담길,14,4,10
2019,4,A,골목상권,1000842,원신길,22,11,11
2019,4,A,골목상권,1000840,양산길,11,3,8
2019,4,A,골목상권,1000839,호암로24길,1218,1084,134
2019,4,A,골목상권,1000838,호암로20길,186,77,109
2019,4,A,골목상권,1000837,행운길,557,428,129
2019,4,A,골목상권,1000836,행운1길,250,151,99
2019,4,A,골목상권,1000835,청림3길,167,58,109
2019,4,A,골목상권,1000834,청룡길,404,224,180
2019,4,A,골목상권,1000833,청룡8길,222,53,169
2019,4,A,골목상권,1000832,중앙길,99,30,69
2019,4,A,골목상권,1000831,조원중앙로2길,921,694,227
2019,4,A,골목상권,1000830,조원로18길,179,92,87
2019,4,A,골목상권,1000829,조원로10길,397,215,182
2019,4,A,골목상권,1000828,장군봉2길,201,115,86
2019,4,A,골목상권,1000827,장군봉1길,326,166,160
2019,4,A,골목상권,1000826,인헌길,115,61,54
2019,4,A,골목상권,1000825,은천로25길,44,21,23
2019,4,A,골목상권,1000824,양녕로6길,205,124,81
2019,4,A,골목상권,1000823,신원로3길,180,103,77
2019,4,A,골목상권,1000822,신사로20길,121,93,28
2019,4,A,골목상권,1000821,신림로65길,228,175,53
2019,4,A,골목상권,1000820,신림로64길,113,45,68
2019,4,A,골목상권,1000819,신림로48길,75,49,26
2019,4,A,골목상권,1000818,신림로38길,147,90,57
2019,4,A,골목상권,1000817,신림로28길,442,283,159
2019,4,A,골목상권,1000816,신림로11길,284,183,101
2019,4,A,골목상권,1000815,신림동길,669,435,234
2019,4,A,골목상권,1000814,승방길,251,141,110
2019,4,A,골목상권,1000813,서림7길,116,58,58
2019,4,A,골목상권,1000812,봉천로33길,211,131,80
2019,4,A,골목상권,1000811,봉천로13길,241,86,155
2019,4,A,골목상권,1000810,복은길,405,229,176
2019,4,A,골목상권,1000809,법원단지길,16,5,11
2019,4,A,골목상권,1000808,법원단지9길,163,102,61
2019,4,A,골목상권,1000807,미성5길,309,154,155
2019,4,A,골목상권,1000806,대학길,80,45,35
2019,4,A,골목상권,1000805,대학14길,61,31,30
2019,4,A,골목상권,1000804,당곡길,227,117,110
2019,4,A,골목상권,1000803,남현길,117,28,89
2019,4,A,골목상권,1000802,남현3길,372,256,116
2019,4,A,골목상권,1000801,남현2길,568,398,170
2019,4,A,골목상권,1000800,남부순환로248길,404,213,191
2019,4,A,골목상권,1000799,남부순환로234길,126,81,45
2019,4,A,골목상권,1000798,남부순환로172길,450,316,134
2019,4,A,골목상권,1000797,남부순환로161길,347,223,124
2019,4,A,골목상권,1000796,남부순환로151길,788,369,419
2019,4,A,골목상권,1000795,남부순환로142길,418,252,166
2019,4,A,골목상권,1000794,난향길,206,89,117
2019,4,A,골목상권,1000793,난우길,217,121,96
2019,4,A,골목상권,1000792,난곡로74길,2179,1754,425
2019,4,A,골목상권,1000791,난곡로34길,47,19,28
2019,4,A,골목상권,1000790,난곡로26길,120,85,35
2019,4,A,골목상권,1000789,난곡로24길,89,34,55
2019,4,A,골목상권,1000788,낙성대역길,431,230,201
2019,4,A,골목상권,1000787,국회단지길,1430,396,1034
2019,4,A,골목상권,1000786,구암길,228,72,156
2019,4,A,골목상권,1000785,관천로22길,194,117,77
2019,4,A,골목상권,1000784,관천로15길,236,149,87
2019,4,A,골목상권,1000783,관악로30길,140,51,89
2019,4,A,골목상권,1000782,관악로28길,122,39,83
2019,4,A,골목상권,1000781,관악로14길,109,42,67
2019,4,A,골목상권,1000780,관악로10길,1482,1050,432
2019,4,A,골목상권,1000779,흑석로9길,110,76,34
2019,4,A,골목상권,1000778,흑석로13길,77,33,44
2019,4,A,골목상권,1000777,장승배기로27길,260,135,125
2019,4,A,골목상권,1000776,장승배기로19길,518,409,109
2019,4,A,골목상권,1000775,장승배기로10길,223,90,133
2019,4,A,골목상권,1000774,여의대방로46길,1238,733,505
2019,4,A,골목상권,1000773,여의대방로24길,16249,10586,5663
2019,4,A,골목상권,1000772,여의대방로22카길,346,202,144
2019,4,A,골목상권,1000771,여의대방로22나길,188,95,93
2019,4,A,골목상권,1000770,여의대방로22길,241,128,113
2019,4,A,골목상권,1000769,양녕로26길,92,49,43
2019,4,A,골목상권,1000768,신대방길,191,90,101
2019,4,A,골목상권,1000767,성대로29길,297,143,154
2019,4,A,골목상권,1000766,성대로1길,87,43,44
2019,4,A,골목상권,1000765,서달로8가길,83,34,49
2019,4,A,골목상권,1000764,서달로15길,42,14,28
2019,4,A,골목상권,1000763,서달로14길,21,7,14
2019,4,A,골목상권,1000762,서달로10길,51,28,23
2019,4,A,골목상권,1000761,상도로62길,332,179,153
2019,4,A,골목상권,1000760,상도로61길,187,67,120
2019,4,A,골목상권,1000759,상도로47길,601,288,313
2019,4,A,골목상권,1000758,상도로37길,128,65,63
2019,4,A,골목상권,1000757,상도로15길,320,121,199
2019,4,A,골목상권,1000756,사당로8길,131,70,61
2019,4,A,골목상권,1000755,사당로30길,514,180,334
2019,4,A,골목상권,1000754,사당로2차길,324,216,108
2019,4,A,골목상권,1000753,사당로29길,128,78,50
2019,4,A,골목상권,1000752,사당로26길,321,199,122
2019,4,A,골목상권,1000751,사당로23나길,36,21,15
2019,4,A,골목상권,1000749,사당로20길,103,53,50
2019,4,A,골목상권,1000748,사당로16길,116,36,80
2019,4,A,골목상권,1000747,사당로16가길,237,147,90
2019,4,A,골목상권,1000746,만양로8길,824,512,312
2019,4,A,골목상권,1000745,만양로14길,47,29,18
2019,4,A,골목상권,1000744,등용로14길,409,134,275
2019,4,A,골목상권,1000743,동작대로7길,182,84,98
2019,4,A,골목상권,1000742,동작대로35길,190,87,103
2019,4,A,골목상권,1000741,동작대로33길,170,88,82
2019,4,A,골목상권,1000740,동작대로29길,224,49,175
2019,4,A,골목상권,1000739,동작대로17길,806,386,420
2019,4,A,골목상권,1000738,대방동2길,281,134,147
2019,4,A,골목상권,1000737,대방동27길,465,223,242
2019,4,A,골목상권,1000736,노량진로6길,307,204,103
2019,4,A,골목상권,1000735,국사봉길,138,79,59
2019,4,A,골목상권,1000734,국사봉2길,55,34,21
2019,4,A,골목상권,1000733,국사봉1길,85,52,33
2019,4,A,골목상권,1000732,영신로9길,3221,1646,1575
2019,4,A,골목상권,1000731,영등포로84길,1933,673,1260
2019,4,A,골목상권,1000730,영등포로80길,96,48,48
2019,4,A,골목상권,1000729,영등포로62길,118,85,33
2019,4,A,골목상권,1000728,영등포로35길,340,192,148
2019,4,A,골목상권,1000727,영등포로27길,301,189,112
2019,4,A,골목상권,1000726,영등포로25길,493,363,130
2019,4,A,골목상권,1000725,여의대방로61길,514,400,114
2019,4,A,골목상권,1000724,여의대방로43나길,859,661,198
2019,4,A,골목상권,1000723,여의대방로39길,193,112,81
2019,4,A,골목상권,1000722,여의대방로35길,197,65,132
2019,4,A,골목상권,1000721,양평로28길,847,707,140
2019,4,A,골목상권,1000720,양평로22라길,555,299,256
2019,4,A,골목상권,1000719,양평로19길,748,436,312
2019,4,A,골목상권,1000718,신길로60길,260,196,64
2019,4,A,골목상권,1000717,신길로42길,501,270,231
2019,4,A,골목상권,1000716,신길로42가길,210,90,120
2019,4,A,골목상권,1000715,신길로39길,56,32,24
2019,4,A,골목상권,1000714,신길로17길,676,289,387
2019,4,A,골목상권,1000713,선유서로28길,208,110,98
2019,4,A,골목상권,1000712,선유서로25길,1697,1284,413
2019,4,A,골목상권,1000711,선유서로24길,114,70,44
2019,4,A,골목상권,1000710,선유로55길,416,273,143
2019,4,A,골목상권,1000709,디지털로74길,13,8,5
2019,4,A,골목상권,1000708,디지털로57길,1036,639,397
2019,4,A,골목상권,1000707,디지털로37길,172,55,117
2019,4,A,골목상권,1000706,도신로62길,227,173,54
2019,4,A,골목상권,1000705,도신로60길,124,51,73
2019,4,A,골목상권,1000704,도신로29길,108,49,59
2019,4,A,골목상권,1000703,도신로15길,437,238,199
2019,4,A,골목상권,1000702,도림천로21길,236,157,79
2019,4,A,골목상권,1000701,도림로63길,53,41,12
2019,4,A,골목상권,1000700,도림로147길,334,255,79
2019,4,A,골목상권,1000699,도림로112길,30,19,11
2019,4,A,골목상권,1000698,대림로8길,234,113,121
2019,4,A,골목상권,1000697,대림로7길,49,23,26
2019,4,A,골목상권,1000696,대림로44길,411,289,122
2019,4,A,골목상권,1000695,대림로34길,201,139,62
2019,4,A,골목상권,1000694,대림로31길,454,281,173
2019,4,A,골목상권,1000693,대림로29길,964,624,340
2019,4,A,골목상권,1000692,대림로22길,190,98,92
2019,4,A,골목상권,1000691,당산로46길,698,529,169
2019,4,A,골목상권,1000690,당산로38길,676,471,205
2019,4,A,골목상권,1000689,당산로37길,2439,1483,956
2019,4,A,골목상권,1000688,당산로31길,1481,749,732
2019,4,A,골목상권,1000687,국회대로56길,3275,1590,1685
2019,4,A,골목상권,1000686,경인로90길,282,210,72
2019,4,A,골목상권,1000685,경인로80길,1007,706,301
2019,4,A,골목상권,1000684,경인로77길,741,512,229
2019,4,A,골목상권,1000683,가마산로61길,47,35,12
2019,4,A,골목상권,1000682,시흥대로94길,446,164,282
2019,4,A,골목상권,1000681,시흥대로84길,178,103,75
2019,4,A,골목상권,1000680,시흥대로68길,549,219,330
2019,4,A,골목상권,1000679,시흥대로63길,1016,542,474
2019,4,A,골목상권,1000678,시흥대로62가길,86,59,27
2019,4,A,골목상권,1000677,시흥대로36길,288,173,115
2019,4,A,골목상권,1000676,시흥대로22길,259,143,116
2019,4,A,골목상권,1000675,시흥대로153길,92,55,37
2019,4,A,골목상권,1000674,시흥대로150길,421,278,143
2019,4,A,골목상권,1000673,시흥대로141길,214,142,72
2019,4,A,골목상권,1000672,시흥대로138길,341,246,95
2019,4,A,골목상권,1000671,시흥대로120길,192,117,75
2019,4,A,골목상권,1000670,벚꽃로56길,301,260,41
2019,4,A,골목상권,1000669,범안로17길,4567,2830,1737
2019,4,A,골목상권,1000668,범안로11길,1498,819,679
2019,4,A,골목상권,1000667,문성로5길,379,199,180
2019,4,A,골목상권,1000666,독산로85길,68,34,34
2019,4,A,골목상권,1000665,독산로78다길,195,124,71
2019,4,A,골목상권,1000664,독산로70길,74,31,43
2019,4,A,골목상권,1000663,독산로64길,186,152,34
2019,4,A,골목상권,1000662,독산로50길,27,6,21
2019,4,A,골목상권,1000661,독산로40길,219,75,144
2019,4,A,골목상권,1000660,독산로108길,1619,1443,176
2019,4,A,골목상권,1000659,남부순환로112길,96,66,30
2019,4,A,골목상권,1000658,금하로24길,132,72,60
2019,4,A,골목상권,1000657,금하로1길,227,175,52
2019,4,A,골목상권,1000656,금하로14길,96,65,31
2019,4,A,골목상권,1000655,가산로5길,499,350,149
2019,4,A,골목상권,1000654,가산로3길,999,756,243
2019,4,A,골목상권,1000653,중앙로1길,960,704,256
2019,4,A,골목상권,1000652,중앙로15길,171,106,65
2019,4,A,골목상권,1000651,우마길,43,19,24
2019,4,A,골목상권,1000650,오류로8길,442,219,223
2019,4,A,골목상권,1000649,신도림로13길,148,100,48
2019,4,A,골목상권,1000648,새말로18길,933,549,384
2019,4,A,골목상권,1000647,부일로1길,356,321,35
2019,4,A,골목상권,1000646,부일로15길,156,107,49
2019,4,A,골목상권,1000645,부일로11길,281,115,166
2019,4,A,골목상권,1000644,디지털로32길,815,435,380
2019,4,A,골목상권,1000643,디지털로32가길,2221,1322,899
2019,4,A,골목상권,1000642,디지털로27길,26,20,6
2019,4,A,골목상권,1000641,도림로6길,160,93,67
2019,4,A,골목상권,1000640,도림로12길,186,124,62
2019,4,A,골목상권,1000639,남부순환로97길,101,48,53
2019,4,A,골목상권,1000638,구로중앙로8길,107,41,66
2019,4,A,골목상권,1000637,구로중앙로7길,86,42,44
2019,4,A,골목상권,1000636,구로중앙로42길,403,284,119
2019,4,A,골목상권,1000635,구로중앙로34길,189,149,40
2019,4,A,골목상권,1000634,구로중앙로28길,470,226,244
2019,4,A,골목상권,1000633,구로중앙로19길,666,398,268
2019,4,A,골목상권,1000632,구로동로8길,298,153,145
2019,4,A,골목상권,1000631,구로동로7길,115,71,44
2019,4,A,골목상권,1000630,구로동로42길,131,75,56
2019,4,A,골목상권,1000629,구로동로41길,119,79,40
2019,4,A,골목상권,1000628,구로동로38길,625,240,385
2019,4,A,골목상권,1000627,구로동로28길,42,18,24
2019,4,A,골목상권,1000626,구로동로15길,88,50,38
2019,4,A,골목상권,1000625,공원로6가길,1158,755,403
2019,4,A,골목상권,1000624,고척로52길,40,27,13
2019,4,A,골목상권,1000623,고척로27다길,169,99,70
2019,4,A,골목상권,1000622,고척로27길,309,167,142
2019,4,A,골목상권,1000621,고척로21나길,369,197,172
2019,4,A,골목상권,1000620,경인로47길,657,264,393
2019,4,A,골목상권,1000619,경인로35길,364,232,132
2019,4,A,골목상권,1000618,경인로31길,130,61,69
2019,4,A,골목상권,1000617,경인로15길,259,93,166
2019,4,A,골목상권,1000616,개봉로3길,273,139,134
2019,4,A,골목상권,1000615,개봉로2길,186,99,87
2019,4,A,골목상권,1000614,개봉로23가길,826,590,236
2019,4,A,골목상권,1000613,개봉로20길,3082,1346,1736
2019,4,A,골목상권,1000612,개봉로1길,187,126,61
2019,4,A,골목상권,1000611,개봉로17다길,2362,1606,756
2019,4,A,골목상권,1000610,개봉로17길,1304,418,886
2019,4,A,골목상권,1000609,개봉로11길,181,97,84
2019,4,A,골목상권,1000608,화곡로64길,1128,686,442
2019,4,A,골목상권,1000607,화곡로59길,316,232,84
2019,4,A,골목상권,1000606,화곡로44나길,625,559,66
2019,4,A,골목상권,1000605,화곡로31길,618,375,243
2019,4,A,골목상권,1000604,화곡로20길,355,193,162
2019,4,A,골목상권,1000603,화곡로13길,368,249,119
2019,4,A,골목상권,1000602,초원로16길,523,369,154
2019,4,A,골목상권,1000601,초록마을로8길,116,68,48
2019,4,A,골목상권,1000600,초록마을로3길,439,355,84
2019,4,A,골목상권,1000599,월정로20길,135,31,104
2019,4,A,골목상권,1000598,우장산로6길,486,298,188
2019,4,A,골목상권,1000597,양천로73가길,468,360,108
2019,4,A,골목상권,1000596,양천로71길,1203,752,451
2019,4,A,골목상권,1000595,양천로49길,342,232,110
2019,4,A,골목상권,1000594,양천로26길,479,377,102
2019,4,A,골목상권,1000593,양천로24길,186,100,86
2019,4,A,골목상권,1000592,양천로24가길,207,113,94
2019,4,A,골목상권,1000591,양천로14길,257,143,114
2019,4,A,골목상권,1000590,방화대로6라길,653,413,240
2019,4,A,골목상권,1000589,방화대로21길,390,243,147
2019,4,A,골목상권,1000588,등촌로5길,1524,514,1010
2019,4,A,골목상권,1000587,등촌로55길,432,323,109
2019,4,A,골목상권,1000586,등촌로51길,239,137,102
2019,4,A,골목상권,1000585,등촌로39길,313,146,167
2019,4,A,골목상권,1000584,등촌로13길,183,128,55
2019,4,A,골목상권,1000583,남부순환로11길,307,201,106
2019,4,A,골목상권,1000582,까치산로4길,189,112,77
2019,4,A,골목상권,1000581,국회대로7길,215,101,114
2019,4,A,골목상권,1000580,공항대로8길,276,172,104
2019,4,A,골목상권,1000579,공항대로61길,547,415,132
2019,4,A,골목상권,1000578,공항대로59다길,1037,645,392
2019,4,A,골목상권,1000577,공항대로59길,654,454,200
2019,4,A,골목상권,1000576,공항대로55길,900,577,323
2019,4,A,골목상권,1000575,공항대로42길,514,323,191
2019,4,A,골목상권,1000574,공항대로38길,92,49,43
2019,4,A,골목상권,1000573,곰달래로60길,221,146,75
2019,4,A,골목상권,1000572,곰달래로53길,130,89,41
2019,4,A,골목상권,1000571,곰달래로47길,333,218,115
2019,4,A,골목상권,1000570,곰달래로31길,120,78,42
2019,4,A,골목상권,1000569,곰달래로25길,245,139,106
2019,4,A,골목상권,1000568,개화동로25길,351,201,150
2019,4,A,골목상권,1000567,개화동로23길,857,669,188
2019,4,A,골목상권,1000566,강서로8길,214,125,89
2019,4,A,골목상권,1000565,강서로5라길,245,176,69
2019,4,A,골목상권,1000564,강서로5나길,360,221,139
2019,4,A,골목상권,1000563,강서로5가길,182,98,84
2019,4,A,골목상권,1000562,강서로47라길,207,150,57
2019,4,A,골목상권,1000561,강서로47길,327,146,181
2019,4,A,골목상권,1000560,강서로45다길,243,178,65
2019,4,A,골목상권,1000559,강서로45길,101,43,58
2019,4,A,골목상권,1000558,강서로35길,280,120,160
2019,4,A,골목상권,1000557,강서로29길,384,230,154
2019,4,A,골목상권,1000556,강서로18길,676,545,131
2019,4,A,골목상권,1000555,강서로17가길,554,386,168
2019,4,A,골목상권,1000554,강서로15길,261,152,109
2019,4,A,골목상권,1000553,가로공원로80길,270,175,95
2019,4,A,골목상권,1000552,가로공원로76가길,168,91,77
2019,4,A,골목상권,1000551,화곡로4길,421,219,202
2019,4,A,골목상권,1000550,화곡로3길,351,177,174
2019,4,A,골목상권,1000549,지양로7길,245,105,140
2019,4,A,골목상권,1000548,중앙로55길,592,261,331
2019,4,A,골목상권,1000547,중앙로51길,283,178,105
2019,4,A,골목상권,1000546,중앙로47길,94,40,54
2019,4,A,골목상권,1000545,중앙로45길,1386,1342,44
2019,4,A,골목상권,1000544,중앙로36길,133,49,84
2019,4,A,골목상권,1000543,중앙로32길,145,87,58
2019,4,A,골목상권,1000542,중앙로25길,97,61,36
2019,4,A,골목상권,1000541,은행정로7길,472,183,289
2019,4,A,골목상권,1000540,은행정로5길,109,57,52
2019,4,A,골목상권,1000539,오목로5길,120,85,35
2019,4,A,골목상권,1000538,오목로3길,375,296,79
2019,4,A,골목상권,1000537,오목로30길,220,125,95
2019,4,A,골목상권,1000536,오목로23길,401,155,246
2019,4,A,골목상권,1000535,신월로20길,47,30,17
2019,4,A,골목상권,1000534,신월로15길,357,184,173
2019,4,A,골목상권,1000533,신목로6길,582,383,199
2019,4,A,골목상권,1000532,신목로5길,645,416,229
2019,4,A,골목상권,1000531,신목로2길,386,255,131
2019,4,A,골목상권,1000530,목동중앙서로8가길,317,200,117
2019,4,A,골목상권,1000529,목동중앙서로7길,75,52,23
2019,4,A,골목상권,1000528,목동중앙북로8길,171,102,69
2019,4,A,골목상권,1000527,목동중앙북로16길,488,190,298
2019,4,A,골목상권,1000526,목동중앙본로7길,131,70,61
2019,4,A,골목상권,1000525,목동중앙로3길,157,95,62
2019,4,A,골목상권,1000524,목동중앙로13나길,346,248,98
2019,4,A,골목상권,1000523,목동중앙남로3가길,190,108,82
2019,4,A,골목상권,1000522,목동로9길,768,479,289
2019,4,A,골목상권,1000521,목동로19길,351,190,161
2019,4,A,골목상권,1000520,목동동로8길,184,106,78
2019,4,A,골목상권,1000519,목동동로12길,335,228,107
2019,4,A,골목상권,1000518,목동남로4길,797,494,303
2019,4,A,골목상권,1000517,남부순환로88길,328,124,204
2019,4,A,골목상권,1000516,남부순환로79길,142,74,68
2019,4,A,골목상권,1000515,남부순환로70길,165,101,64
2019,4,A,골목상권,1000514,남부순환로58길,282,179,103
2019,4,A,골목상권,1000513,남부순환로40길,122,46,76
2019,4,A,골목상권,1000512,남부순환로33길,179,116,63
2019,4,A,골목상권,1000511,곰달래로5길,211,125,86
2019,4,A,골목상권,1000510,곰달래로3길,313,213,100
2019,4,A,골목상권,1000509,곰달래로2길,610,344,266
2019,4,A,골목상권,1000508,곰달래로10길,543,449,94
2019,4,A,골목상권,1000507,가로공원로58길,91,54,37
2019,4,A,골목상권,1000506,효창원로93길,243,99,144
2019,4,A,골목상권,1000505,토정로37길,431,166,265
2019,4,A,골목상권,1000504,월드컵로8길,939,462,477
2019,4,A,골목상권,1000503,월드컵로7길,759,308,451
2019,4,A,골목상권,1000502,월드컵로36길,461,286,175
2019,4,A,골목상권,1000501,월드컵로25길,309,125,184
2019,4,A,골목상권,1000500,월드컵로19길,284,181,103
2019,4,A,골목상권,1000499,월드컵로16길,1538,929,609
2019,4,A,골목상권,1000498,월드컵로11길,421,153,268
2019,4,A,골목상권,1000497,월드컵로10길,1102,654,448
2019,4,A,골목상권,1000496,와우산로3길,257,176,81
2019,4,A,골목상권,1000495,와우산로29길,78,30,48
2019,4,A,골목상권,1000494,와우산로29가길,989,653,336
2019,4,A,골목상권,1000493,양화진길,676,412,264
2019,4,A,골목상권,1000492,양화로1길,544,248,296
2019,4,A,골목상권,1000491,양화로11길,2761,1012,1749
2019,4,A,골목상권,1000490,신촌로30길,109,64,45
2019,4,A,골목상권,1000489,신촌로28가길,59,19,40
2019,4,A,골목상권,1000488,신촌로12길,197,95,102
2019,4,A,골목상권,1000487,숭문길,1467,1016,451
2019,4,A,골목상권,1000486,숭문8길,109,65,44
2019,4,A,골목상권,1000485,성지3길,338,228,110
2019,4,A,골목상권,1000484,성산로4길,855,546,309
2019,4,A,골목상권,1000483,성미산로32길,243,172,71
2019,4,A,골목상권,1000482,성미산로1길,554,299,255
2019,4,A,골목상권,1000481,성미산로11길,1114,807,307
2019,4,A,골목상권,1000480,백범로16길,1908,1298,610
2019,4,A,골목상권,1000479,방울내로9안길,619,351,268
2019,4,A,골목상권,1000478,모래내로7길,91,63,28
2019,4,A,골목상권,1000477,매봉산로2길,806,601,205
2019,4,A,골목상권,1000476,망원로2길,282,190,92
2019,4,A,골목상권,1000475,망원로11길,144,73,71
2019,4,A,골목상권,1000474,만리재옛길,1190,687,503
2019,4,A,골목상권,1000473,마포대로4길,674,365,309
2019,4,A,골목상권,1000472,마포대로20길,483,258,225
2019,4,A,골목상권,1000471,마포대로12길,78,39,39
2019,4,A,골목상권,1000470,동교로38길,464,247,217
2019,4,A,골목상권,1000469,동교로27길,1172,795,377
2019,4,A,골목상권,1000468,동교로25길,1378,581,797
2019,4,A,골목상권,1000467,동교로19길,1207,739,468
2019,4,A,골목상권,1000466,동교로17길,405,240,165
2019,4,A,골목상권,1000465,독막로8길,441,274,167
2019,4,A,골목상권,1000464,독막로32길,487,240,247
2019,4,A,골목상권,1000463,독막로22길,91,61,30
2019,4,A,골목상권,1000462,도화길,56,32,24
2019,4,A,골목상권,1000461,도화4길,825,292,533
2019,4,A,골목상권,1000460,대흥로28길,50,17,33
2019,4,A,골목상권,1000459,대흥로21길,372,188,184
2019,4,A,골목상권,1000458,광성로6길,295,169,126
2019,4,A,골목상권,1000457,홍제내길,565,201,364
2019,4,A,골목상권,1000456,홍연길,79,47,32
2019,4,A,골목상권,1000455,통일로39길,67,32,35
2019,4,A,골목상권,1000454,통일로37길,611,407,204
2019,4,A,골목상권,1000453,통일로11길,97,46,51
2019,4,A,골목상권,1000452,충정로6길,3185,1879,1306
2019,4,A,골목상권,1000451,충정로4길,2044,1298,746
2019,4,A,골목상권,1000450,증가로6길,326,277,49
2019,4,A,골목상권,1000449,증가로23나길,902,441,461
2019,4,A,골목상권,1000448,증가로20가길,336,99,237
2019,4,A,골목상권,1000447,증가로10길,1463,1123,340
2019,4,A,골목상권,1000446,응암로1길,621,380,241
2019,4,A,골목상권,1000445,연희로10길,3448,3135,313
2019,4,A,골목상권,1000444,신촌로37길,52,25,27
2019,4,A,골목상권,1000443,수색로8길,1090,905,185
2019,4,A,골목상권,1000442,세무서길,164,78,86
2019,4,A,골목상권,1000441,세무서2길,186,77,109
2019,4,A,골목상권,1000440,세검정로1길,109,37,72
2019,4,A,골목상권,1000439,북아현로4길,350,225,125
2019,4,A,골목상권,1000438,모래내로15길,74,54,20
2019,4,A,골목상권,1000437,명지대길,107,58,49
2019,4,A,골목상권,1000436,독립문로8길,679,422,257
2019,4,A,골목상권,1000435,가재울로6길,168,108,60
2019,4,A,골목상권,1000434,통일로92길,186,72,114
2019,4,A,골목상권,1000433,통일로87길,255,130,125
2019,4,A,골목상권,1000432,통일로78길,172,60,112
2019,4,A,골목상권,1000431,통일로69길,107,55,52
2019,4,A,골목상권,1000430,진흥로1길,310,165,145
2019,4,A,골목상권,1000429,진흥로12길,392,144,248
2019,4,A,골목상권,1000428,증산서길,334,189,145
2019,4,A,골목상권,1000427,증산로9길,606,525,81
2019,4,A,골목상권,1000426,증산로5길,508,308,200
2019,4,A,골목상권,1000425,증산로21길,237,122,115
2019,4,A,골목상권,1000424,증산로17길,161,110,51
2019,4,A,골목상권,1000423,증산로15길,398,297,101
2019,4,A,골목상권,1000422,증산로13길,79,42,37
2019,4,A,골목상권,1000421,응암로34길,231,118,113
2019,4,A,골목상권,1000420,응암로22길,130,53,77
2019,4,A,골목상권,1000419,응암로14길,99,50,49
2019,4,A,골목상권,1000418,응암로13길,156,44,112
2019,4,A,골목상권,1000417,응암로12길,67,32,35
2019,4,A,골목상권,1000416,은평로8길,275,194,81
2019,4,A,골목상권,1000415,은평로3길,242,110,132
2019,4,A,골목상권,1000414,은평로20길,9,2,7
2019,4,A,골목상권,1000413,은평로13길,655,283,372
2019,4,A,골목상권,1000412,은평로10길,246,148,98
2019,4,A,골목상권,1000411,연서로5길,647,303,344
2019,4,A,골목상권,1000410,연서로41길,64,33,31
2019,4,A,골목상권,1000409,연서로3길,119,51,68
2019,4,A,골목상권,1000408,연서로34길,1310,709,601
2019,4,A,골목상권,1000407,연서로33길,109,49,60
2019,4,A,골목상권,1000406,연서로29길,100,60,40
2019,4,A,골목상권,1000405,연서로28길,226,118,108
2019,4,A,골목상권,1000404,연서로27길,339,148,191
2019,4,A,골목상권,1000403,연서로21길,684,486,198
2019,4,A,골목상권,1000402,연서로17길,540,162,378
2019,4,A,골목상권,1000401,연서로16길,121,66,55
2019,4,A,골목상권,1000400,연서로13길,218,135,83
2019,4,A,골목상권,1000399,연서로11길,640,263,377
2019,4,A,골목상권,1000398,역말로9길,159,82,77
2019,4,A,골목상권,1000397,수색로18길,128,93,35
2019,4,A,골목상권,1000396,서오릉로8길,160,104,56
2019,4,A,골목상권,1000395,서오릉로21길,153,56,97
2019,4,A,골목상권,1000394,불광천길,192,95,97
2019,4,A,골목상권,1000393,갈현로7길,398,205,193
2019,4,A,골목상권,1000392,갈현로41길,171,78,93
2019,4,A,골목상권,1000391,갈현로33길,255,149,106
2019,4,A,골목상권,1000390,갈현로1길,66,36,30
2019,4,A,골목상권,1000389,가좌로7길,329,203,126
2019,4,A,골목상권,1000388,한글비석로44길,232,95,137
2019,4,A,골목상권,1000387,한글비석로24길,180,62,118
2019,4,A,골목상권,1000386,한글비석로22길,172,92,80
2019,4,A,골목상권,1000385,석계로1길,605,255,350
2019,4,A,골목상권,1000384,상계로9가길,151,82,69
2019,4,A,골목상권,1000383,상계로1길,334,244,90
2019,4,A,골목상권,1000382,상계로12길,144,90,54
2019,4,A,골목상권,1000381,동일로242길,302,142,160
2019,4,A,골목상권,1000380,동일로192길,429,326,103
2019,4,A,골목상권,1000379,동일로173가길,1230,946,284
2019,4,A,골목상권,1000378,공릉로58길,129,61,68
2019,4,A,골목상권,1000377,해등로16길,285,134,151
2019,4,A,골목상권,1000376,우이천로4다길,125,83,42
2019,4,A,골목상권,1000375,우이천로32길,206,83,123
2019,4,A,골목상권,1000374,시루봉로23길,267,128,139
2019,4,A,골목상권,1000373,삼양로144길,50,24,26
2019,4,A,골목상권,1000372,방학로6가길,167,67,100
2019,4,A,골목상권,1000371,방학로5길,124,87,37
2019,4,A,골목상권,1000370,방학로15길,687,454,233
2019,4,A,골목상권,1000369,방학로10길,67,51,16
2019,4,A,골목상권,1000368,도봉산길,135,64,71
2019,4,A,골목상권,1000367,도봉산4길,27,24,3
2019,4,A,골목상권,1000366,도봉로181길,93,30,63
2019,4,A,골목상권,1000365,도봉로169나길,244,184,60
2019,4,A,골목상권,1000364,도봉로156길,93,62,31
2019,4,A,골목상권,1000363,도봉로152가길,342,311,31
2019,4,A,골목상권,1000362,도봉로147길,161,81,80
2019,4,A,골목상권,1000361,도봉로143길,73,48,25
2019,4,A,골목상권,1000360,도봉로114길,380,143,237
2019,4,A,골목상권,1000359,도봉로109길,276,223,53
2019,4,A,골목상권,1000358,도당로29길,518,292,226
2019,4,A,골목상권,1000357,도당로19길,597,66,531
2019,4,A,골목상권,1000356,도당로13바길,74,35,39
2019,4,A,골목상권,1000355,도당로13가길,36,21,15
2019,4,A,골목상권,1000354,덕릉로60길,177,126,51
2019,4,A,골목상권,1000353,노해로63다길,43,19,24
2019,4,A,골목상권,1000352,노해로60길,136,85,51
2019,4,A,골목상권,1000351,한천로140길,36,25,11
2019,4,A,골목상권,1000350,한천로139가길,108,47,61
2019,4,A,골목상권,1000349,한천로132길,56,31,25
2019,4,A,골목상권,1000348,한천로130길,91,69,22
2019,4,A,골목상권,1000347,한천로124나길,54,23,31
2019,4,A,골목상권,1000346,한천로109길,439,280,159
2019,4,A,골목상권,1000345,인수봉로79길,242,153,89
2019,4,A,골목상권,1000344,인수봉로72길,54,18,36
2019,4,A,골목상권,1000343,인수봉로56길,44,25,19
2019,4,A,골목상권,1000342,오패산로67길,238,89,149
2019,4,A,골목상권,1000341,오패산로52길,105,47,58
2019,4,A,골목상권,1000340,오패산로30길,13,5,8
2019,4,A,골목상권,1000339,수유로12길,281,199,82
2019,4,A,골목상권,1000338,솔샘로65길,284,66,218
2019,4,A,골목상권,1000337,솔매로50길,442,162,280
2019,4,A,골목상권,1000336,솔매로45길,65,32,33
2019,4,A,골목상권,1000335,솔매로41길,67,38,29
2019,4,A,골목상권,1000334,삼양로93길,209,94,115
2019,4,A,골목상권,1000333,삼양로77길,131,58,73
2019,4,A,골목상권,1000332,삼양로54길,295,66,229
2019,4,A,골목상권,1000331,삼양로41길,338,275,63
2019,4,A,골목상권,1000330,삼양로27길,7,4,3
2019,4,A,골목상권,1000329,삼양로24길,26,16,10
2019,4,A,골목상권,1000328,삼양로20길,179,168,11
2019,4,A,골목상권,1000327,삼각산로28길,70,33,37
2019,4,A,골목상권,1000326,도봉로99길,250,155,95
2019,4,A,골목상권,1000325,도봉로8길,6,4,2
2019,4,A,골목상권,1000324,도봉로76길,311,138,173
2019,4,A,골목상권,1000323,도봉로67길,116,57,59
2019,4,A,골목상권,1000322,도봉로45길,112,54,58
2019,4,A,골목상권,1000321,도봉로18길,225,182,43
2019,4,A,골목상권,1000320,도봉로13길,13,8,5
2019,4,A,골목상권,1000319,덕릉로41길,185,105,80
2019,4,A,골목상권,1000318,덕릉로40길,187,95,92
2019,4,A,골목상권,1000317,노해로33길,84,30,54
2019,4,A,골목상권,1000316,노해로23길,70,47,23
2019,4,A,골목상권,1000315,노해로17길,103,56,47
2019,4,A,골목상권,1000314,화랑로40길,71,46,25
2019,4,A,골목상권,1000313,화랑로32길,395,292,103
2019,4,A,골목상권,1000312,화랑로1길,1112,811,301
2019,4,A,골목상권,1000311,화랑로19길,43,19,24
2019,4,A,골목상권,1000310,화랑로14길,99,73,26
2019,4,A,골목상권,1000309,화랑로13길,267,95,172
2019,4,A,골목상권,1000308,한천로76길,132,100,32
2019,4,A,골목상권,1000307,한천로101가길,15,9,6
2019,4,A,골목상권,1000306,창경궁로43길,917,434,483
2019,4,A,골목상권,1000305,지봉로20길,3780,3162,618
2019,4,A,골목상권,1000304,종암로5길,404,201,203
2019,4,A,골목상권,1000303,종암로24가길,81,18,63
2019,4,A,골목상권,1000302,종암로21길,550,344,206
2019,4,A,골목상권,1000301,종암로19길,18269,9427,8842
2019,4,A,골목상권,1000300,종암로16길,140,61,79
2019,4,A,골목상권,1000299,정릉로8길,1407,1165,242
2019,4,A,골목상권,1000298,정릉로27길,75,30,45
2019,4,A,골목상권,1000297,정릉로26길,214,103,111
2019,4,A,골목상권,1000296,장위로50길,343,160,183
2019,4,A,골목상권,1000295,장월로1길,74,19,55
2019,4,A,골목상권,1000294,인촌로6길,195,131,64
2019,4,A,골목상권,1000293,인촌로5길,63,31,32
2019,4,A,골목상권,1000292,인촌로24길,1580,1010,570
2019,4,A,골목상권,1000291,개운사길,150,83,67
2019,4,A,골목상권,1000290,인촌로1길,127,78,49
2019,4,A,골목상권,1000289,인촌로17가길,90,48,42
2019,4,A,골목상권,1000288,오패산로4길,841,540,301
2019,4,A,골목상권,1000287,오패산로3길,310,187,123
2019,4,A,골목상권,1000286,오패산로19길,101,36,65
2019,4,A,골목상권,1000285,안암로5길,960,743,217
2019,4,A,골목상권,1000284,아리랑로4길,595,281,314
2019,4,A,골목상권,1000283,솔샘로6길,74,48,26
2019,4,A,골목상권,1000282,성북로8길,143,88,55
2019,4,A,골목상권,1000281,삼양로8길,147,70,77
2019,4,A,골목상권,1000280,삼선교로16가길,99,42,57
2019,4,A,골목상권,1000279,삼선교로10다길,38,17,21
2019,4,A,골목상권,1000278,삼선교로10길,186,110,76
2019,4,A,골목상권,1000277,보문로32길,267,128,139
2019,4,A,골목상권,1000276,보문로31길,253,128,125
2019,4,A,골목상권,1000275,보문로26길,134,62,72
2019,4,A,골목상권,1000274,보문로13길,1048,741,307
2019,4,A,골목상권,1000273,보국문로16길,181,97,84
2019,4,A,골목상권,1000272,동소문로6길,62,28,34
2019,4,A,골목상권,1000271,동소문로2길,53,21,32
2019,4,A,골목상권,1000270,동소문로26가길,219,122,97
2019,4,A,골목상권,1000269,동소문로15길,209,152,57
2019,4,A,골목상권,1000268,동소문로13길,572,285,287
2019,4,A,골목상권,1000267,돌곶이로8길,117,75,42
2019,4,A,골목상권,1000266,돌곶이로41길,40,13,27
2019,4,A,골목상권,1000265,돌곶이로28길,222,96,126
2019,4,A,골목상권,1000264,돌곶이로27길,103,59,44
2019,4,A,골목상권,1000263,돌곶이로22길,61,34,27
2019,4,A,골목상권,1000262,돌곶이로14길,77,58,19
2019,4,A,골목상권,1000261,길음로7길,14,5,9
2019,4,A,골목상권,1000260,중랑천로10길,207,109,98
2019,4,A,골목상권,1000259,용마산로94길,304,259,45
2019,4,A,골목상권,1000258,용마산로118길,108,63,45
2019,4,A,골목상권,1000257,용마산로112길,114,69,45
2019,4,A,골목상권,1000256,용마산로100길,122,52,70
2019,4,A,골목상권,1000255,신내로7가길,276,115,161
2019,4,A,골목상권,1000254,사가정로54길,122,47,75
2019,4,A,골목상권,1000253,사가정로42길,183,89,94
2019,4,A,골목상권,1000252,봉화산로56길,649,289,360
2019,4,A,골목상권,1000251,봉화산로4길,58,30,28
2019,4,A,골목상권,1000250,봉화산로30길,139,38,101
2019,4,A,골목상권,1000249,봉우재로33길,150,59,91
2019,4,A,골목상권,1000248,면목로78길,93,44,49
2019,4,A,골목상권,1000247,면목로56길,91,53,38
2019,4,A,골목상권,1000246,면목로55길,473,306,167
2019,4,A,골목상권,1000245,면목로49길,109,67,42
2019,4,A,골목상권,1000244,면목로48길,873,544,329
2019,4,A,골목상권,1000243,면목로45길,454,364,90
2019,4,A,골목상권,1000242,면목로33길,86,28,58
2019,4,A,골목상권,1000241,면목로21길,54,37,17
2019,4,A,골목상권,1000240,망우로73길,51,34,17
2019,4,A,골목상권,1000239,망우로68길,107,44,63
2019,4,A,골목상권,1000238,동일로163길,112,67,45
2019,4,A,골목상권,1000237,동일로157길,443,270,173
2019,4,A,골목상권,1000236,동일로149길,870,749,121
2019,4,A,골목상권,1000235,동일로140길,432,314,118
2019,4,A,골목상권,1000234,동일로139길,77,53,24
2019,4,A,골목상권,1000233,동일로139가길,187,81,106
2019,4,A,골목상권,1000232,동일로130길,130,99,31
2019,4,A,골목상권,1000231,동일로123길,145,74,71
2019,4,A,골목상권,1000230,동일로112길,193,120,73
2019,4,A,골목상권,1000229,동일로101길,202,58,144
2019,4,A,골목상권,1000228,동일로100길,328,240,88
2019,4,A,골목상권,1000227,답십리로75길,57,33,24
2019,4,A,골목상권,1000226,공릉로2길,148,69,79
2019,4,A,골목상권,1000225,공릉로12가길,75,50,25
2019,4,A,골목상권,1000224,겸재로54길,131,79,52
2019,4,A,골목상권,1000223,겸재로36길,134,60,74
2019,4,A,골목상권,1000222,겸재로29길,126,74,52
2019,4,A,골목상권,1000221,휘경로3길,127,69,58
2019,4,A,골목상권,1000220,휘경로2길,138,88,50
2019,4,A,골목상권,1000219,휘경로23길,89,56,33
2019,4,A,골목상권,1000218,휘경로14길,113,41,72
2019,4,A,골목상권,1000217,한천로46길,257,101,156
2019,4,A,골목상권,1000216,한천로40길,90,57,33
2019,4,A,골목상권,1000215,한천로33길,203,76,127
2019,4,A,골목상권,1000214,한천로14길,696,440,256
2019,4,A,골목상권,1000213,천호대로97길,878,590,288
2019,4,A,골목상권,1000212,천호대로77길,169,111,58
2019,4,A,골목상권,1000211,천호대로45길,47,38,9
2019,4,A,골목상권,1000210,천호대로17길,2512,1893,619
2019,4,A,골목상권,1000209,천호대로12길,55,35,20
2019,4,A,골목상권,1000208,천장산로7길,74,32,42
2019,4,A,골목상권,1000207,제기로5길,45,39,6
2019,4,A,골목상권,1000206,제기로21길,101,62,39
2019,4,A,골목상권,1000205,전농로4길,274,210,64
2019,4,A,골목상권,1000204,전농로3길,170,120,50
2019,4,A,골목상권,1000203,전농로29길,461,336,125
2019,4,A,골목상권,1000202,장한로8길,438,295,143
2019,4,A,골목상권,1000201,장한로5길,314,189,125
2019,4,A,골목상권,1000200,장한로27길,167,119,48
2019,4,A,골목상권,1000199,장한로27가길,148,81,67
2019,4,A,골목상권,1000198,장한로26길,2436,1696,740
2019,4,A,골목상권,1000197,장한로26가길,122,87,35
2019,4,A,골목상권,1000196,장한로25길,408,210,198
2019,4,A,골목상권,1000195,장한로14길,179,98,81
2019,4,A,골목상권,1000194,이문로42길,48,29,19
2019,4,A,골목상권,1000193,왕산로43길,560,199,361
2019,4,A,골목상권,1000192,왕산로33길,72,30,42
2019,4,A,골목상권,1000191,왕산로32길,129,64,65
2019,4,A,골목상권,1000190,약령시로17길,109,77,32
2019,4,A,골목상권,1000189,서울시립대로4길,404,264,140
2019,4,A,골목상권,1000188,서울시립대로29길,368,263,105
2019,4,A,골목상권,1000187,서울시립대로16길,42,14,28
2019,4,A,골목상권,1000186,사가정로2길,268,177,91
2019,4,A,골목상권,1000185,사가정로23가길,84,46,38
2019,4,A,골목상권,1000184,사가정로13길,180,65,115
2019,4,A,골목상권,1000183,무학로45길,227,141,86
2019,4,A,골목상권,1000182,무학로16길,574,441,133
2019,4,A,골목상권,1000181,망우로21길,96,67,29
2019,4,A,골목상권,1000180,망우로18길,52,17,35
2019,4,A,골목상권,1000179,망우로18가길,114,75,39
2019,4,A,골목상권,1000178,답십리로72길,54,20,34
2019,4,A,골목상권,1000177,답십리로69길,533,270,263
2019,4,A,골목상권,1000176,답십리로68길,287,158,129
2019,4,A,골목상권,1000175,답십리로64길,103,73,30
2019,4,A,골목상권,1000174,답십리로63길,1747,1051,696
2019,4,A,골목상권,1000173,답십리로60길,341,213,128
2019,4,A,골목상권,1000172,답십리로56길,78,39,39
2019,4,A,골목상권,1000171,답십리로23길,47,22,25
2019,4,A,골목상권,1000170,난계로30길,4980,2233,2747
2019,4,A,골목상권,1000169,경희대로4길,41,18,23
2019,4,A,골목상권,1000168,경희대로3길,28,16,12
2019,4,A,골목상권,1000167,천호대로129길,344,207,137
2019,4,A,골목상권,1000166,천호대로123길,625,282,343
2019,4,A,골목상권,1000165,천호대로109길,915,504,411
2019,4,A,골목상권,1000164,자양번영로3길,587,462,125
2019,4,A,골목상권,1000163,자양로53길,170,120,50
2019,4,A,골목상권,1000162,자양로50길,218,121,97
2019,4,A,골목상권,1000161,자양로45길,448,184,264
2019,4,A,골목상권,1000160,자양로26길,141,91,50
2019,4,A,골목상권,1000159,자양로15길,106,45,61
2019,4,A,골목상권,1000158,자양로11길,646,250,396
2019,4,A,골목상권,1000157,용마산로3길,541,431,110
2019,4,A,골목상권,1000156,용마산로21길,396,253,143
2019,4,A,골목상권,1000155,아차산로78길,575,421,154
2019,4,A,골목상권,1000154,아차산로65길,357,214,143
2019,4,A,골목상권,1000153,아차산로55길,243,150,93
2019,4,A,골목상권,1000152,아차산로51길,432,110,322
2019,4,A,골목상권,1000151,아차산로40길,357,207,150
2019,4,A,골목상권,1000150,면목로17길,230,138,92
2019,4,A,골목상권,1000149,뚝섬로64길,239,127,112
2019,4,A,골목상권,1000148,뚝섬로58길,278,141,137
2019,4,A,골목상권,1000147,뚝섬로54길,948,798,150
2019,4,A,골목상권,1000146,뚝섬로48길,228,134,94
2019,4,A,골목상권,1000145,뚝섬로24길,111,66,45
2019,4,A,골목상권,1000144,뚝섬로23길,209,148,61
2019,4,A,골목상권,1000143,동일로24길,42,32,10
2019,4,A,골목상권,1000142,동일로18길,79,54,25
2019,4,A,골목상권,1000141,능동로4길,947,834,113
2019,4,A,골목상권,1000140,능동로3길,71,45,26
2019,4,A,골목상권,1000139,능동로34길,1018,676,342
2019,4,A,골목상권,1000138,능동로19길,133,77,56
2019,4,A,골목상권,1000137,능동로13길,221,109,112
2019,4,A,골목상권,1000136,긴고랑로9길,138,51,87
2019,4,A,골목상권,1000135,긴고랑로8길,947,573,374
2019,4,A,골목상권,1000134,긴고랑로7길,460,353,107
2019,4,A,골목상권,1000133,긴고랑로20길,174,98,76
2019,4,A,골목상권,1000132,광나루로52길,649,395,254
2019,4,A,골목상권,1000131,광나루로40길,242,128,114
2019,4,A,골목상권,1000130,광나루로37길,60,29,31
2019,4,A,골목상권,1000129,광나루로36길,412,169,243
2019,4,A,골목상권,1000128,광나루로24길,25,12,13
2019,4,A,골목상권,1000127,광나루로12길,60,19,41
2019,4,A,골목상권,1000126,한림말길,355,174,181
2019,4,A,골목상권,1000125,한림말3길,3329,1128,2201
2019,4,A,골목상권,1000124,청계천로10나길,4951,3728,1223
2019,4,A,골목상권,1000123,장터길,90,46,44
2019,4,A,골목상권,1000122,용답중앙길,93,66,27
2019,4,A,골목상권,1000121,용답29길,537,360,177
2019,4,A,골목상권,1000120,왕십리로6길,538,350,188
2019,4,A,골목상권,1000119,왕십리로31길,208,95,113
2019,4,A,골목상권,1000118,왕십리로26길,2076,1357,719
2019,4,A,골목상권,1000117,왕십리로21길,164,77,87
2019,4,A,골목상권,1000116,왕십리로14길,997,776,221
2019,4,A,골목상권,1000115,아차산로5길,1871,1041,830
2019,4,A,골목상권,1000114,아차산로15길,3361,2374,987
2019,4,A,골목상권,1000113,아차산로11길,3213,2213,1000
2019,4,A,골목상권,1000112,송정4가길,291,123,168
2019,4,A,골목상권,1000111,송정12라길,94,48,46
2019,4,A,골목상권,1000110,성수일로6길,1342,928,414
2019,4,A,골목상권,1000109,성수이로7길,1442,895,547
2019,4,A,골목상권,1000108,성수이로18길,2988,1968,1020
2019,4,A,골목상권,1000107,성덕정길,227,152,75
2019,4,A,골목상권,1000106,성덕정17길,393,244,149
2019,4,A,골목상권,1000105,서울숲2길,335,196,139
2019,4,A,골목상권,1000104,상원길,1919,1334,585
2019,4,A,골목상권,1000103,상원12길,398,238,160
2019,4,A,골목상권,1000102,사근동길,78,48,30
2019,4,A,골목상권,1000101,무학봉길,22,11,11
2019,4,A,골목상권,1000100,무학봉28길,143,69,74
2019,4,A,골목상권,1000099,무학로6길,1897,382,1515
2019,4,A,골목상권,1000098,무수막길,164,122,42
2019,4,A,골목상권,1000097,매봉길,60,30,30
2019,4,A,골목상권,1000096,마조로1길,30,14,16
2019,4,A,골목상권,1000095,마조로16길,155,93,62
2019,4,A,골목상권,1000094,마장로39길,443,258,185
2019,4,A,골목상권,1000093,마장로27길,197,92,105
2019,4,A,골목상권,1000092,뚝섬로5길,2136,1426,710
2019,4,A,골목상권,1000091,둘레9길,419,255,164
2019,4,A,골목상권,1000090,금호산길,159,83,76
2019,4,A,골목상권,1000089,금호산2길,22,12,10
2019,4,A,골목상권,1000088,고산자로6길,704,495,209
2019,4,A,골목상권,1000087,후암로28길,582,313,269
2019,4,A,골목상권,1000086,효창원로39길,163,87,76
2019,4,A,골목상권,1000085,회나무로13길,90,45,45
2019,4,A,골목상권,1000084,한남대로20길,231,131,100
2019,4,A,골목상권,1000083,한강대로88길,224,138,86
2019,4,A,골목상권,1000082,한강대로7길,722,462,260
2019,4,A,골목상권,1000081,한강대로62길,1047,535,512
2019,4,A,골목상권,1000080,한강대로52길,8713,2847,5866
2019,4,A,골목상권,1000079,한강대로43길,1841,1074,767
2019,4,A,골목상권,1000078,한강대로15길,774,417,357
2019,4,A,골목상권,1000077,한강대로104길,8152,1754,6398
2019,4,A,골목상권,1000076,청파로73길,248,128,120
2019,4,A,골목상권,1000075,청파로71길,1317,727,590
2019,4,A,골목상권,1000074,청파로47나길,259,176,83
2019,4,A,골목상권,1000073,청파로47길,192,87,105
2019,4,A,골목상권,1000072,장문로45길,242,106,136
2019,4,A,골목상권,1000071,이태원로54길,812,552,260
2019,4,A,골목상권,1000070,이태원로27길,567,430,137
2019,4,A,골목상권,1000069,이촌로22길,385,307,78
2019,4,A,골목상권,1000068,원효로89길,1387,969,418
2019,4,A,골목상권,1000067,원효로53길,341,222,119
2019,4,A,골목상권,1000066,원효로41길,243,153,90
2019,4,A,골목상권,1000065,원효로19길,609,435,174
2019,4,A,골목상권,1000064,우사단로4길,308,143,165
2019,4,A,골목상권,1000063,우사단로14길,1987,984,1003
2019,4,A,골목상권,1000062,우사단로10길,570,508,62
2019,4,A,골목상권,1000061,신흥로20길,178,118,60
2019,4,A,골목상권,1000060,소월로20길,151,76,75
2019,4,A,골목상권,1000059,서빙고로71길,432,265,167
2019,4,A,골목상권,1000058,백범로90길,535,288,247
2019,4,A,골목상권,1000057,백범로79길,899,560,339
2019,4,A,골목상권,1000056,두텁바위로1길,1111,483,628
2019,4,A,골목상권,1000055,대사관로34길,606,393,213
2019,4,A,골목상권,1000054,녹사평대로46길,43,19,24
2019,4,A,골목상권,1000053,녹사평대로40나길,46,21,25
2019,4,A,골목상권,1000052,녹사평대로32길,56,31,25
2019,4,A,골목상권,1000051,녹사평대로26길,494,230,264
2019,4,A,골목상권,1000050,녹사평대로11길,107,78,29
2019,4,A,골목상권,1000049,퇴계로90길,463,225,238
2019,4,A,골목상권,1000048,퇴계로8길,438,246,192
2019,4,A,골목상권,1000047,퇴계로56길,569,424,145
2019,4,A,골목상권,1000046,퇴계로46길,1098,613,485
2019,4,A,골목상권,1000045,퇴계로18길,967,435,532
2019,4,A,골목상권,1000044,퇴계로12길,180,103,77
2019,4,A,골목상권,1000043,청구로1길,108,72,36
2019,4,A,골목상권,1000042,청구로17길,485,306,179
2019,4,A,골목상권,1000041,장충단로8길,3778,1997,1781
2019,4,A,골목상권,1000040,삼일대로4길,1571,1113,458
2019,4,A,골목상권,1000039,명동길,7830,4550,3280
2019,4,A,골목상권,1000038,동호로8길,386,160,226
2019,4,A,골목상권,1000037,동호로20길,2429,1304,1125
2019,4,A,골목상권,1000036,동호로15길,1161,835,326
2019,4,A,골목상권,1000035,동호로11길,337,208,129
2019,4,A,골목상권,1000034,동호로10길,1553,857,696
2019,4,A,골목상권,1000033,다산로39길,39,19,20
2019,4,A,골목상권,1000032,다산로38길,674,311,363
2019,4,A,골목상권,1000031,다산로36길,91,55,36
2019,4,A,골목상권,1000030,다산로33길,320,201,119
2019,4,A,골목상권,1000029,난계로21길,128,93,35
2019,4,A,골목상권,1000028,난계로11길,255,170,85
2019,4,A,골목상권,1000027,필운대로1길,202,62,140
2019,4,A,골목상권,1000026,평창길,6654,2605,4049
2019,4,A,골목상권,1000025,통일로12길,13,6,7
2019,4,A,골목상권,1000024,창신길,146,29,117
2019,4,A,골목상권,1000023,창신5길,15,7,8
2019,4,A,골목상권,1000022,창신2길,56,26,30
2019,4,A,골목상권,1000021,창경궁로35길,787,171,616
2019,4,A,골목상권,1000020,지봉로8길,183,90,93
2019,4,A,골목상권,1000019,종로65길,275,157,118
2019,4,A,골목상권,1000018,종로58가길,137,71,66
2019,4,A,골목상권,1000017,종로24길,1011,716,295
2019,4,A,골목상권,1000016,자하문로7길,214,83,131
2019,4,A,골목상권,1000015,이화장길,497,221,276
2019,4,A,골목상권,1000014,율곡로16길,235,143,92
2019,4,A,골목상권,1000013,율곡로10길,313,206,107
2019,4,A,골목상권,1000012,옥인길,58,32,26
2019,4,A,골목상권,1000011,숭인동길,329,133,196
2019,4,A,골목상권,1000010,성균관로5길,148,84,64
2019,4,A,골목상권,1000009,삼청로5길,2703,2626,77
2019,4,A,골목상권,1000008,북촌로5나길,234,113,121
2019,4,A,골목상권,1000007,북촌로5길,503,419,84
2019,4,A,골목상권,1000006,북촌로11길,671,232,439
2019,4,A,골목상권,1000005,백석동길,1797,1066,731
2019,4,A,골목상권,1000004,명륜길,56,32,24
2019,4,A,골목상권,1000003,돈화문로11가길,3686,2700,986
2019,4,A,골목상권,1000002,난계로27길,201,114,87
2019,4,A,골목상권,1000001,계동길,842,388,454
2019,3,U,관광특구,1001496,강남 마이스 관광특구,18430,10279,8151
2019,3,U,관광특구,1001495,잠실 관광특구,26843,16958,9885
2019,3,U,관광특구,1001494,종로?청계 관광특구,24700,16394,8306
2019,3,U,관광특구,1001493,동대문패션타운 관광특구,6683,3404,3279
2019,3,U,관광특구,1001492,명동 남대문 북창동 다동 무교동 관광특구,133878,65609,68269
2019,3,U,관광특구,1001491,이태원 관광특구,5797,3200,2597
2019,3,R,전통시장,1001490,길동복조리시장,431,268,163
2019,3,R,전통시장,1001489,둔촌역전통시장,188,104,84
2019,3,R,전통시장,1001488,성내골목시장,35,20,15
2019,3,R,전통시장,1001487,천호시장,32,20,12
2019,3,R,전통시장,1001486,동서울시장,10,5,5
2019,3,R,전통시장,1001485,고분다리골목시장,7,2,5
2019,3,R,전통시장,1001484,양지골목시장,91,61,30
2019,3,R,전통시장,1001483,암사종합시장,80,50,30
2019,3,R,전통시장,1001482,고덕전통시장,1029,945,84
2019,3,R,전통시장,1001481,명일골목시장,87,37,50
2019,3,R,전통시장,1001480,새마을시장,178,105,73
2019,3,R,전통시장,1001479,석촌시장,414,148,266
2019,3,R,전통시장,1001478,방이시장,3029,1247,1782
2019,3,R,전통시장,1001477,마천시장,111,76,35
2019,3,R,전통시장,1001476,풍납시장,63,27,36
2019,3,R,전통시장,1001475,강남개포시장,81,50,31
2019,3,R,전통시장,1001474,도곡시장,58,27,31
2019,3,R,전통시장,1001473,청담삼익시장,60,37,23
2019,3,R,전통시장,1001472,논현종합시장,83,41,42
2019,3,R,전통시장,1001471,영동전통시장,255,106,149
2019,3,R,전통시장,1001470,강남시장_강남,60,39,21
2019,3,R,전통시장,1001469,양재시장,36,23,13
2019,3,R,전통시장,1001468,남부종합시장,69,50,19
2019,3,R,전통시장,1001467,우림시장,55,33,22
2019,3,R,전통시장,1001466,미성동도깨비시장,92,27,65
2019,3,R,전통시장,1001465,신신림시장,1,1,0
2019,3,R,전통시장,1001464,삼성동시장,16,7,9
2019,3,R,전통시장,1001463,신림중앙시장,42,24,18
2019,3,R,전통시장,1001462,강남골목시장,197,118,79
2019,3,R,전통시장,1001461,신림종합시장,6,5,1
2019,3,R,전통시장,1001460,관악신사시장,148,89,59
2019,3,R,전통시장,1001459,신원시장,38,15,23
2019,3,R,전통시장,1001458,인헌시장,131,47,84
2019,3,R,전통시장,1001457,봉천중앙시장,178,53,125
2019,3,R,전통시장,1001456,봉천현대시장,5,2,3
2019,3,R,전통시장,1001455,봉일시장,49,24,25
2019,3,R,전통시장,1001454,봉천제일종합시장,6,1,5
2019,3,R,전통시장,1001453,낙성대시장,24,14,10
2019,3,R,전통시장,1001452,중부시장,85,33,52
2019,3,R,전통시장,1001451,사당시장,73,37,36
2019,3,R,전통시장,1001450,남성역골목시장,490,271,219
2019,3,R,전통시장,1001449,남성사계시장,124,56,68
2019,3,R,전통시장,1001448,흑석시장,87,35,52
2019,3,R,전통시장,1001447,상도4동도깨비골목시장,100,37,63
2019,3,R,전통시장,1001446,성대시장,147,60,87
2019,3,R,전통시장,1001445,영도시장,72,6,66
2019,3,R,전통시장,1001444,상도전통시장,235,115,120
2019,3,R,전통시장,1001443,강남시장_동작,1,0,1
2019,3,R,전통시장,1001442,신노량진시장,5,1,4
2019,3,R,전통시장,1001441,본동인정시장,67,45,22
2019,3,R,전통시장,1001440,노량진중앙시장,181,104,77
2019,3,R,전통시장,1001439,대림중앙시장,41,29,12
2019,3,R,전통시장,1001438,우리시장,11,10,1
2019,3,R,전통시장,1001437,영진시장A동,27,16,11
2019,3,R,전통시장,1001436,사러가시장,83,44,39
2019,3,R,전통시장,1001435,대신시장,39,23,16
2019,3,R,전통시장,1001433,영일시장,174,128,46
2019,3,R,전통시장,1001432,도림시장,7,5,2
2019,3,R,전통시장,1001431,영등포청과시장,30,21,9
2019,3,R,전통시장,1001430,영등포전통시장,1918,1031,887
2019,3,R,전통시장,1001429,은행나무시장,62,35,27
2019,3,R,전통시장,1001428,박미시장,33,24,9
2019,3,R,전통시장,1001427,현대시장,121,55,66
2019,3,R,전통시장,1001426,대명시장,38,17,21
2019,3,R,전통시장,1001425,푸른터시장,4,2,2
2019,3,R,전통시장,1001424,남문시장,82,56,26
2019,3,R,전통시장,1001423,독산동 우시장,605,473,132
2019,3,R,전통시장,1001422,오류시장,77,23,54
2019,3,R,전통시장,1001421,개봉중앙시장,15,10,5
2019,3,R,전통시장,1001420,고척근린시장,60,13,47
2019,3,R,전통시장,1001419,가리봉시장,1,1,0
2019,3,R,전통시장,1001418,남구로시장,73,24,49
2019,3,R,전통시장,1001417,구로시장,15,9,6
2019,3,R,전통시장,1001416,공항시장,5,4,1
2019,3,R,전통시장,1001415,방신전통시장,94,61,33
2019,3,R,전통시장,1001414,송화골목시장,127,44,83
2019,3,R,전통시장,1001413,까치산시장,121,37,84
2019,3,R,전통시장,1001412,화곡본동시장,50,21,29
2019,3,R,전통시장,1001411,남부골목시장,124,41,83
2019,3,R,전통시장,1001410,대원종합시장,7,6,1
2019,3,R,전통시장,1001409,화곡중앙골목시장,138,68,70
2019,3,R,전통시장,1001408,신월중앙시장,118,53,65
2019,3,R,전통시장,1001407,등마루시장,3,3,0
2019,3,R,전통시장,1001406,신정3동골목시장,111,72,39
2019,3,R,전통시장,1001405,신정2동골목시장,45,10,35
2019,3,R,전통시장,1001404,신정제일시장,27,8,19
2019,3,R,전통시장,1001403,신월7동골목시장,43,22,21
2019,3,R,전통시장,1001402,신월6동골목시장,184,116,68
2019,3,R,전통시장,1001400,신월3동골목시장,10,6,4
2019,3,R,전통시장,1001399,경창시장,56,18,38
2019,3,R,전통시장,1001398,월정로시장,71,49,22
2019,3,R,전통시장,1001397,신영시장,54,25,29
2019,3,R,전통시장,1001396,목4동시장,84,48,36
2019,3,R,전통시장,1001395,목3동시장,181,82,99
2019,3,R,전통시장,1001394,목2동시장,426,233,193
2019,3,R,전통시장,1001393,마포농수산물시장,329,231,98
2019,3,R,전통시장,1001392,동진시장,10,5,5
2019,3,R,전통시장,1001391,망원월드컵시장,232,141,91
2019,3,R,전통시장,1001390,망원시장,186,86,100
2019,3,R,전통시장,1001389,합정시장,24,10,14
2019,3,R,전통시장,1001388,영진시장,23,12,11
2019,3,R,전통시장,1001387,서교시장,48,31,17
2019,3,R,전통시장,1001386,신수시장,28,16,12
2019,3,R,전통시장,1001385,아현시장,839,461,378
2019,3,R,전통시장,1001384,마포시장,8,3,5
2019,3,R,전통시장,1001383,공덕시장,3883,1806,2077
2019,3,R,전통시장,1001382,백련시장,57,47,10
2019,3,R,전통시장,1001381,모래내시장,14,9,5
2019,3,R,전통시장,1001380,포방터시장,71,53,18
2019,3,R,전통시장,1001379,인왕시장,51,7,44
2019,3,R,전통시장,1001378,아현가구거리상점가,51,28,23
2019,3,R,전통시장,1001377,영천시장,58,25,33
2019,3,R,전통시장,1001376,수일시장,9,4,5
2019,3,R,전통시장,1001375,증산종합시장,65,12,53
2019,3,R,전통시장,1001374,대림골목시장,234,46,188
2019,3,R,전통시장,1001373,신응암시장,18,12,6
2019,3,R,전통시장,1001372,녹번시장,30,14,16
2019,3,R,전통시장,1001371,대조시장,11,4,7
2019,3,R,전통시장,1001370,역촌중앙시장,2,2,0
2019,3,R,전통시장,1001369,갈현시장,1,1,0
2019,3,R,전통시장,1001368,연서시장,200,139,61
2019,3,R,전통시장,1001367,상계중앙시장,132,67,65
2019,3,R,전통시장,1001366,상계시장,9,3,6
2019,3,R,전통시장,1001365,공릉동도깨비시장,209,165,44
2019,3,R,전통시장,1001364,방학동도깨비시장,46,16,30
2019,3,R,전통시장,1001363,쌍문역골목시장,58,14,44
2019,3,R,전통시장,1001362,백운시장,30,13,17
2019,3,R,전통시장,1001361,신도봉시장,9,6,3
2019,3,R,전통시장,1001360,창동골목시장,106,52,54
2019,3,R,전통시장,1001359,창동신창시장,82,33,49
2019,3,R,전통시장,1001358,수유북부시장,19,13,6
2019,3,R,전통시장,1001357,장미원골목시장,958,615,343
2019,3,R,전통시장,1001356,수유중앙시장,9,5,4
2019,3,R,전통시장,1001355,강북종합시장,45,24,21
2019,3,R,전통시장,1001354,우이시장,70,53,17
2019,3,R,전통시장,1001353,수유전통시장,133,68,65
2019,3,R,전통시장,1001352,번동북부골목시장,51,27,24
2019,3,R,전통시장,1001351,솔샘시장,86,36,50
2019,3,R,전통시장,1001350,숭인시장,57,25,32
2019,3,R,전통시장,1001349,방천골목시장,98,61,37
2019,3,R,전통시장,1001348,동북시장,104,39,65
2019,3,R,전통시장,1001347,석관황금시장,177,147,30
2019,3,R,전통시장,1001346,석관시장,30,19,11
2019,3,R,전통시장,1001345,새석관시장,4,1,3
2019,3,R,전통시장,1001344,번동시장,15,11,4
2019,3,R,전통시장,1001343,장위전통시장,74,43,31
2019,3,R,전통시장,1001342,밤나무골시장,13,1,12
2019,3,R,전통시장,1001341,길음시장,18,5,13
2019,3,R,전통시장,1001340,정릉시장,115,58,57
2019,3,R,전통시장,1001339,정릉아리랑시장,35,10,25
2019,3,R,전통시장,1001338,돈암제일시장,102,27,75
2019,3,R,전통시장,1001337,유영시장,32,7,25
2019,3,R,전통시장,1001336,우림골목시장,345,123,222
2019,3,R,전통시장,1001335,묵1동도깨비시장,43,36,7
2019,3,R,전통시장,1001334,태능시장,57,17,40
2019,3,R,전통시장,1001333,중화제일시장,66,28,38
2019,3,R,전통시장,1001332,사가정시장,93,39,54
2019,3,R,전통시장,1001331,면목골목시장,56,22,34
2019,3,R,전통시장,1001330,동원시장,230,100,130
2019,3,R,전통시장,1001329,동부골목시장,184,69,115
2019,3,R,전통시장,1001328,이문제일시장,1,1,0
2019,3,R,전통시장,1001327,이경시장,14,7,7
2019,3,R,전통시장,1001326,회기시장,63,18,45
2019,3,R,전통시장,1001325,청량리청과물시장,11,7,4
2019,3,R,전통시장,1001324,전곡시장,71,38,33
2019,3,R,전통시장,1001323,답십리시장,99,41,58
2019,3,R,전통시장,1001322,동부시장,13,8,5
2019,3,R,전통시장,1001321,답십리현대시장,53,45,8
2019,3,R,전통시장,1001320,전농로터리시장,17,10,7
2019,3,R,전통시장,1001319,청량리종합시장,18,11,7
2019,3,R,전통시장,1001318,청량리전통시장,9,7,2
2019,3,R,전통시장,1001317,청량리농수산물시장,15,12,3
2019,3,R,전통시장,1001316,서울약령시장,1213,668,545
2019,3,R,전통시장,1001315,동서시장,4,3,1
2019,3,R,전통시장,1001314,경동시장,148,67,81
2019,3,R,전통시장,1001313,청량리수산시장,20,12,8
2019,3,R,전통시장,1001312,용두시장,4,2,2
2019,3,R,전통시장,1001310,구의시장,8,4,4
2019,3,R,전통시장,1001309,조양시장,33,18,15
2019,3,R,전통시장,1001308,영동교골목시장,19,12,7
2019,3,R,전통시장,1001307,능동로골목시장,10,9,1
2019,3,R,전통시장,1001306,노룬산골목시장,26,14,12
2019,3,R,전통시장,1001305,자양종합시장,16,10,6
2019,3,R,전통시장,1001304,자양골목시장,63,34,29
2019,3,R,전통시장,1001303,신성골목시장,10,3,7
2019,3,R,전통시장,1001302,면곡골목시장,62,44,18
2019,3,R,전통시장,1001301,중곡제일시장,122,70,52
2019,3,R,전통시장,1001300,화양제일골목시장,30,7,23
2019,3,R,전통시장,1001299,한아름시장,68,43,25
2019,3,R,전통시장,1001298,성동용답상가시장,55,31,24
2019,3,R,전통시장,1001297,뚝도시장,62,36,26
2019,3,R,전통시장,1001296,금남시장,31,12,19
2019,3,R,전통시장,1001295,행당시장,342,155,187
2019,3,R,전통시장,1001294,마장축산물시장,615,416,199
2019,3,R,전통시장,1001293,보광시장,14,6,8
2019,3,R,전통시장,1001292,이태원제일시장,3,2,1
2019,3,R,전통시장,1001291,이태원시장,50,30,20
2019,3,R,전통시장,1001290,이촌종합시장,100,71,29
2019,3,R,전통시장,1001289,용문전통시장,25,9,16
2019,3,R,전통시장,1001288,만리시장,15,12,3
2019,3,R,전통시장,1001287,신흥시장,7,4,3
2019,3,R,전통시장,1001286,후암시장,22,20,2
2019,3,R,전통시장,1001285,합동(새벽)시장,715,487,228
2019,3,R,전통시장,1001284,서울중앙시장,497,345,152
2019,3,R,전통시장,1001283,백학시장,102,52,50
2019,3,R,전통시장,1001282,약수시장,288,129,159
2019,3,R,전통시장,1001281,청평화시장,117,45,72
2019,3,R,전통시장,1001280,제일평화시장,66,37,29
2019,3,R,전통시장,1001279,동평화시장,216,148,68
2019,3,R,전통시장,1001278,남평화시장,3,2,1
2019,3,R,전통시장,1001277,방산종합시장,1245,767,478
2019,3,R,전통시장,1001276,평화시장,1433,1006,427
2019,3,R,전통시장,1001275,인현시장,180,126,54
2019,3,R,전통시장,1001274,신중부시장,3125,1030,2095
2019,3,R,전통시장,1001273,남대문시장,6883,2898,3985
2019,3,R,전통시장,1001272,신설종합시장,35,25,10
2019,3,R,전통시장,1001271,동묘시장,554,263,291
2019,3,R,전통시장,1001270,창신골목시장,18,9,9
2019,3,R,전통시장,1001269,동문시장,10,6,4
2019,3,R,전통시장,1001268,충신시장,53,30,23
2019,3,R,전통시장,1001267,종로신진시장,180,102,78
2019,3,R,전통시장,1001266,동대문종합시장,1459,1062,397
2019,3,R,전통시장,1001265,광장시장,395,276,119
2019,3,R,전통시장,1001264,통인시장,72,32,40
2019,3,D,발달상권,1001263,서울 노원구 노원역_3,485,181,304
2019,3,D,발달상권,1001262,서울 노원구 노원역_2,297,130,167
2019,3,D,발달상권,1001261,서울 노원구 노원역_1,401,96,305
2019,3,D,발달상권,1001260,창동역,1106,645,461
2019,3,D,발달상권,1001259,서울 강북구 수유역_3,97,49,48
2019,3,D,발달상권,1001258,등나무근린공원 주변,73,24,49
2019,3,D,발달상권,1001257,서울 강북구 수유역_2,2296,1126,1170
2019,3,D,발달상권,1001256,서울 강북구 수유역_1,870,443,427
2019,3,D,발달상권,1001255,서울 은평구 연신내역_3,106,20,86
2019,3,D,발달상권,1001254,서울 은평구 연신내역_2,598,172,426
2019,3,D,발달상권,1001253,서울 은평구 연신내역_1,58,23,35
2019,3,D,발달상권,1001252,서울 성북구 미아삼거리역_2,292,137,155
2019,3,D,발달상권,1001251,서울 강북구 미아삼거리역_1,307,207,100
2019,3,D,발달상권,1001250,서울 은평구 불광역_3,87,31,56
2019,3,D,발달상권,1001249,서울 은평구 불광역_2,118,40,78
2019,3,D,발달상권,1001248,서울 은평구 불광역_1,222,105,117
2019,3,D,발달상권,1001247,미아사거리_2,97,50,47
2019,3,D,발달상권,1001246,미아사거리_1,200,96,104
2019,3,D,발달상권,1001245,서울 성북구 성신여대입구역,1309,888,421
2019,3,D,발달상권,1001244,경희대학교,82,32,50
2019,3,D,발달상권,1001243,서울 성북구 안암역,76,39,37
2019,3,D,발달상권,1001242,혜화역 대학로_3,516,229,287
2019,3,D,발달상권,1001241,혜화역 대학로_2,337,266,71
2019,3,D,발달상권,1001240,혜화역 대학로_1,1581,798,783
2019,3,D,발달상권,1001239,디지털미디어시티,6841,4400,2441
2019,3,D,발달상권,1001238,서울 동대문구 청량리역,925,471,454
2019,3,D,발달상권,1001237,서울 종로구 경복궁역_2,305,143,162
2019,3,D,발달상권,1001236,서울 종로구 안국역_2,1657,826,831
2019,3,D,발달상권,1001235,서울 종로구 안국역_1,3070,2122,948
2019,3,D,발달상권,1001234,서울 종로구 경복궁역_1,633,422,211
2019,3,D,발달상권,1001233,서울 종로구 종로3가역_3,1208,595,613
2019,3,D,발달상권,1001232,서울 종로구 종로3가역_2,909,446,463
2019,3,D,발달상권,1001231,서울 동대문구 신설동역_2,4387,1150,3237
2019,3,D,발달상권,1001230,인사동,25772,15160,10612
2019,3,D,발달상권,1001229,서울 종로구 종로5가역_4,1304,937,367
2019,3,D,발달상권,1001228,서울 종로구 종로5가역_3,1775,1159,616
2019,3,D,발달상권,1001227,종로구청,22114,12078,10036
2019,3,D,발달상권,1001226,서울 종로구 종로5가역_2,11914,7932,3982
2019,3,D,발달상권,1001225,신설동역,202,110,92
2019,3,D,발달상권,1001224,서울 동대문구 신설동역_1,749,320,429
2019,3,D,발달상권,1001223,서울 종로구 광화문역_2,25717,16545,9172
2019,3,D,발달상권,1001222,동묘앞역,869,772,97
2019,3,D,발달상권,1001221,장안동사거리,1764,644,1120
2019,3,D,발달상권,1001220,서울 종로구 동대문역_2,751,232,519
2019,3,D,발달상권,1001219,서울 종로구 동대문역_1,31,18,13
2019,3,D,발달상권,1001218,동대문시장_2,235,139,96
2019,3,D,발달상권,1001217,서울 종로구 종로5가역_1,30,13,17
2019,3,D,발달상권,1001216,서울 종로구 종로3가역_1,2698,1215,1483
2019,3,D,발달상권,1001215,서울 종로구 광화문역_1,14333,8386,5947
2019,3,D,발달상권,1001214,종각역,10055,7801,2254
2019,3,D,발달상권,1001213,종각역 젊음의 거리,3763,2264,1499
2019,3,D,발달상권,1001212,서대문구 서대문역_1,89,60,29
2019,3,D,발달상권,1001211,동대문시장_1,1597,460,1137
2019,3,D,발달상권,1001210,시청역_2,14293,9492,4801
2019,3,D,발달상권,1001209,서울시청,9762,5303,4459
2019,3,D,발달상권,1001208,서울 중구 을지로3가역_2,3297,2165,1132
2019,3,D,발달상권,1001207,서울 중구 신당역_2,764,425,339
2019,3,D,발달상권,1001206,서대문구 서대문역_2,1313,917,396
2019,3,D,발달상권,1001205,동대문역사문화공원역,3244,2583,661
2019,3,D,발달상권,1001204,서울 중구 을지로3가역_1,4668,2292,2376
2019,3,D,발달상권,1001203,명동거리,33325,13963,19362
2019,3,D,발달상권,1001202,롯데백화점,24501,9056,15445
2019,3,D,발달상권,1001201,서울 중구 신당역_1,397,195,202
2019,3,D,발달상권,1001200,북창동,6996,3577,3419
2019,3,D,발달상권,1001199,서울 중구 충무로역_2,17551,7586,9965
2019,3,D,발달상권,1001198,서울 강서구 송정역,407,199,208
2019,3,D,발달상권,1001197,장한평역_2,1648,1063,585
2019,3,D,발달상권,1001196,시청역_1,38617,23204,15413
2019,3,D,발달상권,1001195,왕십리역_2,295,151,144
2019,3,D,발달상권,1001194,서울 강서구 발산역,1381,854,527
2019,3,D,발달상권,1001193,장한평역_1,1134,766,368
2019,3,D,발달상권,1001192,서울 중구 충무로역_1,4375,2786,1589
2019,3,D,발달상권,1001191,왕십리역_1,20,11,9
2019,3,D,발달상권,1001190,장한평역,3895,2272,1623
2019,3,D,발달상권,1001189,서울 중구 명동역,10846,7088,3758
2019,3,D,발달상권,1001188,장충동 족발거리,2514,1233,1281
2019,3,D,발달상권,1001187,한양시장,44,22,22
2019,3,D,발달상권,1001186,서울 서대문구 이대역,377,158,219
2019,3,D,발달상권,1001185,서울 서대문구 신촌역,969,401,568
2019,3,D,발달상권,1001184,서울 마포구 홍대입구역_3,877,348,529
2019,3,D,발달상권,1001183,서울 마포구 홍대입구역_2,1685,599,1086
2019,3,D,발달상권,1001182,홍익대학교 주변,10364,5912,4452
2019,3,D,발달상권,1001181,서울 광진구 군자역,726,433,293
2019,3,D,발달상권,1001180,신촌역,849,329,520
2019,3,D,발달상권,1001179,강서구청,4335,2630,1705
2019,3,D,발달상권,1001178,서울 마포구 홍대입구역_1,1608,858,750
2019,3,D,발달상권,1001177,서울 중구 약수역_2,206,95,111
2019,3,D,발달상권,1001176,서울 중구 약수역_1,13,3,10
2019,3,D,발달상권,1001175,서울 강동구 고덕역,1023,653,370
2019,3,D,발달상권,1001174,등촌역,111,55,56
2019,3,D,발달상권,1001173,서울 강동구 명일역,663,252,411
2019,3,D,발달상권,1001172,어린이대공원역,47,15,32
2019,3,D,발달상권,1001171,서울 마포구 공덕역_2,3874,2494,1380
2019,3,D,발달상권,1001170,공덕역,2470,1444,1026
2019,3,D,발달상권,1001169,서울 용산구 숙대입구역,2911,571,2340
2019,3,D,발달상권,1001168,남영역,6921,4022,2899
2019,3,D,발달상권,1001167,서울 마포구 공덕역_1,5172,3743,1429
2019,3,D,발달상권,1001166,서울 마포구 마포역_2,13137,8053,5084
2019,3,D,발달상권,1001165,서울 광진구 건대입구역_2,551,301,250
2019,3,D,발달상권,1001164,서울 마포구 마포역_1,3431,2457,974
2019,3,D,발달상권,1001163,서울 강동구 천호역_2,2198,1018,1180
2019,3,D,발달상권,1001162,서울 광진구 건대입구역_1,154,67,87
2019,3,D,발달상권,1001161,건대입구역,362,212,150
2019,3,D,발달상권,1001160,서울 광진구 구의역,914,588,326
2019,3,D,발달상권,1001159,서울 강동구 천호역,327,139,188
2019,3,D,발달상권,1001158,당산역_2,1672,1152,520
2019,3,D,발달상권,1001157,서울 강동구 천호역_1,178,74,104
2019,3,D,발달상권,1001156,서울 강동구 길동역,2749,1262,1487
2019,3,D,발달상권,1001155,용산 전자상가_5,2223,1678,545
2019,3,D,발달상권,1001154,용산 전자상가_4,349,252,97
2019,3,D,발달상권,1001153,당산역_1,331,183,148
2019,3,D,발달상권,1001152,서울 광진구 강변역,2160,1695,465
2019,3,D,발달상권,1001151,용산 전자상가_3,2244,1656,588
2019,3,D,발달상권,1001150,서울 용산구 이태원역,846,505,341
2019,3,D,발달상권,1001149,한남오거리,659,450,209
2019,3,D,발달상권,1001148,목동사거리,63,17,46
2019,3,D,발달상권,1001147,용산 전자상가_2,594,475,119
2019,3,D,발달상권,1001146,용산구청,284,197,87
2019,3,D,발달상권,1001145,용산 전자상가_1,3414,2466,948
2019,3,D,발달상권,1001144,국회의사당역_2,18939,11162,7777
2019,3,D,발달상권,1001143,서울 용산구 신용산역,968,657,311
2019,3,D,발달상권,1001142,국회의사당역_1,4489,3474,1015
2019,3,D,발달상권,1001141,압구정 로데오거리_2,8894,3075,5819
2019,3,D,발달상권,1001140,서울 강남구 압구정역,9378,4528,4850
2019,3,D,발달상권,1001139,서울 영등포구 영등포구청역,434,269,165
2019,3,D,발달상권,1001138,압구정 로데오거리_1,14181,6988,7193
2019,3,D,발달상권,1001137,서울 강동구 둔촌동역,302,132,170
2019,3,D,발달상권,1001136,오목교역,114,58,56
2019,3,D,발달상권,1001135,신사동 가로수길,15305,7796,7509
2019,3,D,발달상권,1001134,서울 영등포구 여의도역_2,31529,20808,10721
2019,3,D,발달상권,1001133,청담사거리_3,3033,2097,936
2019,3,D,발달상권,1001132,영등포유통상가,1647,1042,605
2019,3,D,발달상권,1001131,청담역_2,4354,3343,1011
2019,3,D,발달상권,1001130,청담역_1,5401,3449,1952
2019,3,D,발달상권,1001129,청담사거리_2,1350,711,639
2019,3,D,발달상권,1001128,청담사거리_1,503,192,311
2019,3,D,발달상권,1001127,서울 영등포구 여의도역_1,20996,13276,7720
2019,3,D,발달상권,1001126,서울 양천구 신정네거리역_2,31,21,10
2019,3,D,발달상권,1001125,학동사거리_2,2344,1351,993
2019,3,D,발달상권,1001124,서울 영등포구 영등포시장역,620,394,226
2019,3,D,발달상권,1001123,학동사거리_1,3887,2444,1443
2019,3,D,발달상권,1001122,여의도 시범아파트앞,12813,7555,5258
2019,3,D,발달상권,1001121,영등포역_3,137,77,60
2019,3,D,발달상권,1001120,도산공원사거리_1,3595,1700,1895
2019,3,D,발달상권,1001119,영등포역_2,560,241,319
2019,3,D,발달상권,1001118,문래동 주민센터,6909,4050,2859
2019,3,D,발달상권,1001117,강남구 신사역_2,9468,3993,5475
2019,3,D,발달상권,1001116,영등포역_1,110,48,62
2019,3,D,발달상권,1001115,서울 강남구 강남구청역_2,2489,1347,1142
2019,3,D,발달상권,1001114,강남구 신사역_1,1123,644,479
2019,3,D,발달상권,1001113,서울 동작구 노량진1동_1,98,59,39
2019,3,D,발달상권,1001112,서울 강남구 학동역_3,3886,1975,1911
2019,3,D,발달상권,1001111,서울 강남구 강남구청역_1,3755,2581,1174
2019,3,D,발달상권,1001110,잠실역,45953,24023,21930
2019,3,D,발달상권,1001109,강남구 논현역_4,6134,3682,2452
2019,3,D,발달상권,1001108,학동역,1016,607,409
2019,3,D,발달상권,1001107,방이동 먹자골목,7253,4766,2487
2019,3,D,발달상권,1001106,서울 강남구 학동역_2,2446,1605,841
2019,3,D,발달상권,1001105,서울 동작구 노량진역,590,313,277
2019,3,D,발달상권,1001104,삼성역_3,29439,23456,5983
2019,3,D,발달상권,1001103,코엑스,18430,10279,8151
2019,3,D,발달상권,1001102,서울 강남구 학동역_1,1762,1052,710
2019,3,D,발달상권,1001101,선정릉역_2,4273,2944,1329
2019,3,D,발달상권,1001100,강남구 논현역_3,4119,1341,2778
2019,3,D,발달상권,1001099,포스코사거리_2,15779,9200,6579
2019,3,D,발달상권,1001098,포스코사거리_1,15421,8733,6688
2019,3,D,발달상권,1001097,잠실역 롯데월드,2261,1178,1083
2019,3,D,발달상권,1001096,신도림역,2078,1248,830
2019,3,D,발달상권,1001095,강남구 논현역_2,9583,5755,3828
2019,3,D,발달상권,1001094,선정릉역_1,2523,1560,963
2019,3,D,발달상권,1001093,신천역,4717,2610,2107
2019,3,D,발달상권,1001092,강남구 논현역_1,2888,1439,1449
2019,3,D,발달상권,1001091,삼성역_2,11421,6149,5272
2019,3,D,발달상권,1001090,삼정역_2,1226,745,481
2019,3,D,발달상권,1001089,삼정역_1,1881,839,1042
2019,3,D,발달상권,1001088,삼성역_1,27060,17796,9264
2019,3,D,발달상권,1001087,서울 강남구 선릉역_2,40349,21297,19052
2019,3,D,발달상권,1001086,고속터미널역,3484,2919,565
2019,3,D,발달상권,1001085,서울 서초구 강남역,23161,13139,10022
2019,3,D,발달상권,1001084,서울 강남구 선릉역_1,16664,6446,10218
2019,3,D,발달상권,1001083,서울 송파구 석촌역_2,569,313,256
2019,3,D,발달상권,1001082,선릉역_2,27366,16796,10570
2019,3,D,발달상권,1001081,서울 강남구 역삼역_2,19816,16079,3737
2019,3,D,발달상권,1001080,서울 송파구 석촌역_1,225,145,80
2019,3,D,발달상권,1001079,석촌역,183,138,45
2019,3,D,발달상권,1001078,서울 강남구 강남역_2,9238,4452,4786
2019,3,D,발달상권,1001077,선릉역_1,27712,18453,9259
2019,3,D,발달상권,1001076,구로역,242,109,133
2019,3,D,발달상권,1001075,역삼역_2,10035,4561,5474
2019,3,D,발달상권,1001074,대림역_2,7362,5460,1902
2019,3,D,발달상권,1001073,서울 강남구 역삼역_1,25120,16158,8962
2019,3,D,발달상권,1001072,신대방삼거리역,405,258,147
2019,3,D,발달상권,1001071,서울 강남구 한티역,730,391,339
2019,3,D,발달상권,1001070,은마아파트입구사거리_4,544,234,310
2019,3,D,발달상권,1001069,은마아파트입구사거리_3,92,37,55
2019,3,D,발달상권,1001068,은마아파트입구사거리_2,5766,3271,2495
2019,3,D,발달상권,1001067,오류동역,1857,1329,528
2019,3,D,발달상권,1001066,서울 강남구 강남역,38675,18386,20289
2019,3,D,발달상권,1001065,은마아파트입구사거리_1,347,182,165
2019,3,D,발달상권,1001064,대림역_1,278,163,115
2019,3,D,발달상권,1001063,교대역_4,6895,4614,2281
2019,3,D,발달상권,1001062,서울 강남구 강남역_1,26031,15075,10956
2019,3,D,발달상권,1001061,방배동카페골목,229,97,132
2019,3,D,발달상권,1001060,가락시장,61,50,11
2019,3,D,발달상권,1001059,교대역_3,1262,780,482
2019,3,D,발달상권,1001058,역삼역_1,4438,2701,1737
2019,3,D,발달상권,1001057,교대역_2,2851,1597,1254
2019,3,D,발달상권,1001056,서울 송파구 가락시장역,4251,2667,1584
2019,3,D,발달상권,1001055,서울 서초구 서초역,1791,903,888
2019,3,D,발달상권,1001054,서울 강남구 대치역_2,981,565,416
2019,3,D,발달상권,1001053,서울 강남구 대치역_1,99,31,68
2019,3,D,발달상권,1001052,뱅뱅사거리_2,13297,8922,4375
2019,3,D,발달상권,1001051,보라매공원,2357,1432,925
2019,3,D,발달상권,1001050,교대역_1,17111,8100,9011
2019,3,D,발달상권,1001049,개봉동 현대아파트 인근,276,131,145
2019,3,D,발달상권,1001048,뱅뱅사거리,6920,4334,2586
2019,3,D,발달상권,1001047,뱅뱅사거리_1,5288,4076,1212
2019,3,D,발달상권,1001046,서울 관악구 신림역_4,418,169,249
2019,3,D,발달상권,1001045,동작구 총신대입구역_1,438,188,250
2019,3,D,발달상권,1001044,양재역_3,8867,5289,3578
2019,3,D,발달상권,1001043,동작구 총신대입구역_2,1952,949,1003
2019,3,D,발달상권,1001042,서울 서초구 남부터미널역_3,3086,1255,1831
2019,3,D,발달상권,1001041,서울 강남구 수서역,14566,8218,6348
2019,3,D,발달상권,1001040,서울 관악구 신림역_3,93,33,60
2019,3,D,발달상권,1001039,서울 서초구 남부터미널역_2,3694,2446,1248
2019,3,D,발달상권,1001038,구로디지탈1단지,46412,29926,16486
2019,3,D,발달상권,1001037,양재역,1019,522,497
2019,3,D,발달상권,1001036,문정역,88,50,38
2019,3,D,발달상권,1001035,매봉역,7223,4863,2360
2019,3,D,발달상권,1001034,서울 서초구 방배역,1802,1019,783
2019,3,D,발달상권,1001033,서울 서초구 남부터미널역_1,2467,1466,1001
2019,3,D,발달상권,1001032,서울 관악구 신림역_2,170,57,113
2019,3,D,발달상권,1001031,서울 관악구 신림역_1,1369,485,884
2019,3,D,발달상권,1001030,양재역_2,4149,2003,2146
2019,3,D,발달상권,1001029,양재역_1,522,321,201
2019,3,D,발달상권,1001028,서울 관악구 서울대입구역_2,79,38,41
2019,3,D,발달상권,1001027,가산디지털단지역_3,25379,15619,9760
2019,3,D,발달상권,1001026,구로디지털단지역,101,74,27
2019,3,D,발달상권,1001025,서울 관악구 서울대입구역_1,1561,862,699
2019,3,D,발달상권,1001024,관악구 사당역_1,5377,2218,3159
2019,3,D,발달상권,1001023,가산디지털단지역_2,35995,22069,13926
2019,3,D,발달상권,1001022,관악구 사당역_2,1216,576,640
2019,3,D,발달상권,1001021,가산디지털단지역_1,17408,11968,5440
2019,3,D,발달상권,1001020,장지역,4710,3160,1550
2019,3,D,발달상권,1001019,포이사거리_1,119,69,50
2019,3,D,발달상권,1001018,포이사거리_2,11006,6153,4853
2019,3,D,발달상권,1001017,관악구 사당역_3,1530,1124,406
2019,3,D,발달상권,1001016,서울 관악구 대학동_1,348,230,118
2019,3,D,발달상권,1001015,서울 금천구 독산1동_1,991,624,367
2019,3,D,발달상권,1001014,양재동 꽃시장,1559,866,693
2019,3,D,발달상권,1001013,양재 화물트럭터미널앞_2,1137,848,289
2019,3,D,발달상권,1001012,양재 화물트럭터미널앞_1,1955,1643,312
2019,3,D,발달상권,1001011,서울 금천구 시흥1동_4,590,216,374
2019,3,A,골목상권,1001010,풍성로37가길,231,73,158
2019,3,A,골목상권,1001009,천호옛길,543,378,165
2019,3,A,골목상권,1001008,천호옛14길,149,95,54
2019,3,A,골목상권,1001007,천호대로219길,462,305,157
2019,3,A,골목상권,1001006,천호대로197길,504,261,243
2019,3,A,골목상권,1001005,천호대로187길,348,195,153
2019,3,A,골목상권,1001004,천호대로170길,328,202,126
2019,3,A,골목상권,1001003,천호대로162길,244,142,102
2019,3,A,골목상권,1001002,천중로51길,824,549,275
2019,3,A,골목상권,1001001,천중로39길,597,389,208
2019,3,A,골목상권,1001000,진황도로47길,186,89,97
2019,3,A,골목상권,1000999,진황도로27길,290,173,117
2019,3,A,골목상권,1000998,올림픽로98길,213,155,58
2019,3,A,골목상권,1000997,올림픽로80길,135,39,96
2019,3,A,골목상권,1000996,올림픽로78길,99,44,55
2019,3,A,골목상권,1000995,올림픽로77길,211,119,92
2019,3,A,골목상권,1000994,올림픽로71길,194,103,91
2019,3,A,골목상권,1000993,올림픽로48길,2051,1337,714
2019,3,A,골목상권,1000992,양재대로96길,229,149,80
2019,3,A,골목상권,1000991,양재대로95길,605,330,275
2019,3,A,골목상권,1000990,양재대로91길,354,228,126
2019,3,A,골목상권,1000989,양재대로133길,318,168,150
2019,3,A,골목상권,1000988,양재대로124길,479,271,208
2019,3,A,골목상권,1000987,양재대로116길,71,37,34
2019,3,A,골목상권,1000986,양재대로101길,672,297,375
2019,3,A,골목상권,1000985,암사길,251,153,98
2019,3,A,골목상권,1000984,성안로3길,2085,1262,823
2019,3,A,골목상권,1000983,성내로5길,1138,709,429
2019,3,A,골목상권,1000982,상일로5길,176,123,53
2019,3,A,골목상권,1000981,상암로5길,317,129,188
2019,3,A,골목상권,1000980,상암로51길,384,174,210
2019,3,A,골목상권,1000979,상암로4길,256,160,96
2019,3,A,골목상권,1000978,상암로14길,447,281,166
2019,3,A,골목상권,1000977,명일로13길,261,159,102
2019,3,A,골목상권,1000976,동남로85길,301,213,88
2019,3,A,골목상권,1000975,동남로82길,125,81,44
2019,3,A,골목상권,1000974,동남로65길,316,209,107
2019,3,A,골목상권,1000973,구천면로42길,280,93,187
2019,3,A,골목상권,1000972,구천면로41길,400,206,194
2019,3,A,골목상권,1000971,구천면로36길,45,22,23
2019,3,A,골목상권,1000970,고덕로61길,96,57,39
2019,3,A,골목상권,1000969,고덕로25길,286,199,87
2019,3,A,골목상권,1000968,고덕로10길,819,385,434
2019,3,A,골목상권,1000967,강동대로53길,1182,759,423
2019,3,A,골목상권,1000966,풍성로25길,77,38,39
2019,3,A,골목상권,1000965,오금로46길,780,409,371
2019,3,A,골목상권,1000964,오금로36길,1470,1046,424
2019,3,A,골목상권,1000963,오금로11길,1152,720,432
2019,3,A,골목상권,1000962,양재대로72길,225,118,107
2019,3,A,골목상권,1000961,양재대로71길,2400,1739,661
2019,3,A,골목상권,1000960,양재대로64길,1422,813,609
2019,3,A,골목상권,1000959,양재대로62길,6233,3834,2399
2019,3,A,골목상권,1000958,송파대로30길,1969,1432,537
2019,3,A,골목상권,1000957,송이로36길,1596,1066,530
2019,3,A,골목상권,1000956,송이로32길,1336,801,535
2019,3,A,골목상권,1000955,송이로23길,1776,1262,514
2019,3,A,골목상권,1000954,삼전로13길,1272,791,481
2019,3,A,골목상권,1000953,백제고분로50길,1354,867,487
2019,3,A,골목상권,1000952,백제고분로46길,677,475,202
2019,3,A,골목상권,1000951,백제고분로45길,1150,713,437
2019,3,A,골목상권,1000950,백제고분로42길,631,320,311
2019,3,A,골목상권,1000949,백제고분로39길,1288,837,451
2019,3,A,골목상권,1000948,백제고분로34길,1857,1347,510
2019,3,A,골목상권,1000947,백제고분로33길,1138,741,397
2019,3,A,골목상권,1000946,백제고분로32길,710,423,287
2019,3,A,골목상권,1000945,백제고분로31길,1747,1347,400
2019,3,A,골목상권,1000944,백제고분로22길,928,601,327
2019,3,A,골목상권,1000943,백제고분로21길,461,293,168
2019,3,A,골목상권,1000942,마천로51길,379,213,166
2019,3,A,골목상권,1000941,동남로20길,2640,1844,796
2019,3,A,골목상권,1000940,거마로20길,514,245,269
2019,3,A,골목상권,1000939,학동로77길,2314,1362,952
2019,3,A,골목상권,1000938,학동로6길,1599,1065,534
2019,3,A,골목상권,1000937,학동로56길,2664,1762,902
2019,3,A,골목상권,1000936,학동로38길,1947,920,1027
2019,3,A,골목상권,1000935,테헤란로81길,1832,919,913
2019,3,A,골목상권,1000934,일원로9길,526,295,231
2019,3,A,골목상권,1000933,일원로3길,396,212,184
2019,3,A,골목상권,1000932,영동대로65길,1259,735,524
2019,3,A,골목상권,1000931,영동대로112길,14335,11746,2589
2019,3,A,골목상권,1000930,언주로81길,5855,3838,2017
2019,3,A,골목상권,1000929,압구정로2길,1819,1266,553
2019,3,A,골목상권,1000928,선릉로18길,561,420,141
2019,3,A,골목상권,1000927,선릉로146길,971,480,491
2019,3,A,골목상권,1000926,선릉로133길,781,452,329
2019,3,A,골목상권,1000925,선릉로132길,1291,618,673
2019,3,A,골목상권,1000924,선릉로121길,2164,1181,983
2019,3,A,골목상권,1000923,삼성로75길,2145,1449,696
2019,3,A,골목상권,1000922,삼성로69길,1962,1057,905
2019,3,A,골목상권,1000921,삼성로64길,3234,1576,1658
2019,3,A,골목상권,1000920,삼성로63길,1124,575,549
2019,3,A,골목상권,1000919,삼성로57길,2446,1558,888
2019,3,A,골목상권,1000918,삼성로147길,204,93,111
2019,3,A,골목상권,1000917,삼성로115길,837,420,417
2019,3,A,골목상권,1000916,봉은사로68길,1383,854,529
2019,3,A,골목상권,1000915,봉은사로57길,477,278,199
2019,3,A,골목상권,1000914,봉은사로43길,4389,2637,1752
2019,3,A,골목상권,1000913,봉은사로29길,2316,1703,613
2019,3,A,골목상권,1000912,봉은사로109길,3073,2193,880
2019,3,A,골목상권,1000911,도산대로89길,1366,712,654
2019,3,A,골목상권,1000910,도산대로81길,12220,10167,2053
2019,3,A,골목상권,1000909,도산대로50길,2456,1656,800
2019,3,A,골목상권,1000908,도산대로38길,1114,662,452
2019,3,A,골목상권,1000907,도산대로30길,2619,1317,1302
2019,3,A,골목상권,1000906,도산대로23길,606,253,353
2019,3,A,골목상권,1000905,도산대로15길,292,167,125
2019,3,A,골목상권,1000904,도곡로37길,7533,4630,2903
2019,3,A,골목상권,1000903,논현로8길,886,597,289
2019,3,A,골목상권,1000902,논현로63길,2108,1433,675
2019,3,A,골목상권,1000901,논현로28길,3338,2289,1049
2019,3,A,골목상권,1000900,논현로26길,16339,4308,12031
2019,3,A,골목상권,1000899,논현로159길,368,126,242
2019,3,A,골목상권,1000898,논현로139길,3993,2346,1647
2019,3,A,골목상권,1000897,논현로123길,203,122,81
2019,3,A,골목상권,1000896,논현로115길,2392,1454,938
2019,3,A,골목상권,1000895,논현로10길,581,343,238
2019,3,A,골목상권,1000894,논현로106길,1458,1011,447
2019,3,A,골목상권,1000893,남부순환로365길,714,454,260
2019,3,A,골목상권,1000892,개포로82길,94,54,40
2019,3,A,골목상권,1000891,개포로28길,584,439,145
2019,3,A,골목상권,1000890,개포로20길,768,474,294
2019,3,A,골목상권,1000889,개포로17길,1190,828,362
2019,3,A,골목상권,1000888,강남대로140길,1129,561,568
2019,3,A,골목상권,1000887,강남대로136길,5386,3882,1504
2019,3,A,골목상권,1000886,강남대로118길,216,97,119
2019,3,A,골목상권,1000885,서초중앙로8길,3692,2516,1176
2019,3,A,골목상권,1000884,방배중앙로21길,7175,2607,4568
2019,3,A,골목상권,1000883,효령로72길,6106,5022,1084
2019,3,A,골목상권,1000882,효령로34길,1303,793,510
2019,3,A,골목상권,1000881,효령로31길,2618,2108,510
2019,3,A,골목상권,1000880,효령로23길,1743,1155,588
2019,3,A,골목상권,1000879,청두곶길,1530,834,696
2019,3,A,골목상권,1000878,주흥길,170,105,65
2019,3,A,골목상권,1000877,주흥15길,650,412,238
2019,3,A,골목상권,1000876,언남길,1248,811,437
2019,3,A,골목상권,1000875,신반포로45길,1139,590,549
2019,3,A,골목상권,1000874,서초대로8길,3044,719,2325
2019,3,A,골목상권,1000873,서초대로64길,1706,1213,493
2019,3,A,골목상권,1000872,서초대로4길,890,520,370
2019,3,A,골목상권,1000871,서초대로25길,2755,2175,580
2019,3,A,골목상권,1000870,서초대로23길,2349,1375,974
2019,3,A,골목상권,1000869,서초대로15길,519,325,194
2019,3,A,골목상권,1000868,사평대로57길,84,47,37
2019,3,A,골목상권,1000867,사평대로26길,615,402,213
2019,3,A,골목상권,1000866,사평대로22길,1825,1099,726
2019,3,A,골목상권,1000865,사임당로17길,2107,1279,828
2019,3,A,골목상권,1000864,방배로42길,853,701,152
2019,3,A,골목상권,1000863,방배로35길,1386,874,512
2019,3,A,골목상권,1000862,방배로18길,917,589,328
2019,3,A,골목상권,1000861,반포대로9길,532,297,235
2019,3,A,골목상권,1000860,바우뫼로39길,2853,1707,1146
2019,3,A,골목상권,1000859,마방로2길,3386,2494,892
2019,3,A,골목상권,1000858,방배천로4안길,1082,468,614
2019,3,A,골목상권,1000857,동산로19길,1318,656,662
2019,3,A,골목상권,1000856,동산로10길,1650,1164,486
2019,3,A,골목상권,1000855,동광로39길,1217,833,384
2019,3,A,골목상권,1000854,동광로1길,1470,667,803
2019,3,A,골목상권,1000853,동광로12길,873,489,384
2019,3,A,골목상권,1000852,논현로27길,2976,2165,811
2019,3,A,골목상권,1000851,논현로1길,1592,1121,471
2019,3,A,골목상권,1000850,남부순환로339길,2908,1282,1626
2019,3,A,골목상권,1000849,남부순환로325길,1658,956,702
2019,3,A,골목상권,1000848,남부순환로317길,2256,1460,796
2019,3,A,골목상권,1000847,고무래로8길,5772,3607,2165
2019,3,A,골목상권,1000846,강남대로8길,2001,1329,672
2019,3,A,골목상권,1000845,강남대로34길,2194,1522,672
2019,3,A,골목상권,1000844,강남대로23길,2345,1776,569
2019,3,A,골목상권,1000843,소담길,15,4,11
2019,3,A,골목상권,1000842,원신길,39,15,24
2019,3,A,골목상권,1000841,양지길,10,2,8
2019,3,A,골목상권,1000840,양산길,7,2,5
2019,3,A,골목상권,1000839,호암로24길,1199,1059,140
2019,3,A,골목상권,1000838,호암로20길,207,89,118
2019,3,A,골목상권,1000837,행운길,575,450,125
2019,3,A,골목상권,1000836,행운1길,228,132,96
2019,3,A,골목상권,1000835,청림3길,152,49,103
2019,3,A,골목상권,1000834,청룡길,318,205,113
2019,3,A,골목상권,1000833,청룡8길,251,75,176
2019,3,A,골목상권,1000832,중앙길,85,24,61
2019,3,A,골목상권,1000831,조원중앙로2길,960,714,246
2019,3,A,골목상권,1000830,조원로18길,229,118,111
2019,3,A,골목상권,1000829,조원로10길,386,210,176
2019,3,A,골목상권,1000828,장군봉2길,210,130,80
2019,3,A,골목상권,1000827,장군봉1길,355,197,158
2019,3,A,골목상권,1000826,인헌길,108,63,45
2019,3,A,골목상권,1000825,은천로25길,62,33,29
2019,3,A,골목상권,1000824,양녕로6길,178,109,69
2019,3,A,골목상권,1000823,신원로3길,191,109,82
2019,3,A,골목상권,1000822,신사로20길,115,85,30
2019,3,A,골목상권,1000821,신림로65길,221,170,51
2019,3,A,골목상권,1000820,신림로64길,183,90,93
2019,3,A,골목상권,1000819,신림로48길,82,51,31
2019,3,A,골목상권,1000818,신림로38길,131,78,53
2019,3,A,골목상권,1000817,신림로28길,454,285,169
2019,3,A,골목상권,1000816,신림로11길,238,154,84
2019,3,A,골목상권,1000815,신림동길,695,410,285
2019,3,A,골목상권,1000814,승방길,520,404,116
2019,3,A,골목상권,1000813,서림7길,124,65,59
2019,3,A,골목상권,1000812,봉천로33길,188,119,69
2019,3,A,골목상권,1000811,봉천로13길,358,106,252
2019,3,A,골목상권,1000810,복은길,599,378,221
2019,3,A,골목상권,1000809,법원단지길,34,10,24
2019,3,A,골목상권,1000808,법원단지9길,172,110,62
2019,3,A,골목상권,1000807,미성5길,376,204,172
2019,3,A,골목상권,1000806,대학길,55,31,24
2019,3,A,골목상권,1000805,대학14길,70,23,47
2019,3,A,골목상권,1000804,당곡길,207,96,111
2019,3,A,골목상권,1000803,남현길,143,43,100
2019,3,A,골목상권,1000802,남현3길,466,315,151
2019,3,A,골목상권,1000801,남현2길,931,661,270
2019,3,A,골목상권,1000800,남부순환로248길,484,255,229
2019,3,A,골목상권,1000799,남부순환로234길,183,118,65
2019,3,A,골목상권,1000798,남부순환로172길,746,465,281
2019,3,A,골목상권,1000797,남부순환로161길,439,287,152
2019,3,A,골목상권,1000796,남부순환로151길,371,154,217
2019,3,A,골목상권,1000795,남부순환로142길,450,251,199
2019,3,A,골목상권,1000794,난향길,694,279,415
2019,3,A,골목상권,1000793,난우길,181,95,86
2019,3,A,골목상권,1000792,난곡로74길,2071,1671,400
2019,3,A,골목상권,1000791,난곡로34길,61,26,35
2019,3,A,골목상권,1000790,난곡로26길,108,77,31
2019,3,A,골목상권,1000789,난곡로24길,89,42,47
2019,3,A,골목상권,1000788,낙성대역길,493,282,211
2019,3,A,골목상권,1000787,국회단지길,3757,1162,2595
2019,3,A,골목상권,1000786,구암길,152,36,116
2019,3,A,골목상권,1000785,관천로22길,240,155,85
2019,3,A,골목상권,1000784,관천로15길,224,150,74
2019,3,A,골목상권,1000783,관악로30길,94,13,81
2019,3,A,골목상권,1000782,관악로28길,127,37,90
2019,3,A,골목상권,1000781,관악로14길,155,81,74
2019,3,A,골목상권,1000780,관악로10길,696,443,253
2019,3,A,골목상권,1000779,흑석로9길,85,49,36
2019,3,A,골목상권,1000778,흑석로13길,74,30,44
2019,3,A,골목상권,1000777,장승배기로27길,252,141,111
2019,3,A,골목상권,1000776,장승배기로19길,130,62,68
2019,3,A,골목상권,1000775,장승배기로10길,109,72,37
2019,3,A,골목상권,1000774,여의대방로46길,1202,739,463
2019,3,A,골목상권,1000773,여의대방로24길,15790,10229,5561
2019,3,A,골목상권,1000772,여의대방로22카길,183,139,44
2019,3,A,골목상권,1000771,여의대방로22나길,170,95,75
2019,3,A,골목상권,1000770,여의대방로22길,194,113,81
2019,3,A,골목상권,1000769,양녕로26길,92,54,38
2019,3,A,골목상권,1000768,신대방길,180,88,92
2019,3,A,골목상권,1000767,성대로29길,266,130,136
2019,3,A,골목상권,1000766,성대로1길,79,45,34
2019,3,A,골목상권,1000765,서달로8가길,107,45,62
2019,3,A,골목상권,1000764,서달로15길,56,20,36
2019,3,A,골목상권,1000763,서달로14길,21,9,12
2019,3,A,골목상권,1000762,서달로10길,68,40,28
2019,3,A,골목상권,1000761,상도로62길,425,265,160
2019,3,A,골목상권,1000760,상도로61길,214,88,126
2019,3,A,골목상권,1000759,상도로47길,450,200,250
2019,3,A,골목상권,1000758,상도로37길,59,26,33
2019,3,A,골목상권,1000757,상도로15길,368,150,218
2019,3,A,골목상권,1000756,사당로8길,127,62,65
2019,3,A,골목상권,1000755,사당로30길,329,184,145
2019,3,A,골목상권,1000754,사당로2차길,728,535,193
2019,3,A,골목상권,1000753,사당로29길,134,76,58
2019,3,A,골목상권,1000752,사당로26길,342,243,99
2019,3,A,골목상권,1000751,사당로23나길,32,20,12
2019,3,A,골목상권,1000750,사당로23길,7,6,1
2019,3,A,골목상권,1000749,사당로20길,112,61,51
2019,3,A,골목상권,1000748,사당로16길,77,38,39
2019,3,A,골목상권,1000747,사당로16가길,231,142,89
2019,3,A,골목상권,1000746,만양로8길,664,316,348
2019,3,A,골목상권,1000745,만양로14길,50,23,27
2019,3,A,골목상권,1000744,등용로14길,375,163,212
2019,3,A,골목상권,1000743,동작대로7길,284,148,136
2019,3,A,골목상권,1000742,동작대로35길,240,89,151
2019,3,A,골목상권,1000741,동작대로33길,216,109,107
2019,3,A,골목상권,1000740,동작대로29길,287,103,184
2019,3,A,골목상권,1000739,동작대로17길,819,434,385
2019,3,A,골목상권,1000738,대방동2길,348,182,166
2019,3,A,골목상권,1000737,대방동27길,533,246,287
2019,3,A,골목상권,1000736,노량진로6길,317,206,111
2019,3,A,골목상권,1000735,국사봉길,180,109,71
2019,3,A,골목상권,1000734,국사봉2길,99,60,39
2019,3,A,골목상권,1000733,국사봉1길,128,68,60
2019,3,A,골목상권,1000732,영신로9길,1423,811,612
2019,3,A,골목상권,1000731,영등포로84길,2014,690,1324
2019,3,A,골목상권,1000730,영등포로80길,159,86,73
2019,3,A,골목상권,1000729,영등포로62길,113,80,33
2019,3,A,골목상권,1000728,영등포로35길,270,137,133
2019,3,A,골목상권,1000727,영등포로27길,453,281,172
2019,3,A,골목상권,1000726,영등포로25길,1488,919,569
2019,3,A,골목상권,1000725,여의대방로61길,1117,767,350
2019,3,A,골목상권,1000724,여의대방로43나길,935,742,193
2019,3,A,골목상권,1000723,여의대방로39길,163,96,67
2019,3,A,골목상권,1000722,여의대방로35길,212,70,142
2019,3,A,골목상권,1000721,양평로28길,908,712,196
2019,3,A,골목상권,1000720,양평로22라길,663,352,311
2019,3,A,골목상권,1000719,양평로19길,1345,865,480
2019,3,A,골목상권,1000718,신길로60길,256,195,61
2019,3,A,골목상권,1000717,신길로42길,462,240,222
2019,3,A,골목상권,1000716,신길로42가길,220,99,121
2019,3,A,골목상권,1000715,신길로39길,68,40,28
2019,3,A,골목상권,1000714,신길로17길,722,301,421
2019,3,A,골목상권,1000713,선유서로28길,243,129,114
2019,3,A,골목상권,1000712,선유서로25길,1702,1311,391
2019,3,A,골목상권,1000711,선유서로24길,136,91,45
2019,3,A,골목상권,1000710,선유로55길,423,285,138
2019,3,A,골목상권,1000709,디지털로74길,11,7,4
2019,3,A,골목상권,1000708,디지털로57길,144,78,66
2019,3,A,골목상권,1000707,디지털로37길,165,46,119
2019,3,A,골목상권,1000706,도신로62길,183,145,38
2019,3,A,골목상권,1000705,도신로60길,83,49,34
2019,3,A,골목상권,1000704,도신로29길,114,52,62
2019,3,A,골목상권,1000703,도신로15길,483,288,195
2019,3,A,골목상권,1000702,도림천로21길,228,152,76
2019,3,A,골목상권,1000701,도림로63길,59,48,11
2019,3,A,골목상권,1000700,도림로147길,333,255,78
2019,3,A,골목상권,1000699,도림로112길,37,24,13
2019,3,A,골목상권,1000698,대림로8길,313,160,153
2019,3,A,골목상권,1000697,대림로7길,70,41,29
2019,3,A,골목상권,1000696,대림로44길,476,318,158
2019,3,A,골목상권,1000695,대림로34길,274,181,93
2019,3,A,골목상권,1000694,대림로31길,428,270,158
2019,3,A,골목상권,1000693,대림로29길,989,662,327
2019,3,A,골목상권,1000692,대림로22길,176,116,60
2019,3,A,골목상권,1000691,당산로46길,2538,1622,916
2019,3,A,골목상권,1000690,당산로38길,990,730,260
2019,3,A,골목상권,1000689,당산로37길,1015,731,284
2019,3,A,골목상권,1000688,당산로31길,1723,895,828
2019,3,A,골목상권,1000687,국회대로56길,3263,1592,1671
2019,3,A,골목상권,1000686,경인로90길,317,236,81
2019,3,A,골목상권,1000685,경인로80길,849,578,271
2019,3,A,골목상권,1000684,경인로77길,845,570,275
2019,3,A,골목상권,1000683,가마산로61길,53,37,16
2019,3,A,골목상권,1000682,시흥대로94길,429,147,282
2019,3,A,골목상권,1000681,시흥대로84길,192,114,78
2019,3,A,골목상권,1000680,시흥대로68길,557,213,344
2019,3,A,골목상권,1000679,시흥대로63길,1679,865,814
2019,3,A,골목상권,1000678,시흥대로62가길,130,83,47
2019,3,A,골목상권,1000677,시흥대로36길,571,405,166
2019,3,A,골목상권,1000676,시흥대로22길,233,119,114
2019,3,A,골목상권,1000675,시흥대로153길,100,63,37
2019,3,A,골목상권,1000674,시흥대로150길,354,227,127
2019,3,A,골목상권,1000673,시흥대로141길,316,217,99
2019,3,A,골목상권,1000672,시흥대로138길,358,270,88
2019,3,A,골목상권,1000671,시흥대로120길,175,115,60
2019,3,A,골목상권,1000670,벚꽃로56길,88,65,23
2019,3,A,골목상권,1000669,범안로17길,4343,2744,1599
2019,3,A,골목상권,1000668,범안로11길,1827,988,839
2019,3,A,골목상권,1000667,문성로5길,107,67,40
2019,3,A,골목상권,1000666,독산로85길,45,23,22
2019,3,A,골목상권,1000665,독산로78다길,504,343,161
2019,3,A,골목상권,1000664,독산로70길,79,26,53
2019,3,A,골목상권,1000663,독산로64길,320,275,45
2019,3,A,골목상권,1000662,독산로50길,25,6,19
2019,3,A,골목상권,1000661,독산로40길,208,74,134
2019,3,A,골목상권,1000660,독산로108길,1698,1523,175
2019,3,A,골목상권,1000659,남부순환로112길,84,49,35
2019,3,A,골목상권,1000658,금하로24길,176,103,73
2019,3,A,골목상권,1000657,금하로1길,200,149,51
2019,3,A,골목상권,1000656,금하로14길,102,66,36
2019,3,A,골목상권,1000655,가산로5길,371,243,128
2019,3,A,골목상권,1000654,가산로3길,1032,747,285
2019,3,A,골목상권,1000653,중앙로1길,937,692,245
2019,3,A,골목상권,1000652,중앙로15길,157,99,58
2019,3,A,골목상권,1000651,우마길,44,21,23
2019,3,A,골목상권,1000650,오류로8길,478,232,246
2019,3,A,골목상권,1000649,신도림로13길,129,85,44
2019,3,A,골목상권,1000648,새말로18길,437,293,144
2019,3,A,골목상권,1000647,부일로1길,665,618,47
2019,3,A,골목상권,1000646,부일로15길,200,128,72
2019,3,A,골목상권,1000645,부일로11길,244,97,147
2019,3,A,골목상권,1000644,디지털로32길,645,346,299
2019,3,A,골목상권,1000643,디지털로32가길,2779,1421,1358
2019,3,A,골목상권,1000642,디지털로27길,58,34,24
2019,3,A,골목상권,1000641,도림로6길,167,97,70
2019,3,A,골목상권,1000640,도림로12길,62,31,31
2019,3,A,골목상권,1000639,남부순환로97길,105,56,49
2019,3,A,골목상권,1000638,구로중앙로8길,125,60,65
2019,3,A,골목상권,1000637,구로중앙로7길,86,43,43
2019,3,A,골목상권,1000636,구로중앙로42길,511,370,141
2019,3,A,골목상권,1000635,구로중앙로34길,101,85,16
2019,3,A,골목상권,1000634,구로중앙로28길,594,335,259
2019,3,A,골목상권,1000633,구로중앙로19길,585,342,243
2019,3,A,골목상권,1000632,구로동로8길,387,177,210
2019,3,A,골목상권,1000631,구로동로7길,119,74,45
2019,3,A,골목상권,1000630,구로동로42길,143,77,66
2019,3,A,골목상권,1000629,구로동로41길,146,82,64
2019,3,A,골목상권,1000628,구로동로38길,386,162,224
2019,3,A,골목상권,1000627,구로동로28길,24,15,9
2019,3,A,골목상권,1000626,구로동로15길,108,58,50
2019,3,A,골목상권,1000625,공원로6가길,1447,1065,382
2019,3,A,골목상권,1000624,고척로52길,64,41,23
2019,3,A,골목상권,1000623,고척로27다길,181,111,70
2019,3,A,골목상권,1000622,고척로27길,325,192,133
2019,3,A,골목상권,1000621,고척로21나길,347,184,163
2019,3,A,골목상권,1000620,경인로47길,669,279,390
2019,3,A,골목상권,1000619,경인로35길,421,252,169
2019,3,A,골목상권,1000618,경인로31길,119,58,61
2019,3,A,골목상권,1000617,경인로15길,258,96,162
2019,3,A,골목상권,1000616,개봉로3길,331,156,175
2019,3,A,골목상권,1000615,개봉로2길,240,127,113
2019,3,A,골목상권,1000614,개봉로23가길,834,597,237
2019,3,A,골목상권,1000613,개봉로20길,3242,1499,1743
2019,3,A,골목상권,1000612,개봉로1길,179,124,55
2019,3,A,골목상권,1000611,개봉로17다길,2174,1501,673
2019,3,A,골목상권,1000610,개봉로17길,1349,442,907
2019,3,A,골목상권,1000609,개봉로11길,178,84,94
2019,3,A,골목상권,1000608,화곡로64길,938,587,351
2019,3,A,골목상권,1000607,화곡로59길,798,527,271
2019,3,A,골목상권,1000606,화곡로44나길,574,454,120
2019,3,A,골목상권,1000605,화곡로31길,575,335,240
2019,3,A,골목상권,1000604,화곡로20길,393,210,183
2019,3,A,골목상권,1000603,화곡로13길,478,348,130
2019,3,A,골목상권,1000602,초원로16길,283,122,161
2019,3,A,골목상권,1000601,초록마을로8길,130,65,65
2019,3,A,골목상권,1000600,초록마을로3길,471,367,104
2019,3,A,골목상권,1000599,월정로20길,126,24,102
2019,3,A,골목상권,1000598,우장산로6길,325,215,110
2019,3,A,골목상권,1000597,양천로73가길,474,363,111
2019,3,A,골목상권,1000596,양천로71길,1127,699,428
2019,3,A,골목상권,1000595,양천로49길,368,276,92
2019,3,A,골목상권,1000594,양천로26길,516,388,128
2019,3,A,골목상권,1000593,양천로24길,203,95,108
2019,3,A,골목상권,1000592,양천로24가길,161,106,55
2019,3,A,골목상권,1000591,양천로14길,312,176,136
2019,3,A,골목상권,1000590,방화대로6라길,706,451,255
2019,3,A,골목상권,1000589,방화대로21길,380,245,135
2019,3,A,골목상권,1000588,등촌로5길,1514,501,1013
2019,3,A,골목상권,1000587,등촌로55길,437,322,115
2019,3,A,골목상권,1000586,등촌로51길,292,160,132
2019,3,A,골목상권,1000585,등촌로39길,355,152,203
2019,3,A,골목상권,1000584,등촌로13길,234,174,60
2019,3,A,골목상권,1000583,남부순환로11길,309,217,92
2019,3,A,골목상권,1000582,까치산로4길,217,123,94
2019,3,A,골목상권,1000581,국회대로7길,226,112,114
2019,3,A,골목상권,1000580,공항대로8길,276,190,86
2019,3,A,골목상권,1000579,공항대로61길,498,387,111
2019,3,A,골목상권,1000578,공항대로59다길,1046,654,392
2019,3,A,골목상권,1000577,공항대로59길,839,584,255
2019,3,A,골목상권,1000576,공항대로55길,741,448,293
2019,3,A,골목상권,1000575,공항대로42길,477,302,175
2019,3,A,골목상권,1000574,공항대로38길,128,91,37
2019,3,A,골목상권,1000573,곰달래로60길,226,147,79
2019,3,A,골목상권,1000572,곰달래로53길,147,94,53
2019,3,A,골목상권,1000571,곰달래로47길,275,174,101
2019,3,A,골목상권,1000570,곰달래로31길,134,82,52
2019,3,A,골목상권,1000569,곰달래로25길,196,124,72
2019,3,A,골목상권,1000568,개화동로25길,259,181,78
2019,3,A,골목상권,1000567,개화동로23길,930,654,276
2019,3,A,골목상권,1000566,강서로8길,211,130,81
2019,3,A,골목상권,1000565,강서로5라길,299,200,99
2019,3,A,골목상권,1000564,강서로5나길,378,232,146
2019,3,A,골목상권,1000563,강서로5가길,216,119,97
2019,3,A,골목상권,1000562,강서로47라길,192,146,46
2019,3,A,골목상권,1000561,강서로47길,310,131,179
2019,3,A,골목상권,1000560,강서로45다길,167,110,57
2019,3,A,골목상권,1000559,강서로45길,82,32,50
2019,3,A,골목상권,1000558,강서로35길,324,160,164
2019,3,A,골목상권,1000557,강서로29길,392,223,169
2019,3,A,골목상권,1000556,강서로18길,690,539,151
2019,3,A,골목상권,1000555,강서로17가길,562,397,165
2019,3,A,골목상권,1000554,강서로15길,256,165,91
2019,3,A,골목상권,1000553,가로공원로80길,382,190,192
2019,3,A,골목상권,1000552,가로공원로76가길,212,117,95
2019,3,A,골목상권,1000551,화곡로4길,248,180,68
2019,3,A,골목상권,1000550,화곡로3길,264,141,123
2019,3,A,골목상권,1000549,지양로7길,221,110,111
2019,3,A,골목상권,1000548,중앙로55길,358,218,140
2019,3,A,골목상권,1000547,중앙로51길,474,315,159
2019,3,A,골목상권,1000546,중앙로47길,79,39,40
2019,3,A,골목상권,1000545,중앙로45길,1410,1336,74
2019,3,A,골목상권,1000544,중앙로36길,74,37,37
2019,3,A,골목상권,1000543,중앙로32길,161,102,59
2019,3,A,골목상권,1000542,중앙로25길,118,79,39
2019,3,A,골목상권,1000541,은행정로7길,448,180,268
2019,3,A,골목상권,1000540,은행정로5길,171,62,109
2019,3,A,골목상권,1000539,오목로5길,112,76,36
2019,3,A,골목상권,1000538,오목로3길,208,145,63
2019,3,A,골목상권,1000537,오목로30길,230,130,100
2019,3,A,골목상권,1000536,오목로23길,492,171,321
2019,3,A,골목상권,1000535,신월로20길,53,31,22
2019,3,A,골목상권,1000534,신월로15길,311,152,159
2019,3,A,골목상권,1000533,신목로6길,399,277,122
2019,3,A,골목상권,1000532,신목로5길,578,347,231
2019,3,A,골목상권,1000531,신목로2길,339,226,113
2019,3,A,골목상권,1000530,목동중앙서로8가길,351,206,145
2019,3,A,골목상권,1000529,목동중앙서로7길,121,80,41
2019,3,A,골목상권,1000528,목동중앙북로8길,183,111,72
2019,3,A,골목상권,1000527,목동중앙북로16길,453,194,259
2019,3,A,골목상권,1000526,목동중앙본로7길,169,70,99
2019,3,A,골목상권,1000525,목동중앙로3길,121,73,48
2019,3,A,골목상권,1000524,목동중앙로13나길,287,177,110
2019,3,A,골목상권,1000523,목동중앙남로3가길,165,102,63
2019,3,A,골목상권,1000522,목동로9길,739,457,282
2019,3,A,골목상권,1000521,목동로19길,381,208,173
2019,3,A,골목상권,1000520,목동동로8길,190,110,80
2019,3,A,골목상권,1000519,목동동로12길,389,228,161
2019,3,A,골목상권,1000518,목동남로4길,886,575,311
2019,3,A,골목상권,1000517,남부순환로88길,965,681,284
2019,3,A,골목상권,1000516,남부순환로79길,185,77,108
2019,3,A,골목상권,1000515,남부순환로70길,253,138,115
2019,3,A,골목상권,1000514,남부순환로58길,247,152,95
2019,3,A,골목상권,1000513,남부순환로40길,152,69,83
2019,3,A,골목상권,1000512,남부순환로33길,171,109,62
2019,3,A,골목상권,1000511,곰달래로5길,442,180,262
2019,3,A,골목상권,1000510,곰달래로3길,312,201,111
2019,3,A,골목상권,1000509,곰달래로2길,571,321,250
2019,3,A,골목상권,1000508,곰달래로10길,586,475,111
2019,3,A,골목상권,1000507,가로공원로58길,113,65,48
2019,3,A,골목상권,1000506,효창원로93길,811,463,348
2019,3,A,골목상권,1000505,토정로37길,291,143,148
2019,3,A,골목상권,1000504,월드컵로8길,1502,712,790
2019,3,A,골목상권,1000503,월드컵로7길,739,286,453
2019,3,A,골목상권,1000502,월드컵로36길,503,334,169
2019,3,A,골목상권,1000501,월드컵로25길,307,119,188
2019,3,A,골목상권,1000500,월드컵로19길,270,185,85
2019,3,A,골목상권,1000499,월드컵로16길,1290,882,408
2019,3,A,골목상권,1000498,월드컵로11길,408,138,270
2019,3,A,골목상권,1000497,월드컵로10길,1245,730,515
2019,3,A,골목상권,1000496,와우산로3길,269,178,91
2019,3,A,골목상권,1000495,와우산로29길,132,75,57
2019,3,A,골목상권,1000494,와우산로29가길,884,601,283
2019,3,A,골목상권,1000493,양화진길,735,445,290
2019,3,A,골목상권,1000492,양화로1길,676,339,337
2019,3,A,골목상권,1000491,양화로11길,2245,883,1362
2019,3,A,골목상권,1000490,신촌로30길,91,49,42
2019,3,A,골목상권,1000489,신촌로28가길,91,27,64
2019,3,A,골목상권,1000488,신촌로12길,276,150,126
2019,3,A,골목상권,1000487,숭문길,2192,1610,582
2019,3,A,골목상권,1000486,숭문8길,127,72,55
2019,3,A,골목상권,1000485,성지3길,323,224,99
2019,3,A,골목상권,1000484,성산로4길,1260,726,534
2019,3,A,골목상권,1000483,성미산로32길,180,106,74
2019,3,A,골목상권,1000482,성미산로1길,4503,3329,1174
2019,3,A,골목상권,1000481,성미산로11길,1167,798,369
2019,3,A,골목상권,1000480,백범로16길,1781,1234,547
2019,3,A,골목상권,1000479,방울내로9안길,652,389,263
2019,3,A,골목상권,1000478,모래내로7길,111,83,28
2019,3,A,골목상권,1000477,매봉산로2길,380,207,173
2019,3,A,골목상권,1000476,망원로2길,339,221,118
2019,3,A,골목상권,1000475,망원로11길,147,84,63
2019,3,A,골목상권,1000474,만리재옛길,1540,724,816
2019,3,A,골목상권,1000473,마포대로4길,1567,1015,552
2019,3,A,골목상권,1000472,마포대로20길,680,364,316
2019,3,A,골목상권,1000471,마포대로12길,76,32,44
2019,3,A,골목상권,1000470,동교로38길,622,255,367
2019,3,A,골목상권,1000469,동교로27길,1193,731,462
2019,3,A,골목상권,1000468,동교로25길,1133,701,432
2019,3,A,골목상권,1000467,동교로19길,1139,729,410
2019,3,A,골목상권,1000466,동교로17길,459,264,195
2019,3,A,골목상권,1000465,독막로8길,575,372,203
2019,3,A,골목상권,1000464,독막로32길,416,211,205
2019,3,A,골목상권,1000463,독막로22길,100,67,33
2019,3,A,골목상권,1000462,도화길,57,27,30
2019,3,A,골목상권,1000461,도화4길,687,298,389
2019,3,A,골목상권,1000460,대흥로28길,97,50,47
2019,3,A,골목상권,1000459,대흥로21길,363,205,158
2019,3,A,골목상권,1000458,광성로6길,344,200,144
2019,3,A,골목상권,1000457,홍제내길,280,131,149
2019,3,A,골목상권,1000456,홍연길,79,49,30
2019,3,A,골목상권,1000455,통일로39길,53,24,29
2019,3,A,골목상권,1000454,통일로37길,722,448,274
2019,3,A,골목상권,1000453,통일로11길,76,30,46
2019,3,A,골목상권,1000452,충정로6길,3745,2262,1483
2019,3,A,골목상권,1000451,충정로4길,2596,1459,1137
2019,3,A,골목상권,1000450,증가로6길,375,305,70
2019,3,A,골목상권,1000449,증가로23나길,869,405,464
2019,3,A,골목상권,1000448,증가로20가길,280,111,169
2019,3,A,골목상권,1000447,증가로10길,136,78,58
2019,3,A,골목상권,1000446,응암로1길,652,405,247
2019,3,A,골목상권,1000445,연희로10길,3486,3183,303
2019,3,A,골목상권,1000444,신촌로37길,36,16,20
2019,3,A,골목상권,1000443,수색로8길,2502,2197,305
2019,3,A,골목상권,1000442,세무서길,449,174,275
2019,3,A,골목상권,1000441,세무서2길,185,92,93
2019,3,A,골목상권,1000440,세검정로1길,179,40,139
2019,3,A,골목상권,1000439,북아현로4길,212,96,116
2019,3,A,골목상권,1000438,모래내로15길,137,31,106
2019,3,A,골목상권,1000437,명지대길,312,209,103
2019,3,A,골목상권,1000436,독립문로8길,734,453,281
2019,3,A,골목상권,1000435,가재울로6길,135,78,57
2019,3,A,골목상권,1000434,통일로92길,184,79,105
2019,3,A,골목상권,1000433,통일로87길,308,158,150
2019,3,A,골목상권,1000432,통일로78길,154,49,105
2019,3,A,골목상권,1000431,통일로69길,112,43,69
2019,3,A,골목상권,1000430,진흥로1길,319,179,140
2019,3,A,골목상권,1000429,진흥로12길,379,186,193
2019,3,A,골목상권,1000428,증산서길,264,170,94
2019,3,A,골목상권,1000427,증산로9길,665,578,87
2019,3,A,골목상권,1000426,증산로5길,469,262,207
2019,3,A,골목상권,1000425,증산로21길,270,131,139
2019,3,A,골목상권,1000424,증산로17길,164,101,63
2019,3,A,골목상권,1000423,증산로15길,427,323,104
2019,3,A,골목상권,1000422,증산로13길,89,48,41
2019,3,A,골목상권,1000421,응암로34길,225,119,106
2019,3,A,골목상권,1000420,응암로22길,126,62,64
2019,3,A,골목상권,1000419,응암로14길,92,56,36
2019,3,A,골목상권,1000418,응암로13길,129,30,99
2019,3,A,골목상권,1000417,응암로12길,63,38,25
2019,3,A,골목상권,1000416,은평로8길,265,176,89
2019,3,A,골목상권,1000415,은평로3길,290,131,159
2019,3,A,골목상권,1000414,은평로20길,48,9,39
2019,3,A,골목상권,1000413,은평로13길,661,309,352
2019,3,A,골목상권,1000412,은평로10길,305,178,127
2019,3,A,골목상권,1000411,연서로5길,583,226,357
2019,3,A,골목상권,1000410,연서로41길,114,42,72
2019,3,A,골목상권,1000409,연서로3길,153,65,88
2019,3,A,골목상권,1000408,연서로34길,1175,602,573
2019,3,A,골목상권,1000407,연서로33길,111,49,62
2019,3,A,골목상권,1000406,연서로29길,96,64,32
2019,3,A,골목상권,1000405,연서로28길,271,146,125
2019,3,A,골목상권,1000404,연서로27길,404,187,217
2019,3,A,골목상권,1000403,연서로21길,249,151,98
2019,3,A,골목상권,1000402,연서로17길,623,157,466
2019,3,A,골목상권,1000401,연서로16길,316,187,129
2019,3,A,골목상권,1000400,연서로13길,388,274,114
2019,3,A,골목상권,1000399,연서로11길,614,256,358
2019,3,A,골목상권,1000398,역말로9길,195,101,94
2019,3,A,골목상권,1000397,수색로18길,146,100,46
2019,3,A,골목상권,1000396,서오릉로8길,152,98,54
2019,3,A,골목상권,1000395,서오릉로21길,130,40,90
2019,3,A,골목상권,1000394,불광천길,197,99,98
2019,3,A,골목상권,1000393,갈현로7길,285,154,131
2019,3,A,골목상권,1000392,갈현로41길,155,59,96
2019,3,A,골목상권,1000391,갈현로33길,272,159,113
2019,3,A,골목상권,1000390,갈현로1길,93,44,49
2019,3,A,골목상권,1000389,가좌로7길,429,223,206
2019,3,A,골목상권,1000388,한글비석로44길,235,91,144
2019,3,A,골목상권,1000387,한글비석로24길,197,76,121
2019,3,A,골목상권,1000386,한글비석로22길,156,73,83
2019,3,A,골목상권,1000385,석계로1길,619,268,351
2019,3,A,골목상권,1000384,상계로9가길,288,106,182
2019,3,A,골목상권,1000383,상계로1길,280,189,91
2019,3,A,골목상권,1000382,상계로12길,143,88,55
2019,3,A,골목상권,1000381,동일로242길,557,352,205
2019,3,A,골목상권,1000380,동일로192길,390,283,107
2019,3,A,골목상권,1000379,동일로173가길,1133,839,294
2019,3,A,골목상권,1000378,공릉로58길,118,55,63
2019,3,A,골목상권,1000377,해등로16길,98,56,42
2019,3,A,골목상권,1000376,우이천로4다길,101,69,32
2019,3,A,골목상권,1000375,우이천로32길,193,70,123
2019,3,A,골목상권,1000374,시루봉로23길,309,177,132
2019,3,A,골목상권,1000373,삼양로144길,51,23,28
2019,3,A,골목상권,1000372,방학로6가길,178,87,91
2019,3,A,골목상권,1000371,방학로5길,206,114,92
2019,3,A,골목상권,1000370,방학로15길,613,413,200
2019,3,A,골목상권,1000369,방학로10길,79,49,30
2019,3,A,골목상권,1000368,도봉산길,1194,445,749
2019,3,A,골목상권,1000367,도봉산4길,27,24,3
2019,3,A,골목상권,1000366,도봉로181길,108,36,72
2019,3,A,골목상권,1000365,도봉로169나길,268,194,74
2019,3,A,골목상권,1000364,도봉로156길,66,38,28
2019,3,A,골목상권,1000363,도봉로152가길,376,337,39
2019,3,A,골목상권,1000362,도봉로147길,190,88,102
2019,3,A,골목상권,1000361,도봉로143길,118,83,35
2019,3,A,골목상권,1000360,도봉로114길,421,178,243
2019,3,A,골목상권,1000359,도봉로109길,212,159,53
2019,3,A,골목상권,1000358,도당로29길,188,98,90
2019,3,A,골목상권,1000357,도당로19길,116,52,64
2019,3,A,골목상권,1000356,도당로13바길,89,45,44
2019,3,A,골목상권,1000355,도당로13가길,39,23,16
2019,3,A,골목상권,1000354,덕릉로60길,160,115,45
2019,3,A,골목상권,1000353,노해로63다길,34,13,21
2019,3,A,골목상권,1000352,노해로60길,184,99,85
2019,3,A,골목상권,1000351,한천로140길,37,24,13
2019,3,A,골목상권,1000350,한천로139가길,112,41,71
2019,3,A,골목상권,1000349,한천로132길,76,43,33
2019,3,A,골목상권,1000348,한천로130길,74,55,19
2019,3,A,골목상권,1000347,한천로124나길,36,18,18
2019,3,A,골목상권,1000346,한천로109길,549,347,202
2019,3,A,골목상권,1000345,인수봉로79길,226,155,71
2019,3,A,골목상권,1000344,인수봉로72길,67,25,42
2019,3,A,골목상권,1000343,인수봉로56길,35,22,13
2019,3,A,골목상권,1000342,오패산로67길,307,111,196
2019,3,A,골목상권,1000341,오패산로52길,120,53,67
2019,3,A,골목상권,1000340,오패산로30길,41,26,15
2019,3,A,골목상권,1000339,수유로12길,190,119,71
2019,3,A,골목상권,1000338,솔샘로65길,353,99,254
2019,3,A,골목상권,1000337,솔매로50길,314,93,221
2019,3,A,골목상권,1000336,솔매로45길,44,15,29
2019,3,A,골목상권,1000335,솔매로41길,91,53,38
2019,3,A,골목상권,1000334,삼양로93길,210,92,118
2019,3,A,골목상권,1000333,삼양로77길,158,67,91
2019,3,A,골목상권,1000332,삼양로54길,317,73,244
2019,3,A,골목상권,1000331,삼양로41길,324,256,68
2019,3,A,골목상권,1000330,삼양로27길,12,5,7
2019,3,A,골목상권,1000329,삼양로24길,32,19,13
2019,3,A,골목상권,1000328,삼양로20길,210,186,24
2019,3,A,골목상권,1000327,삼각산로28길,98,43,55
2019,3,A,골목상권,1000326,도봉로99길,227,135,92
2019,3,A,골목상권,1000325,도봉로8길,8,6,2
2019,3,A,골목상권,1000324,도봉로76길,325,151,174
2019,3,A,골목상권,1000323,도봉로67길,124,65,59
2019,3,A,골목상권,1000322,도봉로45길,109,55,54
2019,3,A,골목상권,1000321,도봉로18길,202,156,46
2019,3,A,골목상권,1000320,도봉로13길,16,14,2
2019,3,A,골목상권,1000319,덕릉로41길,171,89,82
2019,3,A,골목상권,1000318,덕릉로40길,159,89,70
2019,3,A,골목상권,1000317,노해로33길,104,40,64
2019,3,A,골목상권,1000316,노해로23길,87,48,39
2019,3,A,골목상권,1000315,노해로17길,103,50,53
2019,3,A,골목상권,1000314,화랑로40길,86,53,33
2019,3,A,골목상권,1000313,화랑로32길,359,266,93
2019,3,A,골목상권,1000312,화랑로1길,943,668,275
2019,3,A,골목상권,1000311,화랑로19길,57,25,32
2019,3,A,골목상권,1000310,화랑로14길,141,96,45
2019,3,A,골목상권,1000309,화랑로13길,196,85,111
2019,3,A,골목상권,1000308,한천로76길,345,284,61
2019,3,A,골목상권,1000307,한천로101가길,8,4,4
2019,3,A,골목상권,1000306,창경궁로43길,576,353,223
2019,3,A,골목상권,1000305,지봉로20길,3833,3171,662
2019,3,A,골목상권,1000304,종암로5길,411,209,202
2019,3,A,골목상권,1000303,종암로24가길,75,18,57
2019,3,A,골목상권,1000302,종암로21길,558,351,207
2019,3,A,골목상권,1000301,종암로19길,2396,1433,963
2019,3,A,골목상권,1000300,종암로16길,175,69,106
2019,3,A,골목상권,1000299,정릉로8길,1372,1139,233
2019,3,A,골목상권,1000298,정릉로27길,114,51,63
2019,3,A,골목상권,1000297,정릉로26길,277,137,140
2019,3,A,골목상권,1000296,장위로50길,397,188,209
2019,3,A,골목상권,1000295,장월로1길,78,16,62
2019,3,A,골목상권,1000294,인촌로6길,222,156,66
2019,3,A,골목상권,1000293,인촌로5길,72,36,36
2019,3,A,골목상권,1000292,인촌로24길,1559,1001,558
2019,3,A,골목상권,1000291,개운사길,190,100,90
2019,3,A,골목상권,1000290,인촌로1길,188,88,100
2019,3,A,골목상권,1000289,인촌로17가길,116,70,46
2019,3,A,골목상권,1000288,오패산로4길,662,406,256
2019,3,A,골목상권,1000287,오패산로3길,600,364,236
2019,3,A,골목상권,1000286,오패산로19길,122,52,70
2019,3,A,골목상권,1000285,안암로5길,579,427,152
2019,3,A,골목상권,1000284,아리랑로4길,489,221,268
2019,3,A,골목상권,1000283,솔샘로6길,61,45,16
2019,3,A,골목상권,1000282,성북로8길,212,119,93
2019,3,A,골목상권,1000281,삼양로8길,184,88,96
2019,3,A,골목상권,1000280,삼선교로16가길,110,59,51
2019,3,A,골목상권,1000279,삼선교로10다길,35,14,21
2019,3,A,골목상권,1000278,삼선교로10길,182,104,78
2019,3,A,골목상권,1000277,보문로32길,300,142,158
2019,3,A,골목상권,1000276,보문로31길,318,191,127
2019,3,A,골목상권,1000275,보문로26길,109,47,62
2019,3,A,골목상권,1000274,보문로13길,1236,766,470
2019,3,A,골목상권,1000273,보국문로16길,228,128,100
2019,3,A,골목상권,1000272,동소문로6길,46,21,25
2019,3,A,골목상권,1000271,동소문로2길,73,25,48
2019,3,A,골목상권,1000270,동소문로26가길,305,140,165
2019,3,A,골목상권,1000269,동소문로15길,204,142,62
2019,3,A,골목상권,1000268,동소문로13길,603,289,314
2019,3,A,골목상권,1000267,돌곶이로8길,96,61,35
2019,3,A,골목상권,1000266,돌곶이로41길,55,20,35
2019,3,A,골목상권,1000265,돌곶이로28길,247,127,120
2019,3,A,골목상권,1000264,돌곶이로27길,147,96,51
2019,3,A,골목상권,1000263,돌곶이로22길,74,41,33
2019,3,A,골목상권,1000262,돌곶이로14길,51,34,17
2019,3,A,골목상권,1000261,길음로7길,15,6,9
2019,3,A,골목상권,1000260,중랑천로10길,235,116,119
2019,3,A,골목상권,1000259,용마산로94길,91,63,28
2019,3,A,골목상권,1000258,용마산로118길,173,107,66
2019,3,A,골목상권,1000257,용마산로112길,115,62,53
2019,3,A,골목상권,1000256,용마산로100길,135,54,81
2019,3,A,골목상권,1000255,신내로7가길,280,114,166
2019,3,A,골목상권,1000254,사가정로54길,94,35,59
2019,3,A,골목상권,1000253,사가정로42길,223,84,139
2019,3,A,골목상권,1000252,봉화산로56길,601,309,292
2019,3,A,골목상권,1000251,봉화산로4길,129,42,87
2019,3,A,골목상권,1000250,봉화산로30길,150,33,117
2019,3,A,골목상권,1000249,봉우재로33길,142,52,90
2019,3,A,골목상권,1000248,면목로78길,108,52,56
2019,3,A,골목상권,1000247,면목로56길,141,63,78
2019,3,A,골목상권,1000246,면목로55길,473,308,165
2019,3,A,골목상권,1000245,면목로49길,116,70,46
2019,3,A,골목상권,1000244,면목로48길,842,541,301
2019,3,A,골목상권,1000243,면목로45길,170,95,75
2019,3,A,골목상권,1000242,면목로33길,37,22,15
2019,3,A,골목상권,1000241,면목로21길,37,24,13
2019,3,A,골목상권,1000240,망우로73길,39,28,11
2019,3,A,골목상권,1000239,망우로68길,183,92,91
2019,3,A,골목상권,1000238,동일로163길,137,88,49
2019,3,A,골목상권,1000237,동일로157길,504,286,218
2019,3,A,골목상권,1000236,동일로149길,853,741,112
2019,3,A,골목상권,1000235,동일로140길,321,175,146
2019,3,A,골목상권,1000234,동일로139길,92,61,31
2019,3,A,골목상권,1000233,동일로139가길,215,99,116
2019,3,A,골목상권,1000232,동일로130길,167,121,46
2019,3,A,골목상권,1000231,동일로123길,153,83,70
2019,3,A,골목상권,1000230,동일로112길,318,172,146
2019,3,A,골목상권,1000229,동일로101길,120,50,70
2019,3,A,골목상권,1000228,동일로100길,331,252,79
2019,3,A,골목상권,1000227,답십리로75길,59,32,27
2019,3,A,골목상권,1000226,공릉로2길,398,236,162
2019,3,A,골목상권,1000225,공릉로12가길,139,75,64
2019,3,A,골목상권,1000224,겸재로54길,113,67,46
2019,3,A,골목상권,1000223,겸재로36길,171,72,99
2019,3,A,골목상권,1000222,겸재로29길,160,91,69
2019,3,A,골목상권,1000221,휘경로3길,135,64,71
2019,3,A,골목상권,1000220,휘경로2길,95,47,48
2019,3,A,골목상권,1000219,휘경로23길,181,136,45
2019,3,A,골목상권,1000218,휘경로14길,119,47,72
2019,3,A,골목상권,1000217,한천로46길,240,97,143
2019,3,A,골목상권,1000216,한천로40길,101,66,35
2019,3,A,골목상권,1000215,한천로33길,208,74,134
2019,3,A,골목상권,1000214,한천로14길,781,497,284
2019,3,A,골목상권,1000213,천호대로97길,527,429,98
2019,3,A,골목상권,1000212,천호대로77길,207,132,75
2019,3,A,골목상권,1000211,천호대로45길,61,47,14
2019,3,A,골목상권,1000210,천호대로17길,2981,2142,839
2019,3,A,골목상권,1000209,천호대로12길,96,53,43
2019,3,A,골목상권,1000208,천장산로7길,82,34,48
2019,3,A,골목상권,1000207,제기로5길,63,51,12
2019,3,A,골목상권,1000206,제기로21길,93,53,40
2019,3,A,골목상권,1000205,전농로4길,356,277,79
2019,3,A,골목상권,1000204,전농로3길,184,131,53
2019,3,A,골목상권,1000203,전농로29길,557,400,157
2019,3,A,골목상권,1000202,장한로8길,394,240,154
2019,3,A,골목상권,1000201,장한로5길,419,227,192
2019,3,A,골목상권,1000200,장한로27길,221,120,101
2019,3,A,골목상권,1000199,장한로27가길,190,93,97
2019,3,A,골목상권,1000198,장한로26길,2391,1660,731
2019,3,A,골목상권,1000197,장한로26가길,290,169,121
2019,3,A,골목상권,1000196,장한로25길,314,217,97
2019,3,A,골목상권,1000195,장한로14길,204,127,77
2019,3,A,골목상권,1000194,이문로42길,62,39,23
2019,3,A,골목상권,1000193,왕산로43길,581,225,356
2019,3,A,골목상권,1000192,왕산로33길,78,33,45
2019,3,A,골목상권,1000191,왕산로32길,51,28,23
2019,3,A,골목상권,1000190,약령시로17길,106,73,33
2019,3,A,골목상권,1000189,서울시립대로4길,380,244,136
2019,3,A,골목상권,1000188,서울시립대로29길,431,311,120
2019,3,A,골목상권,1000187,서울시립대로16길,20,9,11
2019,3,A,골목상권,1000186,사가정로2길,283,192,91
2019,3,A,골목상권,1000185,사가정로23가길,109,47,62
2019,3,A,골목상권,1000184,사가정로13길,206,72,134
2019,3,A,골목상권,1000183,무학로45길,296,172,124
2019,3,A,골목상권,1000182,무학로16길,700,430,270
2019,3,A,골목상권,1000181,망우로21길,131,89,42
2019,3,A,골목상권,1000180,망우로18길,232,79,153
2019,3,A,골목상권,1000179,망우로18가길,101,72,29
2019,3,A,골목상권,1000178,답십리로72길,95,36,59
2019,3,A,골목상권,1000177,답십리로69길,487,280,207
2019,3,A,골목상권,1000176,답십리로68길,429,199,230
2019,3,A,골목상권,1000175,답십리로64길,137,88,49
2019,3,A,골목상권,1000174,답십리로63길,1756,1034,722
2019,3,A,골목상권,1000173,답십리로60길,354,216,138
2019,3,A,골목상권,1000172,답십리로56길,90,47,43
2019,3,A,골목상권,1000171,답십리로23길,57,32,25
2019,3,A,골목상권,1000170,난계로30길,5259,2277,2982
2019,3,A,골목상권,1000169,경희대로4길,36,12,24
2019,3,A,골목상권,1000168,경희대로3길,20,9,11
2019,3,A,골목상권,1000167,천호대로129길,376,233,143
2019,3,A,골목상권,1000166,천호대로123길,566,273,293
2019,3,A,골목상권,1000165,천호대로109길,1000,525,475
2019,3,A,골목상권,1000164,자양번영로3길,254,148,106
2019,3,A,골목상권,1000163,자양로53길,222,137,85
2019,3,A,골목상권,1000162,자양로50길,246,143,103
2019,3,A,골목상권,1000161,자양로45길,449,177,272
2019,3,A,골목상권,1000160,자양로26길,173,97,76
2019,3,A,골목상권,1000159,자양로15길,81,42,39
2019,3,A,골목상권,1000158,자양로11길,705,274,431
2019,3,A,골목상권,1000157,용마산로3길,564,432,132
2019,3,A,골목상권,1000156,용마산로21길,364,223,141
2019,3,A,골목상권,1000155,아차산로78길,660,474,186
2019,3,A,골목상권,1000154,아차산로65길,525,358,167
2019,3,A,골목상권,1000153,아차산로55길,322,204,118
2019,3,A,골목상권,1000152,아차산로51길,475,130,345
2019,3,A,골목상권,1000151,아차산로40길,465,253,212
2019,3,A,골목상권,1000150,면목로17길,194,104,90
2019,3,A,골목상권,1000149,뚝섬로64길,306,169,137
2019,3,A,골목상권,1000148,뚝섬로58길,389,185,204
2019,3,A,골목상권,1000147,뚝섬로54길,981,835,146
2019,3,A,골목상권,1000146,뚝섬로48길,243,144,99
2019,3,A,골목상권,1000145,뚝섬로24길,119,74,45
2019,3,A,골목상권,1000144,뚝섬로23길,219,155,64
2019,3,A,골목상권,1000143,동일로24길,62,50,12
2019,3,A,골목상권,1000142,동일로18길,116,58,58
2019,3,A,골목상권,1000141,능동로4길,963,843,120
2019,3,A,골목상권,1000140,능동로3길,70,45,25
2019,3,A,골목상권,1000139,능동로34길,1054,699,355
2019,3,A,골목상권,1000138,능동로19길,170,99,71
2019,3,A,골목상권,1000137,능동로13길,233,114,119
2019,3,A,골목상권,1000136,긴고랑로9길,79,25,54
2019,3,A,골목상권,1000135,긴고랑로8길,954,608,346
2019,3,A,골목상권,1000134,긴고랑로7길,563,443,120
2019,3,A,골목상권,1000133,긴고랑로20길,242,121,121
2019,3,A,골목상권,1000132,광나루로52길,656,440,216
2019,3,A,골목상권,1000131,광나루로40길,305,185,120
2019,3,A,골목상권,1000130,광나루로37길,72,31,41
2019,3,A,골목상권,1000129,광나루로36길,428,176,252
2019,3,A,골목상권,1000128,광나루로24길,32,21,11
2019,3,A,골목상권,1000127,광나루로12길,55,18,37
2019,3,A,골목상권,1000126,한림말길,348,165,183
2019,3,A,골목상권,1000125,한림말3길,2979,1079,1900
2019,3,A,골목상권,1000124,청계천로10나길,972,621,351
2019,3,A,골목상권,1000123,장터길,118,56,62
2019,3,A,골목상권,1000122,용답중앙길,344,121,223
2019,3,A,골목상권,1000121,용답29길,548,346,202
2019,3,A,골목상권,1000120,왕십리로6길,753,483,270
2019,3,A,골목상권,1000119,왕십리로31길,243,104,139
2019,3,A,골목상권,1000118,왕십리로26길,1414,738,676
2019,3,A,골목상권,1000117,왕십리로21길,132,62,70
2019,3,A,골목상권,1000116,왕십리로14길,1050,758,292
2019,3,A,골목상권,1000115,아차산로5길,1961,1073,888
2019,3,A,골목상권,1000114,아차산로15길,3698,2616,1082
2019,3,A,골목상권,1000113,아차산로11길,3847,2751,1096
2019,3,A,골목상권,1000112,송정4가길,443,269,174
2019,3,A,골목상권,1000111,송정12라길,127,44,83
2019,3,A,골목상권,1000110,성수일로6길,1732,1101,631
2019,3,A,골목상권,1000109,성수이로7길,1947,1198,749
2019,3,A,골목상권,1000108,성수이로18길,3060,2001,1059
2019,3,A,골목상권,1000107,성덕정길,266,180,86
2019,3,A,골목상권,1000106,성덕정17길,452,287,165
2019,3,A,골목상권,1000105,서울숲2길,447,274,173
2019,3,A,골목상권,1000104,상원길,2490,1650,840
2019,3,A,골목상권,1000103,상원12길,339,197,142
2019,3,A,골목상권,1000102,사근동길,107,57,50
2019,3,A,골목상권,1000101,무학봉길,45,22,23
2019,3,A,골목상권,1000100,무학봉28길,202,89,113
2019,3,A,골목상권,1000099,무학로6길,771,332,439
2019,3,A,골목상권,1000098,무수막길,200,148,52
2019,3,A,골목상권,1000097,매봉길,67,39,28
2019,3,A,골목상권,1000096,마조로1길,79,53,26
2019,3,A,골목상권,1000095,마조로16길,168,103,65
2019,3,A,골목상권,1000094,마장로39길,477,278,199
2019,3,A,골목상권,1000093,마장로27길,213,109,104
2019,3,A,골목상권,1000092,뚝섬로5길,1930,1347,583
2019,3,A,골목상권,1000091,둘레9길,450,282,168
2019,3,A,골목상권,1000090,금호산길,167,88,79
2019,3,A,골목상권,1000089,금호산2길,89,66,23
2019,3,A,골목상권,1000088,고산자로6길,7561,2336,5225
2019,3,A,골목상권,1000087,후암로28길,600,312,288
2019,3,A,골목상권,1000086,효창원로39길,181,104,77
2019,3,A,골목상권,1000085,회나무로13길,1739,704,1035
2019,3,A,골목상권,1000084,한남대로20길,460,247,213
2019,3,A,골목상권,1000083,한강대로88길,173,131,42
2019,3,A,골목상권,1000082,한강대로7길,500,370,130
2019,3,A,골목상권,1000081,한강대로62길,658,436,222
2019,3,A,골목상권,1000080,한강대로52길,8103,2393,5710
2019,3,A,골목상권,1000079,한강대로43길,1702,976,726
2019,3,A,골목상권,1000078,한강대로15길,720,400,320
2019,3,A,골목상권,1000077,한강대로104길,8558,1934,6624
2019,3,A,골목상권,1000076,청파로73길,236,126,110
2019,3,A,골목상권,1000075,청파로71길,781,568,213
2019,3,A,골목상권,1000074,청파로47나길,242,147,95
2019,3,A,골목상권,1000073,청파로47길,257,126,131
2019,3,A,골목상권,1000072,장문로45길,141,75,66
2019,3,A,골목상권,1000071,이태원로54길,889,578,311
2019,3,A,골목상권,1000070,이태원로27길,1061,681,380
2019,3,A,골목상권,1000069,이촌로22길,376,305,71
2019,3,A,골목상권,1000068,원효로89길,1495,1046,449
2019,3,A,골목상권,1000067,원효로53길,408,260,148
2019,3,A,골목상권,1000066,원효로41길,200,123,77
2019,3,A,골목상권,1000065,원효로19길,481,316,165
2019,3,A,골목상권,1000064,우사단로4길,302,143,159
2019,3,A,골목상권,1000063,우사단로14길,2002,973,1029
2019,3,A,골목상권,1000062,우사단로10길,533,489,44
2019,3,A,골목상권,1000061,신흥로20길,171,120,51
2019,3,A,골목상권,1000060,소월로20길,106,39,67
2019,3,A,골목상권,1000059,서빙고로71길,423,264,159
2019,3,A,골목상권,1000058,백범로90길,533,292,241
2019,3,A,골목상권,1000057,백범로79길,945,583,362
2019,3,A,골목상권,1000056,두텁바위로1길,616,340,276
2019,3,A,골목상권,1000055,대사관로34길,648,430,218
2019,3,A,골목상권,1000054,녹사평대로46길,53,17,36
2019,3,A,골목상권,1000053,녹사평대로40나길,67,31,36
2019,3,A,골목상권,1000052,녹사평대로32길,66,39,27
2019,3,A,골목상권,1000051,녹사평대로26길,466,244,222
2019,3,A,골목상권,1000050,녹사평대로11길,123,92,31
2019,3,A,골목상권,1000049,퇴계로90길,569,244,325
2019,3,A,골목상권,1000048,퇴계로8길,418,196,222
2019,3,A,골목상권,1000047,퇴계로56길,877,655,222
2019,3,A,골목상권,1000046,퇴계로46길,1150,556,594
2019,3,A,골목상권,1000045,퇴계로18길,919,556,363
2019,3,A,골목상권,1000044,퇴계로12길,278,147,131
2019,3,A,골목상권,1000043,청구로1길,91,71,20
2019,3,A,골목상권,1000042,청구로17길,523,344,179
2019,3,A,골목상권,1000041,장충단로8길,3859,1945,1914
2019,3,A,골목상권,1000040,삼일대로4길,1704,1211,493
2019,3,A,골목상권,1000039,명동길,7051,4474,2577
2019,3,A,골목상권,1000038,동호로8길,273,116,157
2019,3,A,골목상권,1000037,동호로20길,1860,879,981
2019,3,A,골목상권,1000036,동호로15길,915,567,348
2019,3,A,골목상권,1000035,동호로11길,354,239,115
2019,3,A,골목상권,1000034,동호로10길,1597,859,738
2019,3,A,골목상권,1000033,다산로39길,49,22,27
2019,3,A,골목상권,1000032,다산로38길,492,213,279
2019,3,A,골목상권,1000031,다산로36길,107,45,62
2019,3,A,골목상권,1000030,다산로33길,354,218,136
2019,3,A,골목상권,1000029,난계로21길,124,85,39
2019,3,A,골목상권,1000028,난계로11길,310,193,117
2019,3,A,골목상권,1000027,필운대로1길,244,79,165
2019,3,A,골목상권,1000026,평창길,2679,1515,1164
2019,3,A,골목상권,1000025,통일로12길,7,4,3
2019,3,A,골목상권,1000024,창신길,173,28,145
2019,3,A,골목상권,1000023,창신5길,22,6,16
2019,3,A,골목상권,1000022,창신2길,61,26,35
2019,3,A,골목상권,1000021,창경궁로35길,134,65,69
2019,3,A,골목상권,1000020,지봉로8길,198,101,97
2019,3,A,골목상권,1000019,종로65길,261,151,110
2019,3,A,골목상권,1000018,종로58가길,170,87,83
2019,3,A,골목상권,1000017,종로24길,1123,778,345
2019,3,A,골목상권,1000016,자하문로7길,507,243,264
2019,3,A,골목상권,1000015,이화장길,540,236,304
2019,3,A,골목상권,1000014,율곡로16길,319,204,115
2019,3,A,골목상권,1000013,율곡로10길,351,224,127
2019,3,A,골목상권,1000012,옥인길,85,48,37
2019,3,A,골목상권,1000011,숭인동길,352,153,199
2019,3,A,골목상권,1000010,성균관로5길,169,91,78
2019,3,A,골목상권,1000009,삼청로5길,2709,2629,80
2019,3,A,골목상권,1000008,북촌로5나길,235,118,117
2019,3,A,골목상권,1000007,북촌로5길,548,431,117
2019,3,A,골목상권,1000006,북촌로11길,501,186,315
2019,3,A,골목상권,1000005,백석동길,1686,1005,681
2019,3,A,골목상권,1000004,명륜길,42,29,13
2019,3,A,골목상권,1000003,돈화문로11가길,3804,2773,1031
2019,3,A,골목상권,1000002,난계로27길,348,159,189
2019,3,A,골목상권,1000001,계동길,609,224,385
2019,2,U,관광특구,1001496,강남 마이스 관광특구,18430,10279,8151
2019,2,U,관광특구,1001495,잠실 관광특구,26843,16958,9885
2019,2,U,관광특구,1001494,종로?청계 관광특구,24700,16394,8306
2019,2,U,관광특구,1001493,동대문패션타운 관광특구,6683,3404,3279
2019,2,U,관광특구,1001492,명동 남대문 북창동 다동 무교동 관광특구,133878,65609,68269
2019,2,U,관광특구,1001491,이태원 관광특구,5797,3200,2597
2019,2,R,전통시장,1001490,길동복조리시장,431,268,163
2019,2,R,전통시장,1001489,둔촌역전통시장,188,104,84
2019,2,R,전통시장,1001488,성내골목시장,35,20,15
2019,2,R,전통시장,1001487,천호시장,32,20,12
2019,2,R,전통시장,1001486,동서울시장,10,5,5
2019,2,R,전통시장,1001485,고분다리골목시장,7,2,5
2019,2,R,전통시장,1001484,양지골목시장,91,61,30
2019,2,R,전통시장,1001483,암사종합시장,80,50,30
2019,2,R,전통시장,1001482,고덕전통시장,1029,945,84
2019,2,R,전통시장,1001481,명일골목시장,87,37,50
2019,2,R,전통시장,1001480,새마을시장,178,105,73
2019,2,R,전통시장,1001479,석촌시장,414,148,266
2019,2,R,전통시장,1001478,방이시장,3029,1247,1782
2019,2,R,전통시장,1001477,마천시장,111,76,35
2019,2,R,전통시장,1001476,풍납시장,63,27,36
2019,2,R,전통시장,1001475,강남개포시장,81,50,31
2019,2,R,전통시장,1001474,도곡시장,58,27,31
2019,2,R,전통시장,1001473,청담삼익시장,60,37,23
2019,2,R,전통시장,1001472,논현종합시장,83,41,42
2019,2,R,전통시장,1001471,영동전통시장,255,106,149
2019,2,R,전통시장,1001470,강남시장_강남,60,39,21
2019,2,R,전통시장,1001469,양재시장,36,23,13
2019,2,R,전통시장,1001468,남부종합시장,69,50,19
2019,2,R,전통시장,1001467,우림시장,55,33,22
2019,2,R,전통시장,1001466,미성동도깨비시장,92,27,65
2019,2,R,전통시장,1001465,신신림시장,1,1,0
2019,2,R,전통시장,1001464,삼성동시장,16,7,9
2019,2,R,전통시장,1001463,신림중앙시장,42,24,18
2019,2,R,전통시장,1001462,강남골목시장,197,118,79
2019,2,R,전통시장,1001461,신림종합시장,6,5,1
2019,2,R,전통시장,1001460,관악신사시장,148,89,59
2019,2,R,전통시장,1001459,신원시장,38,15,23
2019,2,R,전통시장,1001458,인헌시장,131,47,84
2019,2,R,전통시장,1001457,봉천중앙시장,178,53,125
2019,2,R,전통시장,1001456,봉천현대시장,5,2,3
2019,2,R,전통시장,1001455,봉일시장,49,24,25
2019,2,R,전통시장,1001454,봉천제일종합시장,6,1,5
2019,2,R,전통시장,1001453,낙성대시장,24,14,10
2019,2,R,전통시장,1001452,중부시장,85,33,52
2019,2,R,전통시장,1001451,사당시장,73,37,36
2019,2,R,전통시장,1001450,남성역골목시장,490,271,219
2019,2,R,전통시장,1001449,남성사계시장,124,56,68
2019,2,R,전통시장,1001448,흑석시장,87,35,52
2019,2,R,전통시장,1001447,상도4동도깨비골목시장,100,37,63
2019,2,R,전통시장,1001446,성대시장,147,60,87
2019,2,R,전통시장,1001445,영도시장,72,6,66
2019,2,R,전통시장,1001444,상도전통시장,235,115,120
2019,2,R,전통시장,1001443,강남시장_동작,1,0,1
2019,2,R,전통시장,1001442,신노량진시장,5,1,4
2019,2,R,전통시장,1001441,본동인정시장,67,45,22
2019,2,R,전통시장,1001440,노량진중앙시장,181,104,77
2019,2,R,전통시장,1001439,대림중앙시장,41,29,12
2019,2,R,전통시장,1001438,우리시장,11,10,1
2019,2,R,전통시장,1001437,영진시장A동,27,16,11
2019,2,R,전통시장,1001436,사러가시장,83,44,39
2019,2,R,전통시장,1001435,대신시장,39,23,16
2019,2,R,전통시장,1001433,영일시장,174,128,46
2019,2,R,전통시장,1001432,도림시장,7,5,2
2019,2,R,전통시장,1001431,영등포청과시장,30,21,9
2019,2,R,전통시장,1001430,영등포전통시장,1918,1031,887
2019,2,R,전통시장,1001429,은행나무시장,62,35,27
2019,2,R,전통시장,1001428,박미시장,33,24,9
2019,2,R,전통시장,1001427,현대시장,121,55,66
2019,2,R,전통시장,1001426,대명시장,38,17,21
2019,2,R,전통시장,1001425,푸른터시장,4,2,2
2019,2,R,전통시장,1001424,남문시장,82,56,26
2019,2,R,전통시장,1001423,독산동 우시장,605,473,132
2019,2,R,전통시장,1001422,오류시장,77,23,54
2019,2,R,전통시장,1001421,개봉중앙시장,15,10,5
2019,2,R,전통시장,1001420,고척근린시장,60,13,47
2019,2,R,전통시장,1001419,가리봉시장,1,1,0
2019,2,R,전통시장,1001418,남구로시장,73,24,49
2019,2,R,전통시장,1001417,구로시장,15,9,6
2019,2,R,전통시장,1001416,공항시장,5,4,1
2019,2,R,전통시장,1001415,방신전통시장,94,61,33
2019,2,R,전통시장,1001414,송화골목시장,127,44,83
2019,2,R,전통시장,1001413,까치산시장,121,37,84
2019,2,R,전통시장,1001412,화곡본동시장,50,21,29
2019,2,R,전통시장,1001411,남부골목시장,124,41,83
2019,2,R,전통시장,1001410,대원종합시장,7,6,1
2019,2,R,전통시장,1001409,화곡중앙골목시장,138,68,70
2019,2,R,전통시장,1001408,신월중앙시장,118,53,65
2019,2,R,전통시장,1001407,등마루시장,3,3,0
2019,2,R,전통시장,1001406,신정3동골목시장,111,72,39
2019,2,R,전통시장,1001405,신정2동골목시장,45,10,35
2019,2,R,전통시장,1001404,신정제일시장,27,8,19
2019,2,R,전통시장,1001403,신월7동골목시장,43,22,21
2019,2,R,전통시장,1001402,신월6동골목시장,184,116,68
2019,2,R,전통시장,1001400,신월3동골목시장,10,6,4
2019,2,R,전통시장,1001399,경창시장,56,18,38
2019,2,R,전통시장,1001398,월정로시장,71,49,22
2019,2,R,전통시장,1001397,신영시장,54,25,29
2019,2,R,전통시장,1001396,목4동시장,84,48,36
2019,2,R,전통시장,1001395,목3동시장,181,82,99
2019,2,R,전통시장,1001394,목2동시장,426,233,193
2019,2,R,전통시장,1001393,마포농수산물시장,329,231,98
2019,2,R,전통시장,1001392,동진시장,10,5,5
2019,2,R,전통시장,1001391,망원월드컵시장,232,141,91
2019,2,R,전통시장,1001390,망원시장,186,86,100
2019,2,R,전통시장,1001389,합정시장,24,10,14
2019,2,R,전통시장,1001388,영진시장,23,12,11
2019,2,R,전통시장,1001387,서교시장,48,31,17
2019,2,R,전통시장,1001386,신수시장,28,16,12
2019,2,R,전통시장,1001385,아현시장,839,461,378
2019,2,R,전통시장,1001384,마포시장,8,3,5
2019,2,R,전통시장,1001383,공덕시장,3883,1806,2077
2019,2,R,전통시장,1001382,백련시장,57,47,10
2019,2,R,전통시장,1001381,모래내시장,14,9,5
2019,2,R,전통시장,1001380,포방터시장,71,53,18
2019,2,R,전통시장,1001379,인왕시장,51,7,44
2019,2,R,전통시장,1001378,아현가구거리상점가,51,28,23
2019,2,R,전통시장,1001377,영천시장,58,25,33
2019,2,R,전통시장,1001376,수일시장,9,4,5
2019,2,R,전통시장,1001375,증산종합시장,65,12,53
2019,2,R,전통시장,1001374,대림골목시장,234,46,188
2019,2,R,전통시장,1001373,신응암시장,18,12,6
2019,2,R,전통시장,1001372,녹번시장,30,14,16
2019,2,R,전통시장,1001371,대조시장,11,4,7
2019,2,R,전통시장,1001370,역촌중앙시장,2,2,0
2019,2,R,전통시장,1001369,갈현시장,1,1,0
2019,2,R,전통시장,1001368,연서시장,200,139,61
2019,2,R,전통시장,1001367,상계중앙시장,132,67,65
2019,2,R,전통시장,1001366,상계시장,9,3,6
2019,2,R,전통시장,1001365,공릉동도깨비시장,209,165,44
2019,2,R,전통시장,1001364,방학동도깨비시장,46,16,30
2019,2,R,전통시장,1001363,쌍문역골목시장,58,14,44
2019,2,R,전통시장,1001362,백운시장,30,13,17
2019,2,R,전통시장,1001361,신도봉시장,9,6,3
2019,2,R,전통시장,1001360,창동골목시장,106,52,54
2019,2,R,전통시장,1001359,창동신창시장,82,33,49
2019,2,R,전통시장,1001358,수유북부시장,19,13,6
2019,2,R,전통시장,1001357,장미원골목시장,958,615,343
2019,2,R,전통시장,1001356,수유중앙시장,9,5,4
2019,2,R,전통시장,1001355,강북종합시장,45,24,21
2019,2,R,전통시장,1001354,우이시장,70,53,17
2019,2,R,전통시장,1001353,수유전통시장,133,68,65
2019,2,R,전통시장,1001352,번동북부골목시장,51,27,24
2019,2,R,전통시장,1001351,솔샘시장,86,36,50
2019,2,R,전통시장,1001350,숭인시장,57,25,32
2019,2,R,전통시장,1001349,방천골목시장,98,61,37
2019,2,R,전통시장,1001348,동북시장,104,39,65
2019,2,R,전통시장,1001347,석관황금시장,177,147,30
2019,2,R,전통시장,1001346,석관시장,30,19,11
2019,2,R,전통시장,1001345,새석관시장,4,1,3
2019,2,R,전통시장,1001344,번동시장,15,11,4
2019,2,R,전통시장,1001343,장위전통시장,74,43,31
2019,2,R,전통시장,1001342,밤나무골시장,13,1,12
2019,2,R,전통시장,1001341,길음시장,18,5,13
2019,2,R,전통시장,1001340,정릉시장,115,58,57
2019,2,R,전통시장,1001339,정릉아리랑시장,35,10,25
2019,2,R,전통시장,1001338,돈암제일시장,102,27,75
2019,2,R,전통시장,1001337,유영시장,32,7,25
2019,2,R,전통시장,1001336,우림골목시장,345,123,222
2019,2,R,전통시장,1001335,묵1동도깨비시장,43,36,7
2019,2,R,전통시장,1001334,태능시장,57,17,40
2019,2,R,전통시장,1001333,중화제일시장,66,28,38
2019,2,R,전통시장,1001332,사가정시장,93,39,54
2019,2,R,전통시장,1001331,면목골목시장,56,22,34
2019,2,R,전통시장,1001330,동원시장,230,100,130
2019,2,R,전통시장,1001329,동부골목시장,184,69,115
2019,2,R,전통시장,1001328,이문제일시장,1,1,0
2019,2,R,전통시장,1001327,이경시장,14,7,7
2019,2,R,전통시장,1001326,회기시장,63,18,45
2019,2,R,전통시장,1001325,청량리청과물시장,11,7,4
2019,2,R,전통시장,1001324,전곡시장,71,38,33
2019,2,R,전통시장,1001323,답십리시장,99,41,58
2019,2,R,전통시장,1001322,동부시장,13,8,5
2019,2,R,전통시장,1001321,답십리현대시장,53,45,8
2019,2,R,전통시장,1001320,전농로터리시장,17,10,7
2019,2,R,전통시장,1001319,청량리종합시장,18,11,7
2019,2,R,전통시장,1001318,청량리전통시장,9,7,2
2019,2,R,전통시장,1001317,청량리농수산물시장,15,12,3
2019,2,R,전통시장,1001316,서울약령시장,1213,668,545
2019,2,R,전통시장,1001315,동서시장,4,3,1
2019,2,R,전통시장,1001314,경동시장,148,67,81
2019,2,R,전통시장,1001313,청량리수산시장,20,12,8
2019,2,R,전통시장,1001312,용두시장,4,2,2
2019,2,R,전통시장,1001310,구의시장,8,4,4
2019,2,R,전통시장,1001309,조양시장,33,18,15
2019,2,R,전통시장,1001308,영동교골목시장,19,12,7
2019,2,R,전통시장,1001307,능동로골목시장,10,9,1
2019,2,R,전통시장,1001306,노룬산골목시장,26,14,12
2019,2,R,전통시장,1001305,자양종합시장,16,10,6
2019,2,R,전통시장,1001304,자양골목시장,63,34,29
2019,2,R,전통시장,1001303,신성골목시장,10,3,7
2019,2,R,전통시장,1001302,면곡골목시장,62,44,18
2019,2,R,전통시장,1001301,중곡제일시장,122,70,52
2019,2,R,전통시장,1001300,화양제일골목시장,30,7,23
2019,2,R,전통시장,1001299,한아름시장,68,43,25
2019,2,R,전통시장,1001298,성동용답상가시장,55,31,24
2019,2,R,전통시장,1001297,뚝도시장,62,36,26
2019,2,R,전통시장,1001296,금남시장,31,12,19
2019,2,R,전통시장,1001295,행당시장,342,155,187
2019,2,R,전통시장,1001294,마장축산물시장,615,416,199
2019,2,R,전통시장,1001293,보광시장,14,6,8
2019,2,R,전통시장,1001292,이태원제일시장,3,2,1
2019,2,R,전통시장,1001291,이태원시장,50,30,20
2019,2,R,전통시장,1001290,이촌종합시장,100,71,29
2019,2,R,전통시장,1001289,용문전통시장,25,9,16
2019,2,R,전통시장,1001288,만리시장,15,12,3
2019,2,R,전통시장,1001287,신흥시장,7,4,3
2019,2,R,전통시장,1001286,후암시장,22,20,2
2019,2,R,전통시장,1001285,합동(새벽)시장,715,487,228
2019,2,R,전통시장,1001284,서울중앙시장,497,345,152
2019,2,R,전통시장,1001283,백학시장,102,52,50
2019,2,R,전통시장,1001282,약수시장,288,129,159
2019,2,R,전통시장,1001281,청평화시장,117,45,72
2019,2,R,전통시장,1001280,제일평화시장,66,37,29
2019,2,R,전통시장,1001279,동평화시장,216,148,68
2019,2,R,전통시장,1001278,남평화시장,3,2,1
2019,2,R,전통시장,1001277,방산종합시장,1245,767,478
2019,2,R,전통시장,1001276,평화시장,1433,1006,427
2019,2,R,전통시장,1001275,인현시장,180,126,54
2019,2,R,전통시장,1001274,신중부시장,3125,1030,2095
2019,2,R,전통시장,1001273,남대문시장,6883,2898,3985
2019,2,R,전통시장,1001272,신설종합시장,35,25,10
2019,2,R,전통시장,1001271,동묘시장,554,263,291
2019,2,R,전통시장,1001270,창신골목시장,18,9,9
2019,2,R,전통시장,1001269,동문시장,10,6,4
2019,2,R,전통시장,1001268,충신시장,53,30,23
2019,2,R,전통시장,1001267,종로신진시장,180,102,78
2019,2,R,전통시장,1001266,동대문종합시장,1459,1062,397
2019,2,R,전통시장,1001265,광장시장,395,276,119
2019,2,R,전통시장,1001264,통인시장,72,32,40
2019,2,D,발달상권,1001263,서울 노원구 노원역_3,485,181,304
2019,2,D,발달상권,1001262,서울 노원구 노원역_2,297,130,167
2019,2,D,발달상권,1001261,서울 노원구 노원역_1,401,96,305
2019,2,D,발달상권,1001260,창동역,1106,645,461
2019,2,D,발달상권,1001259,서울 강북구 수유역_3,97,49,48
2019,2,D,발달상권,1001258,등나무근린공원 주변,73,24,49
2019,2,D,발달상권,1001257,서울 강북구 수유역_2,2296,1126,1170
2019,2,D,발달상권,1001256,서울 강북구 수유역_1,870,443,427
2019,2,D,발달상권,1001255,서울 은평구 연신내역_3,106,20,86
2019,2,D,발달상권,1001254,서울 은평구 연신내역_2,598,172,426
2019,2,D,발달상권,1001253,서울 은평구 연신내역_1,58,23,35
2019,2,D,발달상권,1001252,서울 성북구 미아삼거리역_2,292,137,155
2019,2,D,발달상권,1001251,서울 강북구 미아삼거리역_1,307,207,100
2019,2,D,발달상권,1001250,서울 은평구 불광역_3,87,31,56
2019,2,D,발달상권,1001249,서울 은평구 불광역_2,118,40,78
2019,2,D,발달상권,1001248,서울 은평구 불광역_1,222,105,117
2019,2,D,발달상권,1001247,미아사거리_2,97,50,47
2019,2,D,발달상권,1001246,미아사거리_1,200,96,104
2019,2,D,발달상권,1001245,서울 성북구 성신여대입구역,1309,888,421
2019,2,D,발달상권,1001244,경희대학교,82,32,50
2019,2,D,발달상권,1001243,서울 성북구 안암역,76,39,37
2019,2,D,발달상권,1001242,혜화역 대학로_3,516,229,287
2019,2,D,발달상권,1001241,혜화역 대학로_2,337,266,71
2019,2,D,발달상권,1001240,혜화역 대학로_1,1581,798,783
2019,2,D,발달상권,1001239,디지털미디어시티,6841,4400,2441
2019,2,D,발달상권,1001238,서울 동대문구 청량리역,925,471,454
2019,2,D,발달상권,1001237,서울 종로구 경복궁역_2,305,143,162
2019,2,D,발달상권,1001236,서울 종로구 안국역_2,1657,826,831
2019,2,D,발달상권,1001235,서울 종로구 안국역_1,3070,2122,948
2019,2,D,발달상권,1001234,서울 종로구 경복궁역_1,633,422,211
2019,2,D,발달상권,1001233,서울 종로구 종로3가역_3,1208,595,613
2019,2,D,발달상권,1001232,서울 종로구 종로3가역_2,909,446,463
2019,2,D,발달상권,1001231,서울 동대문구 신설동역_2,4387,1150,3237
2019,2,D,발달상권,1001230,인사동,25772,15160,10612
2019,2,D,발달상권,1001229,서울 종로구 종로5가역_4,1304,937,367
2019,2,D,발달상권,1001228,서울 종로구 종로5가역_3,1775,1159,616
2019,2,D,발달상권,1001227,종로구청,22114,12078,10036
2019,2,D,발달상권,1001226,서울 종로구 종로5가역_2,11914,7932,3982
2019,2,D,발달상권,1001225,신설동역,202,110,92
2019,2,D,발달상권,1001224,서울 동대문구 신설동역_1,749,320,429
2019,2,D,발달상권,1001223,서울 종로구 광화문역_2,25717,16545,9172
2019,2,D,발달상권,1001222,동묘앞역,869,772,97
2019,2,D,발달상권,1001221,장안동사거리,1764,644,1120
2019,2,D,발달상권,1001220,서울 종로구 동대문역_2,751,232,519
2019,2,D,발달상권,1001219,서울 종로구 동대문역_1,31,18,13
2019,2,D,발달상권,1001218,동대문시장_2,235,139,96
2019,2,D,발달상권,1001217,서울 종로구 종로5가역_1,30,13,17
2019,2,D,발달상권,1001216,서울 종로구 종로3가역_1,2698,1215,1483
2019,2,D,발달상권,1001215,서울 종로구 광화문역_1,14333,8386,5947
2019,2,D,발달상권,1001214,종각역,10055,7801,2254
2019,2,D,발달상권,1001213,종각역 젊음의 거리,3763,2264,1499
2019,2,D,발달상권,1001212,서대문구 서대문역_1,89,60,29
2019,2,D,발달상권,1001211,동대문시장_1,1597,460,1137
2019,2,D,발달상권,1001210,시청역_2,14293,9492,4801
2019,2,D,발달상권,1001209,서울시청,9762,5303,4459
2019,2,D,발달상권,1001208,서울 중구 을지로3가역_2,3297,2165,1132
2019,2,D,발달상권,1001207,서울 중구 신당역_2,764,425,339
2019,2,D,발달상권,1001206,서대문구 서대문역_2,1313,917,396
2019,2,D,발달상권,1001205,동대문역사문화공원역,3244,2583,661
2019,2,D,발달상권,1001204,서울 중구 을지로3가역_1,4668,2292,2376
2019,2,D,발달상권,1001203,명동거리,33325,13963,19362
2019,2,D,발달상권,1001202,롯데백화점,24501,9056,15445
2019,2,D,발달상권,1001201,서울 중구 신당역_1,397,195,202
2019,2,D,발달상권,1001200,북창동,6996,3577,3419
2019,2,D,발달상권,1001199,서울 중구 충무로역_2,17551,7586,9965
2019,2,D,발달상권,1001198,서울 강서구 송정역,407,199,208
2019,2,D,발달상권,1001197,장한평역_2,1648,1063,585
2019,2,D,발달상권,1001196,시청역_1,38617,23204,15413
2019,2,D,발달상권,1001195,왕십리역_2,295,151,144
2019,2,D,발달상권,1001194,서울 강서구 발산역,1381,854,527
2019,2,D,발달상권,1001193,장한평역_1,1134,766,368
2019,2,D,발달상권,1001192,서울 중구 충무로역_1,4375,2786,1589
2019,2,D,발달상권,1001191,왕십리역_1,20,11,9
2019,2,D,발달상권,1001190,장한평역,3895,2272,1623
2019,2,D,발달상권,1001189,서울 중구 명동역,10846,7088,3758
2019,2,D,발달상권,1001188,장충동 족발거리,2514,1233,1281
2019,2,D,발달상권,1001187,한양시장,44,22,22
2019,2,D,발달상권,1001186,서울 서대문구 이대역,377,158,219
2019,2,D,발달상권,1001185,서울 서대문구 신촌역,969,401,568
2019,2,D,발달상권,1001184,서울 마포구 홍대입구역_3,877,348,529
2019,2,D,발달상권,1001183,서울 마포구 홍대입구역_2,1685,599,1086
2019,2,D,발달상권,1001182,홍익대학교 주변,10364,5912,4452
2019,2,D,발달상권,1001181,서울 광진구 군자역,726,433,293
2019,2,D,발달상권,1001180,신촌역,849,329,520
2019,2,D,발달상권,1001179,강서구청,4335,2630,1705
2019,2,D,발달상권,1001178,서울 마포구 홍대입구역_1,1608,858,750
2019,2,D,발달상권,1001177,서울 중구 약수역_2,206,95,111
2019,2,D,발달상권,1001176,서울 중구 약수역_1,13,3,10
2019,2,D,발달상권,1001175,서울 강동구 고덕역,1023,653,370
2019,2,D,발달상권,1001174,등촌역,111,55,56
2019,2,D,발달상권,1001173,서울 강동구 명일역,663,252,411
2019,2,D,발달상권,1001172,어린이대공원역,47,15,32
2019,2,D,발달상권,1001171,서울 마포구 공덕역_2,3874,2494,1380
2019,2,D,발달상권,1001170,공덕역,2470,1444,1026
2019,2,D,발달상권,1001169,서울 용산구 숙대입구역,2911,571,2340
2019,2,D,발달상권,1001168,남영역,6921,4022,2899
2019,2,D,발달상권,1001167,서울 마포구 공덕역_1,5172,3743,1429
2019,2,D,발달상권,1001166,서울 마포구 마포역_2,13137,8053,5084
2019,2,D,발달상권,1001165,서울 광진구 건대입구역_2,551,301,250
2019,2,D,발달상권,1001164,서울 마포구 마포역_1,3431,2457,974
2019,2,D,발달상권,1001163,서울 강동구 천호역_2,2198,1018,1180
2019,2,D,발달상권,1001162,서울 광진구 건대입구역_1,154,67,87
2019,2,D,발달상권,1001161,건대입구역,362,212,150
2019,2,D,발달상권,1001160,서울 광진구 구의역,914,588,326
2019,2,D,발달상권,1001159,서울 강동구 천호역,327,139,188
2019,2,D,발달상권,1001158,당산역_2,1672,1152,520
2019,2,D,발달상권,1001157,서울 강동구 천호역_1,178,74,104
2019,2,D,발달상권,1001156,서울 강동구 길동역,2749,1262,1487
2019,2,D,발달상권,1001155,용산 전자상가_5,2223,1678,545
2019,2,D,발달상권,1001154,용산 전자상가_4,349,252,97
2019,2,D,발달상권,1001153,당산역_1,331,183,148
2019,2,D,발달상권,1001152,서울 광진구 강변역,2160,1695,465
2019,2,D,발달상권,1001151,용산 전자상가_3,2244,1656,588
2019,2,D,발달상권,1001150,서울 용산구 이태원역,846,505,341
2019,2,D,발달상권,1001149,한남오거리,659,450,209
2019,2,D,발달상권,1001148,목동사거리,63,17,46
2019,2,D,발달상권,1001147,용산 전자상가_2,594,475,119
2019,2,D,발달상권,1001146,용산구청,284,197,87
2019,2,D,발달상권,1001145,용산 전자상가_1,3414,2466,948
2019,2,D,발달상권,1001144,국회의사당역_2,18939,11162,7777
2019,2,D,발달상권,1001143,서울 용산구 신용산역,968,657,311
2019,2,D,발달상권,1001142,국회의사당역_1,4489,3474,1015
2019,2,D,발달상권,1001141,압구정 로데오거리_2,8894,3075,5819
2019,2,D,발달상권,1001140,서울 강남구 압구정역,9378,4528,4850
2019,2,D,발달상권,1001139,서울 영등포구 영등포구청역,434,269,165
2019,2,D,발달상권,1001138,압구정 로데오거리_1,14181,6988,7193
2019,2,D,발달상권,1001137,서울 강동구 둔촌동역,302,132,170
2019,2,D,발달상권,1001136,오목교역,114,58,56
2019,2,D,발달상권,1001135,신사동 가로수길,15305,7796,7509
2019,2,D,발달상권,1001134,서울 영등포구 여의도역_2,31529,20808,10721
2019,2,D,발달상권,1001133,청담사거리_3,3033,2097,936
2019,2,D,발달상권,1001132,영등포유통상가,1647,1042,605
2019,2,D,발달상권,1001131,청담역_2,4354,3343,1011
2019,2,D,발달상권,1001130,청담역_1,5401,3449,1952
2019,2,D,발달상권,1001129,청담사거리_2,1350,711,639
2019,2,D,발달상권,1001128,청담사거리_1,503,192,311
2019,2,D,발달상권,1001127,서울 영등포구 여의도역_1,20996,13276,7720
2019,2,D,발달상권,1001126,서울 양천구 신정네거리역_2,31,21,10
2019,2,D,발달상권,1001125,학동사거리_2,2344,1351,993
2019,2,D,발달상권,1001124,서울 영등포구 영등포시장역,620,394,226
2019,2,D,발달상권,1001123,학동사거리_1,3887,2444,1443
2019,2,D,발달상권,1001122,여의도 시범아파트앞,12813,7555,5258
2019,2,D,발달상권,1001121,영등포역_3,137,77,60
2019,2,D,발달상권,1001120,도산공원사거리_1,3595,1700,1895
2019,2,D,발달상권,1001119,영등포역_2,560,241,319
2019,2,D,발달상권,1001118,문래동 주민센터,6909,4050,2859
2019,2,D,발달상권,1001117,강남구 신사역_2,9468,3993,5475
2019,2,D,발달상권,1001116,영등포역_1,110,48,62
2019,2,D,발달상권,1001115,서울 강남구 강남구청역_2,2489,1347,1142
2019,2,D,발달상권,1001114,강남구 신사역_1,1123,644,479
2019,2,D,발달상권,1001113,서울 동작구 노량진1동_1,98,59,39
2019,2,D,발달상권,1001112,서울 강남구 학동역_3,3886,1975,1911
2019,2,D,발달상권,1001111,서울 강남구 강남구청역_1,3755,2581,1174
2019,2,D,발달상권,1001110,잠실역,45953,24023,21930
2019,2,D,발달상권,1001109,강남구 논현역_4,6134,3682,2452
2019,2,D,발달상권,1001108,학동역,1016,607,409
2019,2,D,발달상권,1001107,방이동 먹자골목,7253,4766,2487
2019,2,D,발달상권,1001106,서울 강남구 학동역_2,2446,1605,841
2019,2,D,발달상권,1001105,서울 동작구 노량진역,590,313,277
2019,2,D,발달상권,1001104,삼성역_3,29439,23456,5983
2019,2,D,발달상권,1001103,코엑스,18430,10279,8151
2019,2,D,발달상권,1001102,서울 강남구 학동역_1,1762,1052,710
2019,2,D,발달상권,1001101,선정릉역_2,4273,2944,1329
2019,2,D,발달상권,1001100,강남구 논현역_3,4119,1341,2778
2019,2,D,발달상권,1001099,포스코사거리_2,15779,9200,6579
2019,2,D,발달상권,1001098,포스코사거리_1,15421,8733,6688
2019,2,D,발달상권,1001097,잠실역 롯데월드,2261,1178,1083
2019,2,D,발달상권,1001096,신도림역,2078,1248,830
2019,2,D,발달상권,1001095,강남구 논현역_2,9583,5755,3828
2019,2,D,발달상권,1001094,선정릉역_1,2523,1560,963
2019,2,D,발달상권,1001093,신천역,4717,2610,2107
2019,2,D,발달상권,1001092,강남구 논현역_1,2888,1439,1449
2019,2,D,발달상권,1001091,삼성역_2,11421,6149,5272
2019,2,D,발달상권,1001090,삼정역_2,1226,745,481
2019,2,D,발달상권,1001089,삼정역_1,1881,839,1042
2019,2,D,발달상권,1001088,삼성역_1,27060,17796,9264
2019,2,D,발달상권,1001087,서울 강남구 선릉역_2,40349,21297,19052
2019,2,D,발달상권,1001086,고속터미널역,3484,2919,565
2019,2,D,발달상권,1001085,서울 서초구 강남역,23161,13139,10022
2019,2,D,발달상권,1001084,서울 강남구 선릉역_1,16664,6446,10218
2019,2,D,발달상권,1001083,서울 송파구 석촌역_2,569,313,256
2019,2,D,발달상권,1001082,선릉역_2,27366,16796,10570
2019,2,D,발달상권,1001081,서울 강남구 역삼역_2,19816,16079,3737
2019,2,D,발달상권,1001080,서울 송파구 석촌역_1,225,145,80
2019,2,D,발달상권,1001079,석촌역,183,138,45
2019,2,D,발달상권,1001078,서울 강남구 강남역_2,9238,4452,4786
2019,2,D,발달상권,1001077,선릉역_1,27712,18453,9259
2019,2,D,발달상권,1001076,구로역,242,109,133
2019,2,D,발달상권,1001075,역삼역_2,10035,4561,5474
2019,2,D,발달상권,1001074,대림역_2,7362,5460,1902
2019,2,D,발달상권,1001073,서울 강남구 역삼역_1,25120,16158,8962
2019,2,D,발달상권,1001072,신대방삼거리역,405,258,147
2019,2,D,발달상권,1001071,서울 강남구 한티역,730,391,339
2019,2,D,발달상권,1001070,은마아파트입구사거리_4,544,234,310
2019,2,D,발달상권,1001069,은마아파트입구사거리_3,92,37,55
2019,2,D,발달상권,1001068,은마아파트입구사거리_2,5766,3271,2495
2019,2,D,발달상권,1001067,오류동역,1857,1329,528
2019,2,D,발달상권,1001066,서울 강남구 강남역,38675,18386,20289
2019,2,D,발달상권,1001065,은마아파트입구사거리_1,347,182,165
2019,2,D,발달상권,1001064,대림역_1,278,163,115
2019,2,D,발달상권,1001063,교대역_4,6895,4614,2281
2019,2,D,발달상권,1001062,서울 강남구 강남역_1,26031,15075,10956
2019,2,D,발달상권,1001061,방배동카페골목,229,97,132
2019,2,D,발달상권,1001060,가락시장,61,50,11
2019,2,D,발달상권,1001059,교대역_3,1262,780,482
2019,2,D,발달상권,1001058,역삼역_1,4438,2701,1737
2019,2,D,발달상권,1001057,교대역_2,2851,1597,1254
2019,2,D,발달상권,1001056,서울 송파구 가락시장역,4251,2667,1584
2019,2,D,발달상권,1001055,서울 서초구 서초역,1791,903,888
2019,2,D,발달상권,1001054,서울 강남구 대치역_2,981,565,416
2019,2,D,발달상권,1001053,서울 강남구 대치역_1,99,31,68
2019,2,D,발달상권,1001052,뱅뱅사거리_2,13297,8922,4375
2019,2,D,발달상권,1001051,보라매공원,2357,1432,925
2019,2,D,발달상권,1001050,교대역_1,17111,8100,9011
2019,2,D,발달상권,1001049,개봉동 현대아파트 인근,276,131,145
2019,2,D,발달상권,1001048,뱅뱅사거리,6920,4334,2586
2019,2,D,발달상권,1001047,뱅뱅사거리_1,5288,4076,1212
2019,2,D,발달상권,1001046,서울 관악구 신림역_4,418,169,249
2019,2,D,발달상권,1001045,동작구 총신대입구역_1,438,188,250
2019,2,D,발달상권,1001044,양재역_3,8867,5289,3578
2019,2,D,발달상권,1001043,동작구 총신대입구역_2,1952,949,1003
2019,2,D,발달상권,1001042,서울 서초구 남부터미널역_3,3086,1255,1831
2019,2,D,발달상권,1001041,서울 강남구 수서역,14566,8218,6348
2019,2,D,발달상권,1001040,서울 관악구 신림역_3,93,33,60
2019,2,D,발달상권,1001039,서울 서초구 남부터미널역_2,3694,2446,1248
2019,2,D,발달상권,1001038,구로디지탈1단지,46412,29926,16486
2019,2,D,발달상권,1001037,양재역,1019,522,497
2019,2,D,발달상권,1001036,문정역,88,50,38
2019,2,D,발달상권,1001035,매봉역,7223,4863,2360
2019,2,D,발달상권,1001034,서울 서초구 방배역,1802,1019,783
2019,2,D,발달상권,1001033,서울 서초구 남부터미널역_1,2467,1466,1001
2019,2,D,발달상권,1001032,서울 관악구 신림역_2,170,57,113
2019,2,D,발달상권,1001031,서울 관악구 신림역_1,1369,485,884
2019,2,D,발달상권,1001030,양재역_2,4149,2003,2146
2019,2,D,발달상권,1001029,양재역_1,522,321,201
2019,2,D,발달상권,1001028,서울 관악구 서울대입구역_2,79,38,41
2019,2,D,발달상권,1001027,가산디지털단지역_3,25379,15619,9760
2019,2,D,발달상권,1001026,구로디지털단지역,101,74,27
2019,2,D,발달상권,1001025,서울 관악구 서울대입구역_1,1561,862,699
2019,2,D,발달상권,1001024,관악구 사당역_1,5377,2218,3159
2019,2,D,발달상권,1001023,가산디지털단지역_2,35995,22069,13926
2019,2,D,발달상권,1001022,관악구 사당역_2,1216,576,640
2019,2,D,발달상권,1001021,가산디지털단지역_1,17408,11968,5440
2019,2,D,발달상권,1001020,장지역,4710,3160,1550
2019,2,D,발달상권,1001019,포이사거리_1,119,69,50
2019,2,D,발달상권,1001018,포이사거리_2,11006,6153,4853
2019,2,D,발달상권,1001017,관악구 사당역_3,1530,1124,406
2019,2,D,발달상권,1001016,서울 관악구 대학동_1,348,230,118
2019,2,D,발달상권,1001015,서울 금천구 독산1동_1,991,624,367
2019,2,D,발달상권,1001014,양재동 꽃시장,1559,866,693
2019,2,D,발달상권,1001013,양재 화물트럭터미널앞_2,1137,848,289
2019,2,D,발달상권,1001012,양재 화물트럭터미널앞_1,1955,1643,312
2019,2,D,발달상권,1001011,서울 금천구 시흥1동_4,590,216,374
2019,2,A,골목상권,1001010,풍성로37가길,231,73,158
2019,2,A,골목상권,1001009,천호옛길,543,378,165
2019,2,A,골목상권,1001008,천호옛14길,149,95,54
2019,2,A,골목상권,1001007,천호대로219길,462,305,157
2019,2,A,골목상권,1001006,천호대로197길,504,261,243
2019,2,A,골목상권,1001005,천호대로187길,348,195,153
2019,2,A,골목상권,1001004,천호대로170길,328,202,126
2019,2,A,골목상권,1001003,천호대로162길,244,142,102
2019,2,A,골목상권,1001002,천중로51길,824,549,275
2019,2,A,골목상권,1001001,천중로39길,597,389,208
2019,2,A,골목상권,1001000,진황도로47길,186,89,97
2019,2,A,골목상권,1000999,진황도로27길,290,173,117
2019,2,A,골목상권,1000998,올림픽로98길,213,155,58
2019,2,A,골목상권,1000997,올림픽로80길,135,39,96
2019,2,A,골목상권,1000996,올림픽로78길,99,44,55
2019,2,A,골목상권,1000995,올림픽로77길,211,119,92
2019,2,A,골목상권,1000994,올림픽로71길,194,103,91
2019,2,A,골목상권,1000993,올림픽로48길,2051,1337,714
2019,2,A,골목상권,1000992,양재대로96길,229,149,80
2019,2,A,골목상권,1000991,양재대로95길,605,330,275
2019,2,A,골목상권,1000990,양재대로91길,354,228,126
2019,2,A,골목상권,1000989,양재대로133길,318,168,150
2019,2,A,골목상권,1000988,양재대로124길,479,271,208
2019,2,A,골목상권,1000987,양재대로116길,71,37,34
2019,2,A,골목상권,1000986,양재대로101길,672,297,375
2019,2,A,골목상권,1000985,암사길,251,153,98
2019,2,A,골목상권,1000984,성안로3길,2085,1262,823
2019,2,A,골목상권,1000983,성내로5길,1138,709,429
2019,2,A,골목상권,1000982,상일로5길,176,123,53
2019,2,A,골목상권,1000981,상암로5길,317,129,188
2019,2,A,골목상권,1000980,상암로51길,384,174,210
2019,2,A,골목상권,1000979,상암로4길,256,160,96
2019,2,A,골목상권,1000978,상암로14길,447,281,166
2019,2,A,골목상권,1000977,명일로13길,261,159,102
2019,2,A,골목상권,1000976,동남로85길,301,213,88
2019,2,A,골목상권,1000975,동남로82길,125,81,44
2019,2,A,골목상권,1000974,동남로65길,316,209,107
2019,2,A,골목상권,1000973,구천면로42길,280,93,187
2019,2,A,골목상권,1000972,구천면로41길,400,206,194
2019,2,A,골목상권,1000971,구천면로36길,45,22,23
2019,2,A,골목상권,1000970,고덕로61길,96,57,39
2019,2,A,골목상권,1000969,고덕로25길,286,199,87
2019,2,A,골목상권,1000968,고덕로10길,819,385,434
2019,2,A,골목상권,1000967,강동대로53길,1182,759,423
2019,2,A,골목상권,1000966,풍성로25길,77,38,39
2019,2,A,골목상권,1000965,오금로46길,780,409,371
2019,2,A,골목상권,1000964,오금로36길,1470,1046,424
2019,2,A,골목상권,1000963,오금로11길,1152,720,432
2019,2,A,골목상권,1000962,양재대로72길,225,118,107
2019,2,A,골목상권,1000961,양재대로71길,2400,1739,661
2019,2,A,골목상권,1000960,양재대로64길,1422,813,609
2019,2,A,골목상권,1000959,양재대로62길,6233,3834,2399
2019,2,A,골목상권,1000958,송파대로30길,1969,1432,537
2019,2,A,골목상권,1000957,송이로36길,1596,1066,530
2019,2,A,골목상권,1000956,송이로32길,1336,801,535
2019,2,A,골목상권,1000955,송이로23길,1776,1262,514
2019,2,A,골목상권,1000954,삼전로13길,1272,791,481
2019,2,A,골목상권,1000953,백제고분로50길,1354,867,487
2019,2,A,골목상권,1000952,백제고분로46길,677,475,202
2019,2,A,골목상권,1000951,백제고분로45길,1150,713,437
2019,2,A,골목상권,1000950,백제고분로42길,631,320,311
2019,2,A,골목상권,1000949,백제고분로39길,1288,837,451
2019,2,A,골목상권,1000948,백제고분로34길,1857,1347,510
2019,2,A,골목상권,1000947,백제고분로33길,1138,741,397
2019,2,A,골목상권,1000946,백제고분로32길,710,423,287
2019,2,A,골목상권,1000945,백제고분로31길,1747,1347,400
2019,2,A,골목상권,1000944,백제고분로22길,928,601,327
2019,2,A,골목상권,1000943,백제고분로21길,461,293,168
2019,2,A,골목상권,1000942,마천로51길,379,213,166
2019,2,A,골목상권,1000941,동남로20길,2640,1844,796
2019,2,A,골목상권,1000940,거마로20길,514,245,269
2019,2,A,골목상권,1000939,학동로77길,2314,1362,952
2019,2,A,골목상권,1000938,학동로6길,1599,1065,534
2019,2,A,골목상권,1000937,학동로56길,2664,1762,902
2019,2,A,골목상권,1000936,학동로38길,1947,920,1027
2019,2,A,골목상권,1000935,테헤란로81길,1832,919,913
2019,2,A,골목상권,1000934,일원로9길,526,295,231
2019,2,A,골목상권,1000933,일원로3길,396,212,184
2019,2,A,골목상권,1000932,영동대로65길,1259,735,524
2019,2,A,골목상권,1000931,영동대로112길,14335,11746,2589
2019,2,A,골목상권,1000930,언주로81길,5855,3838,2017
2019,2,A,골목상권,1000929,압구정로2길,1819,1266,553
2019,2,A,골목상권,1000928,선릉로18길,561,420,141
2019,2,A,골목상권,1000927,선릉로146길,971,480,491
2019,2,A,골목상권,1000926,선릉로133길,781,452,329
2019,2,A,골목상권,1000925,선릉로132길,1291,618,673
2019,2,A,골목상권,1000924,선릉로121길,2164,1181,983
2019,2,A,골목상권,1000923,삼성로75길,2145,1449,696
2019,2,A,골목상권,1000922,삼성로69길,1962,1057,905
2019,2,A,골목상권,1000921,삼성로64길,3234,1576,1658
2019,2,A,골목상권,1000920,삼성로63길,1124,575,549
2019,2,A,골목상권,1000919,삼성로57길,2446,1558,888
2019,2,A,골목상권,1000918,삼성로147길,204,93,111
2019,2,A,골목상권,1000917,삼성로115길,837,420,417
2019,2,A,골목상권,1000916,봉은사로68길,1383,854,529
2019,2,A,골목상권,1000915,봉은사로57길,477,278,199
2019,2,A,골목상권,1000914,봉은사로43길,4389,2637,1752
2019,2,A,골목상권,1000913,봉은사로29길,2316,1703,613
2019,2,A,골목상권,1000912,봉은사로109길,3073,2193,880
2019,2,A,골목상권,1000911,도산대로89길,1366,712,654
2019,2,A,골목상권,1000910,도산대로81길,12220,10167,2053
2019,2,A,골목상권,1000909,도산대로50길,2456,1656,800
2019,2,A,골목상권,1000908,도산대로38길,1114,662,452
2019,2,A,골목상권,1000907,도산대로30길,2619,1317,1302
2019,2,A,골목상권,1000906,도산대로23길,606,253,353
2019,2,A,골목상권,1000905,도산대로15길,292,167,125
2019,2,A,골목상권,1000904,도곡로37길,7533,4630,2903
2019,2,A,골목상권,1000903,논현로8길,886,597,289
2019,2,A,골목상권,1000902,논현로63길,2108,1433,675
2019,2,A,골목상권,1000901,논현로28길,3338,2289,1049
2019,2,A,골목상권,1000900,논현로26길,16339,4308,12031
2019,2,A,골목상권,1000899,논현로159길,368,126,242
2019,2,A,골목상권,1000898,논현로139길,3993,2346,1647
2019,2,A,골목상권,1000897,논현로123길,203,122,81
2019,2,A,골목상권,1000896,논현로115길,2392,1454,938
2019,2,A,골목상권,1000895,논현로10길,581,343,238
2019,2,A,골목상권,1000894,논현로106길,1458,1011,447
2019,2,A,골목상권,1000893,남부순환로365길,714,454,260
2019,2,A,골목상권,1000892,개포로82길,94,54,40
2019,2,A,골목상권,1000891,개포로28길,584,439,145
2019,2,A,골목상권,1000890,개포로20길,768,474,294
2019,2,A,골목상권,1000889,개포로17길,1190,828,362
2019,2,A,골목상권,1000888,강남대로140길,1129,561,568
2019,2,A,골목상권,1000887,강남대로136길,5386,3882,1504
2019,2,A,골목상권,1000886,강남대로118길,216,97,119
2019,2,A,골목상권,1000885,서초중앙로8길,3692,2516,1176
2019,2,A,골목상권,1000884,방배중앙로21길,7175,2607,4568
2019,2,A,골목상권,1000883,효령로72길,6106,5022,1084
2019,2,A,골목상권,1000882,효령로34길,1303,793,510
2019,2,A,골목상권,1000881,효령로31길,2618,2108,510
2019,2,A,골목상권,1000880,효령로23길,1743,1155,588
2019,2,A,골목상권,1000879,청두곶길,1530,834,696
2019,2,A,골목상권,1000878,주흥길,170,105,65
2019,2,A,골목상권,1000877,주흥15길,650,412,238
2019,2,A,골목상권,1000876,언남길,1248,811,437
2019,2,A,골목상권,1000875,신반포로45길,1139,590,549
2019,2,A,골목상권,1000874,서초대로8길,3044,719,2325
2019,2,A,골목상권,1000873,서초대로64길,1706,1213,493
2019,2,A,골목상권,1000872,서초대로4길,890,520,370
2019,2,A,골목상권,1000871,서초대로25길,2755,2175,580
2019,2,A,골목상권,1000870,서초대로23길,2349,1375,974
2019,2,A,골목상권,1000869,서초대로15길,519,325,194
2019,2,A,골목상권,1000868,사평대로57길,84,47,37
2019,2,A,골목상권,1000867,사평대로26길,615,402,213
2019,2,A,골목상권,1000866,사평대로22길,1825,1099,726
2019,2,A,골목상권,1000865,사임당로17길,2107,1279,828
2019,2,A,골목상권,1000864,방배로42길,853,701,152
2019,2,A,골목상권,1000863,방배로35길,1386,874,512
2019,2,A,골목상권,1000862,방배로18길,917,589,328
2019,2,A,골목상권,1000861,반포대로9길,532,297,235
2019,2,A,골목상권,1000860,바우뫼로39길,2853,1707,1146
2019,2,A,골목상권,1000859,마방로2길,3386,2494,892
2019,2,A,골목상권,1000858,방배천로4안길,1082,468,614
2019,2,A,골목상권,1000857,동산로19길,1318,656,662
2019,2,A,골목상권,1000856,동산로10길,1650,1164,486
2019,2,A,골목상권,1000855,동광로39길,1217,833,384
2019,2,A,골목상권,1000854,동광로1길,1470,667,803
2019,2,A,골목상권,1000853,동광로12길,873,489,384
2019,2,A,골목상권,1000852,논현로27길,2976,2165,811
2019,2,A,골목상권,1000851,논현로1길,1592,1121,471
2019,2,A,골목상권,1000850,남부순환로339길,2908,1282,1626
2019,2,A,골목상권,1000849,남부순환로325길,1658,956,702
2019,2,A,골목상권,1000848,남부순환로317길,2256,1460,796
2019,2,A,골목상권,1000847,고무래로8길,5772,3607,2165
2019,2,A,골목상권,1000846,강남대로8길,2001,1329,672
2019,2,A,골목상권,1000845,강남대로34길,2194,1522,672
2019,2,A,골목상권,1000844,강남대로23길,2345,1776,569
2019,2,A,골목상권,1000843,소담길,15,4,11
2019,2,A,골목상권,1000842,원신길,39,15,24
2019,2,A,골목상권,1000841,양지길,10,2,8
2019,2,A,골목상권,1000840,양산길,7,2,5
2019,2,A,골목상권,1000839,호암로24길,1199,1059,140
2019,2,A,골목상권,1000838,호암로20길,207,89,118
2019,2,A,골목상권,1000837,행운길,575,450,125
2019,2,A,골목상권,1000836,행운1길,228,132,96
2019,2,A,골목상권,1000835,청림3길,152,49,103
2019,2,A,골목상권,1000834,청룡길,318,205,113
2019,2,A,골목상권,1000833,청룡8길,251,75,176
2019,2,A,골목상권,1000832,중앙길,85,24,61
2019,2,A,골목상권,1000831,조원중앙로2길,960,714,246
2019,2,A,골목상권,1000830,조원로18길,229,118,111
2019,2,A,골목상권,1000829,조원로10길,386,210,176
2019,2,A,골목상권,1000828,장군봉2길,210,130,80
2019,2,A,골목상권,1000827,장군봉1길,355,197,158
2019,2,A,골목상권,1000826,인헌길,108,63,45
2019,2,A,골목상권,1000825,은천로25길,62,33,29
2019,2,A,골목상권,1000824,양녕로6길,178,109,69
2019,2,A,골목상권,1000823,신원로3길,191,109,82
2019,2,A,골목상권,1000822,신사로20길,115,85,30
2019,2,A,골목상권,1000821,신림로65길,221,170,51
2019,2,A,골목상권,1000820,신림로64길,183,90,93
2019,2,A,골목상권,1000819,신림로48길,82,51,31
2019,2,A,골목상권,1000818,신림로38길,131,78,53
2019,2,A,골목상권,1000817,신림로28길,454,285,169
2019,2,A,골목상권,1000816,신림로11길,238,154,84
2019,2,A,골목상권,1000815,신림동길,695,410,285
2019,2,A,골목상권,1000814,승방길,520,404,116
2019,2,A,골목상권,1000813,서림7길,124,65,59
2019,2,A,골목상권,1000812,봉천로33길,188,119,69
2019,2,A,골목상권,1000811,봉천로13길,358,106,252
2019,2,A,골목상권,1000810,복은길,599,378,221
2019,2,A,골목상권,1000809,법원단지길,34,10,24
2019,2,A,골목상권,1000808,법원단지9길,172,110,62
2019,2,A,골목상권,1000807,미성5길,376,204,172
2019,2,A,골목상권,1000806,대학길,55,31,24
2019,2,A,골목상권,1000805,대학14길,70,23,47
2019,2,A,골목상권,1000804,당곡길,207,96,111
2019,2,A,골목상권,1000803,남현길,143,43,100
2019,2,A,골목상권,1000802,남현3길,466,315,151
2019,2,A,골목상권,1000801,남현2길,931,661,270
2019,2,A,골목상권,1000800,남부순환로248길,484,255,229
2019,2,A,골목상권,1000799,남부순환로234길,183,118,65
2019,2,A,골목상권,1000798,남부순환로172길,746,465,281
2019,2,A,골목상권,1000797,남부순환로161길,439,287,152
2019,2,A,골목상권,1000796,남부순환로151길,371,154,217
2019,2,A,골목상권,1000795,남부순환로142길,450,251,199
2019,2,A,골목상권,1000794,난향길,694,279,415
2019,2,A,골목상권,1000793,난우길,181,95,86
2019,2,A,골목상권,1000792,난곡로74길,2071,1671,400
2019,2,A,골목상권,1000791,난곡로34길,61,26,35
2019,2,A,골목상권,1000790,난곡로26길,108,77,31
2019,2,A,골목상권,1000789,난곡로24길,89,42,47
2019,2,A,골목상권,1000788,낙성대역길,493,282,211
2019,2,A,골목상권,1000787,국회단지길,3757,1162,2595
2019,2,A,골목상권,1000786,구암길,152,36,116
2019,2,A,골목상권,1000785,관천로22길,240,155,85
2019,2,A,골목상권,1000784,관천로15길,224,150,74
2019,2,A,골목상권,1000783,관악로30길,94,13,81
2019,2,A,골목상권,1000782,관악로28길,127,37,90
2019,2,A,골목상권,1000781,관악로14길,155,81,74
2019,2,A,골목상권,1000780,관악로10길,696,443,253
2019,2,A,골목상권,1000779,흑석로9길,85,49,36
2019,2,A,골목상권,1000778,흑석로13길,74,30,44
2019,2,A,골목상권,1000777,장승배기로27길,252,141,111
2019,2,A,골목상권,1000776,장승배기로19길,130,62,68
2019,2,A,골목상권,1000775,장승배기로10길,109,72,37
2019,2,A,골목상권,1000774,여의대방로46길,1202,739,463
2019,2,A,골목상권,1000773,여의대방로24길,15790,10229,5561
2019,2,A,골목상권,1000772,여의대방로22카길,183,139,44
2019,2,A,골목상권,1000771,여의대방로22나길,170,95,75
2019,2,A,골목상권,1000770,여의대방로22길,194,113,81
2019,2,A,골목상권,1000769,양녕로26길,92,54,38
2019,2,A,골목상권,1000768,신대방길,180,88,92
2019,2,A,골목상권,1000767,성대로29길,266,130,136
2019,2,A,골목상권,1000766,성대로1길,79,45,34
2019,2,A,골목상권,1000765,서달로8가길,107,45,62
2019,2,A,골목상권,1000764,서달로15길,56,20,36
2019,2,A,골목상권,1000763,서달로14길,21,9,12
2019,2,A,골목상권,1000762,서달로10길,68,40,28
2019,2,A,골목상권,1000761,상도로62길,425,265,160
2019,2,A,골목상권,1000760,상도로61길,214,88,126
2019,2,A,골목상권,1000759,상도로47길,450,200,250
2019,2,A,골목상권,1000758,상도로37길,59,26,33
2019,2,A,골목상권,1000757,상도로15길,368,150,218
2019,2,A,골목상권,1000756,사당로8길,127,62,65
2019,2,A,골목상권,1000755,사당로30길,329,184,145
2019,2,A,골목상권,1000754,사당로2차길,728,535,193
2019,2,A,골목상권,1000753,사당로29길,134,76,58
2019,2,A,골목상권,1000752,사당로26길,342,243,99
2019,2,A,골목상권,1000751,사당로23나길,32,20,12
2019,2,A,골목상권,1000750,사당로23길,7,6,1
2019,2,A,골목상권,1000749,사당로20길,112,61,51
2019,2,A,골목상권,1000748,사당로16길,77,38,39
2019,2,A,골목상권,1000747,사당로16가길,231,142,89
2019,2,A,골목상권,1000746,만양로8길,664,316,348
2019,2,A,골목상권,1000745,만양로14길,50,23,27
2019,2,A,골목상권,1000744,등용로14길,375,163,212
2019,2,A,골목상권,1000743,동작대로7길,284,148,136
2019,2,A,골목상권,1000742,동작대로35길,240,89,151
2019,2,A,골목상권,1000741,동작대로33길,216,109,107
2019,2,A,골목상권,1000740,동작대로29길,287,103,184
2019,2,A,골목상권,1000739,동작대로17길,819,434,385
2019,2,A,골목상권,1000738,대방동2길,348,182,166
2019,2,A,골목상권,1000737,대방동27길,533,246,287
2019,2,A,골목상권,1000736,노량진로6길,317,206,111
2019,2,A,골목상권,1000735,국사봉길,180,109,71
2019,2,A,골목상권,1000734,국사봉2길,99,60,39
2019,2,A,골목상권,1000733,국사봉1길,128,68,60
2019,2,A,골목상권,1000732,영신로9길,1423,811,612
2019,2,A,골목상권,1000731,영등포로84길,2014,690,1324
2019,2,A,골목상권,1000730,영등포로80길,159,86,73
2019,2,A,골목상권,1000729,영등포로62길,113,80,33
2019,2,A,골목상권,1000728,영등포로35길,270,137,133
2019,2,A,골목상권,1000727,영등포로27길,453,281,172
2019,2,A,골목상권,1000726,영등포로25길,1488,919,569
2019,2,A,골목상권,1000725,여의대방로61길,1117,767,350
2019,2,A,골목상권,1000724,여의대방로43나길,935,742,193
2019,2,A,골목상권,1000723,여의대방로39길,163,96,67
2019,2,A,골목상권,1000722,여의대방로35길,212,70,142
2019,2,A,골목상권,1000721,양평로28길,908,712,196
2019,2,A,골목상권,1000720,양평로22라길,663,352,311
2019,2,A,골목상권,1000719,양평로19길,1345,865,480
2019,2,A,골목상권,1000718,신길로60길,256,195,61
2019,2,A,골목상권,1000717,신길로42길,462,240,222
2019,2,A,골목상권,1000716,신길로42가길,220,99,121
2019,2,A,골목상권,1000715,신길로39길,68,40,28
2019,2,A,골목상권,1000714,신길로17길,722,301,421
2019,2,A,골목상권,1000713,선유서로28길,243,129,114
2019,2,A,골목상권,1000712,선유서로25길,1702,1311,391
2019,2,A,골목상권,1000711,선유서로24길,136,91,45
2019,2,A,골목상권,1000710,선유로55길,423,285,138
2019,2,A,골목상권,1000709,디지털로74길,11,7,4
2019,2,A,골목상권,1000708,디지털로57길,144,78,66
2019,2,A,골목상권,1000707,디지털로37길,165,46,119
2019,2,A,골목상권,1000706,도신로62길,183,145,38
2019,2,A,골목상권,1000705,도신로60길,83,49,34
2019,2,A,골목상권,1000704,도신로29길,114,52,62
2019,2,A,골목상권,1000703,도신로15길,483,288,195
2019,2,A,골목상권,1000702,도림천로21길,228,152,76
2019,2,A,골목상권,1000701,도림로63길,59,48,11
2019,2,A,골목상권,1000700,도림로147길,333,255,78
2019,2,A,골목상권,1000699,도림로112길,37,24,13
2019,2,A,골목상권,1000698,대림로8길,313,160,153
2019,2,A,골목상권,1000697,대림로7길,70,41,29
2019,2,A,골목상권,1000696,대림로44길,476,318,158
2019,2,A,골목상권,1000695,대림로34길,274,181,93
2019,2,A,골목상권,1000694,대림로31길,428,270,158
2019,2,A,골목상권,1000693,대림로29길,989,662,327
2019,2,A,골목상권,1000692,대림로22길,176,116,60
2019,2,A,골목상권,1000691,당산로46길,2538,1622,916
2019,2,A,골목상권,1000690,당산로38길,990,730,260
2019,2,A,골목상권,1000689,당산로37길,1015,731,284
2019,2,A,골목상권,1000688,당산로31길,1723,895,828
2019,2,A,골목상권,1000687,국회대로56길,3263,1592,1671
2019,2,A,골목상권,1000686,경인로90길,317,236,81
2019,2,A,골목상권,1000685,경인로80길,849,578,271
2019,2,A,골목상권,1000684,경인로77길,845,570,275
2019,2,A,골목상권,1000683,가마산로61길,53,37,16
2019,2,A,골목상권,1000682,시흥대로94길,429,147,282
2019,2,A,골목상권,1000681,시흥대로84길,192,114,78
2019,2,A,골목상권,1000680,시흥대로68길,557,213,344
2019,2,A,골목상권,1000679,시흥대로63길,1679,865,814
2019,2,A,골목상권,1000678,시흥대로62가길,130,83,47
2019,2,A,골목상권,1000677,시흥대로36길,571,405,166
2019,2,A,골목상권,1000676,시흥대로22길,233,119,114
2019,2,A,골목상권,1000675,시흥대로153길,100,63,37
2019,2,A,골목상권,1000674,시흥대로150길,354,227,127
2019,2,A,골목상권,1000673,시흥대로141길,316,217,99
2019,2,A,골목상권,1000672,시흥대로138길,358,270,88
2019,2,A,골목상권,1000671,시흥대로120길,175,115,60
2019,2,A,골목상권,1000670,벚꽃로56길,88,65,23
2019,2,A,골목상권,1000669,범안로17길,4343,2744,1599
2019,2,A,골목상권,1000668,범안로11길,1827,988,839
2019,2,A,골목상권,1000667,문성로5길,107,67,40
2019,2,A,골목상권,1000666,독산로85길,45,23,22
2019,2,A,골목상권,1000665,독산로78다길,504,343,161
2019,2,A,골목상권,1000664,독산로70길,79,26,53
2019,2,A,골목상권,1000663,독산로64길,320,275,45
2019,2,A,골목상권,1000662,독산로50길,25,6,19
2019,2,A,골목상권,1000661,독산로40길,208,74,134
2019,2,A,골목상권,1000660,독산로108길,1698,1523,175
2019,2,A,골목상권,1000659,남부순환로112길,84,49,35
2019,2,A,골목상권,1000658,금하로24길,176,103,73
2019,2,A,골목상권,1000657,금하로1길,200,149,51
2019,2,A,골목상권,1000656,금하로14길,102,66,36
2019,2,A,골목상권,1000655,가산로5길,371,243,128
2019,2,A,골목상권,1000654,가산로3길,1032,747,285
2019,2,A,골목상권,1000653,중앙로1길,937,692,245
2019,2,A,골목상권,1000652,중앙로15길,157,99,58
2019,2,A,골목상권,1000651,우마길,44,21,23
2019,2,A,골목상권,1000650,오류로8길,478,232,246
2019,2,A,골목상권,1000649,신도림로13길,129,85,44
2019,2,A,골목상권,1000648,새말로18길,437,293,144
2019,2,A,골목상권,1000647,부일로1길,665,618,47
2019,2,A,골목상권,1000646,부일로15길,200,128,72
2019,2,A,골목상권,1000645,부일로11길,244,97,147
2019,2,A,골목상권,1000644,디지털로32길,645,346,299
2019,2,A,골목상권,1000643,디지털로32가길,2779,1421,1358
2019,2,A,골목상권,1000642,디지털로27길,58,34,24
2019,2,A,골목상권,1000641,도림로6길,167,97,70
2019,2,A,골목상권,1000640,도림로12길,62,31,31
2019,2,A,골목상권,1000639,남부순환로97길,105,56,49
2019,2,A,골목상권,1000638,구로중앙로8길,125,60,65
2019,2,A,골목상권,1000637,구로중앙로7길,86,43,43
2019,2,A,골목상권,1000636,구로중앙로42길,511,370,141
2019,2,A,골목상권,1000635,구로중앙로34길,101,85,16
2019,2,A,골목상권,1000634,구로중앙로28길,594,335,259
2019,2,A,골목상권,1000633,구로중앙로19길,585,342,243
2019,2,A,골목상권,1000632,구로동로8길,387,177,210
2019,2,A,골목상권,1000631,구로동로7길,119,74,45
2019,2,A,골목상권,1000630,구로동로42길,143,77,66
2019,2,A,골목상권,1000629,구로동로41길,146,82,64
2019,2,A,골목상권,1000628,구로동로38길,386,162,224
2019,2,A,골목상권,1000627,구로동로28길,24,15,9
2019,2,A,골목상권,1000626,구로동로15길,108,58,50
2019,2,A,골목상권,1000625,공원로6가길,1447,1065,382
2019,2,A,골목상권,1000624,고척로52길,64,41,23
2019,2,A,골목상권,1000623,고척로27다길,181,111,70
2019,2,A,골목상권,1000622,고척로27길,325,192,133
2019,2,A,골목상권,1000621,고척로21나길,347,184,163
2019,2,A,골목상권,1000620,경인로47길,669,279,390
2019,2,A,골목상권,1000619,경인로35길,421,252,169
2019,2,A,골목상권,1000618,경인로31길,119,58,61
2019,2,A,골목상권,1000617,경인로15길,258,96,162
2019,2,A,골목상권,1000616,개봉로3길,331,156,175
2019,2,A,골목상권,1000615,개봉로2길,240,127,113
2019,2,A,골목상권,1000614,개봉로23가길,834,597,237
2019,2,A,골목상권,1000613,개봉로20길,3242,1499,1743
2019,2,A,골목상권,1000612,개봉로1길,179,124,55
2019,2,A,골목상권,1000611,개봉로17다길,2174,1501,673
2019,2,A,골목상권,1000610,개봉로17길,1349,442,907
2019,2,A,골목상권,1000609,개봉로11길,178,84,94
2019,2,A,골목상권,1000608,화곡로64길,938,587,351
2019,2,A,골목상권,1000607,화곡로59길,798,527,271
2019,2,A,골목상권,1000606,화곡로44나길,574,454,120
2019,2,A,골목상권,1000605,화곡로31길,575,335,240
2019,2,A,골목상권,1000604,화곡로20길,393,210,183
2019,2,A,골목상권,1000603,화곡로13길,478,348,130
2019,2,A,골목상권,1000602,초원로16길,283,122,161
2019,2,A,골목상권,1000601,초록마을로8길,130,65,65
2019,2,A,골목상권,1000600,초록마을로3길,471,367,104
2019,2,A,골목상권,1000599,월정로20길,126,24,102
2019,2,A,골목상권,1000598,우장산로6길,325,215,110
2019,2,A,골목상권,1000597,양천로73가길,474,363,111
2019,2,A,골목상권,1000596,양천로71길,1127,699,428
2019,2,A,골목상권,1000595,양천로49길,368,276,92
2019,2,A,골목상권,1000594,양천로26길,516,388,128
2019,2,A,골목상권,1000593,양천로24길,203,95,108
2019,2,A,골목상권,1000592,양천로24가길,161,106,55
2019,2,A,골목상권,1000591,양천로14길,312,176,136
2019,2,A,골목상권,1000590,방화대로6라길,706,451,255
2019,2,A,골목상권,1000589,방화대로21길,380,245,135
2019,2,A,골목상권,1000588,등촌로5길,1514,501,1013
2019,2,A,골목상권,1000587,등촌로55길,437,322,115
2019,2,A,골목상권,1000586,등촌로51길,292,160,132
2019,2,A,골목상권,1000585,등촌로39길,355,152,203
2019,2,A,골목상권,1000584,등촌로13길,234,174,60
2019,2,A,골목상권,1000583,남부순환로11길,309,217,92
2019,2,A,골목상권,1000582,까치산로4길,217,123,94
2019,2,A,골목상권,1000581,국회대로7길,226,112,114
2019,2,A,골목상권,1000580,공항대로8길,276,190,86
2019,2,A,골목상권,1000579,공항대로61길,498,387,111
2019,2,A,골목상권,1000578,공항대로59다길,1046,654,392
2019,2,A,골목상권,1000577,공항대로59길,839,584,255
2019,2,A,골목상권,1000576,공항대로55길,741,448,293
2019,2,A,골목상권,1000575,공항대로42길,477,302,175
2019,2,A,골목상권,1000574,공항대로38길,128,91,37
2019,2,A,골목상권,1000573,곰달래로60길,226,147,79
2019,2,A,골목상권,1000572,곰달래로53길,147,94,53
2019,2,A,골목상권,1000571,곰달래로47길,275,174,101
2019,2,A,골목상권,1000570,곰달래로31길,134,82,52
2019,2,A,골목상권,1000569,곰달래로25길,196,124,72
2019,2,A,골목상권,1000568,개화동로25길,259,181,78
2019,2,A,골목상권,1000567,개화동로23길,930,654,276
2019,2,A,골목상권,1000566,강서로8길,211,130,81
2019,2,A,골목상권,1000565,강서로5라길,299,200,99
2019,2,A,골목상권,1000564,강서로5나길,378,232,146
2019,2,A,골목상권,1000563,강서로5가길,216,119,97
2019,2,A,골목상권,1000562,강서로47라길,192,146,46
2019,2,A,골목상권,1000561,강서로47길,310,131,179
2019,2,A,골목상권,1000560,강서로45다길,167,110,57
2019,2,A,골목상권,1000559,강서로45길,82,32,50
2019,2,A,골목상권,1000558,강서로35길,324,160,164
2019,2,A,골목상권,1000557,강서로29길,392,223,169
2019,2,A,골목상권,1000556,강서로18길,690,539,151
2019,2,A,골목상권,1000555,강서로17가길,562,397,165
2019,2,A,골목상권,1000554,강서로15길,256,165,91
2019,2,A,골목상권,1000553,가로공원로80길,382,190,192
2019,2,A,골목상권,1000552,가로공원로76가길,212,117,95
2019,2,A,골목상권,1000551,화곡로4길,248,180,68
2019,2,A,골목상권,1000550,화곡로3길,264,141,123
2019,2,A,골목상권,1000549,지양로7길,221,110,111
2019,2,A,골목상권,1000548,중앙로55길,358,218,140
2019,2,A,골목상권,1000547,중앙로51길,474,315,159
2019,2,A,골목상권,1000546,중앙로47길,79,39,40
2019,2,A,골목상권,1000545,중앙로45길,1410,1336,74
2019,2,A,골목상권,1000544,중앙로36길,74,37,37
2019,2,A,골목상권,1000543,중앙로32길,161,102,59
2019,2,A,골목상권,1000542,중앙로25길,118,79,39
2019,2,A,골목상권,1000541,은행정로7길,448,180,268
2019,2,A,골목상권,1000540,은행정로5길,171,62,109
2019,2,A,골목상권,1000539,오목로5길,112,76,36
2019,2,A,골목상권,1000538,오목로3길,208,145,63
2019,2,A,골목상권,1000537,오목로30길,230,130,100
2019,2,A,골목상권,1000536,오목로23길,492,171,321
2019,2,A,골목상권,1000535,신월로20길,53,31,22
2019,2,A,골목상권,1000534,신월로15길,311,152,159
2019,2,A,골목상권,1000533,신목로6길,399,277,122
2019,2,A,골목상권,1000532,신목로5길,578,347,231
2019,2,A,골목상권,1000531,신목로2길,339,226,113
2019,2,A,골목상권,1000530,목동중앙서로8가길,351,206,145
2019,2,A,골목상권,1000529,목동중앙서로7길,121,80,41
2019,2,A,골목상권,1000528,목동중앙북로8길,183,111,72
2019,2,A,골목상권,1000527,목동중앙북로16길,453,194,259
2019,2,A,골목상권,1000526,목동중앙본로7길,169,70,99
2019,2,A,골목상권,1000525,목동중앙로3길,121,73,48
2019,2,A,골목상권,1000524,목동중앙로13나길,287,177,110
2019,2,A,골목상권,1000523,목동중앙남로3가길,165,102,63
2019,2,A,골목상권,1000522,목동로9길,739,457,282
2019,2,A,골목상권,1000521,목동로19길,381,208,173
2019,2,A,골목상권,1000520,목동동로8길,190,110,80
2019,2,A,골목상권,1000519,목동동로12길,389,228,161
2019,2,A,골목상권,1000518,목동남로4길,886,575,311
2019,2,A,골목상권,1000517,남부순환로88길,965,681,284
2019,2,A,골목상권,1000516,남부순환로79길,185,77,108
2019,2,A,골목상권,1000515,남부순환로70길,253,138,115
2019,2,A,골목상권,1000514,남부순환로58길,247,152,95
2019,2,A,골목상권,1000513,남부순환로40길,152,69,83
2019,2,A,골목상권,1000512,남부순환로33길,171,109,62
2019,2,A,골목상권,1000511,곰달래로5길,442,180,262
2019,2,A,골목상권,1000510,곰달래로3길,312,201,111
2019,2,A,골목상권,1000509,곰달래로2길,571,321,250
2019,2,A,골목상권,1000508,곰달래로10길,586,475,111
2019,2,A,골목상권,1000507,가로공원로58길,113,65,48
2019,2,A,골목상권,1000506,효창원로93길,811,463,348
2019,2,A,골목상권,1000505,토정로37길,291,143,148
2019,2,A,골목상권,1000504,월드컵로8길,1502,712,790
2019,2,A,골목상권,1000503,월드컵로7길,739,286,453
2019,2,A,골목상권,1000502,월드컵로36길,503,334,169
2019,2,A,골목상권,1000501,월드컵로25길,307,119,188
2019,2,A,골목상권,1000500,월드컵로19길,270,185,85
2019,2,A,골목상권,1000499,월드컵로16길,1290,882,408
2019,2,A,골목상권,1000498,월드컵로11길,408,138,270
2019,2,A,골목상권,1000497,월드컵로10길,1245,730,515
2019,2,A,골목상권,1000496,와우산로3길,269,178,91
2019,2,A,골목상권,1000495,와우산로29길,132,75,57
2019,2,A,골목상권,1000494,와우산로29가길,884,601,283
2019,2,A,골목상권,1000493,양화진길,735,445,290
2019,2,A,골목상권,1000492,양화로1길,676,339,337
2019,2,A,골목상권,1000491,양화로11길,2245,883,1362
2019,2,A,골목상권,1000490,신촌로30길,91,49,42
2019,2,A,골목상권,1000489,신촌로28가길,91,27,64
2019,2,A,골목상권,1000488,신촌로12길,276,150,126
2019,2,A,골목상권,1000487,숭문길,2192,1610,582
2019,2,A,골목상권,1000486,숭문8길,127,72,55
2019,2,A,골목상권,1000485,성지3길,323,224,99
2019,2,A,골목상권,1000484,성산로4길,1260,726,534
2019,2,A,골목상권,1000483,성미산로32길,180,106,74
2019,2,A,골목상권,1000482,성미산로1길,4503,3329,1174
2019,2,A,골목상권,1000481,성미산로11길,1167,798,369
2019,2,A,골목상권,1000480,백범로16길,1781,1234,547
2019,2,A,골목상권,1000479,방울내로9안길,652,389,263
2019,2,A,골목상권,1000478,모래내로7길,111,83,28
2019,2,A,골목상권,1000477,매봉산로2길,380,207,173
2019,2,A,골목상권,1000476,망원로2길,339,221,118
2019,2,A,골목상권,1000475,망원로11길,147,84,63
2019,2,A,골목상권,1000474,만리재옛길,1540,724,816
2019,2,A,골목상권,1000473,마포대로4길,1567,1015,552
2019,2,A,골목상권,1000472,마포대로20길,680,364,316
2019,2,A,골목상권,1000471,마포대로12길,76,32,44
2019,2,A,골목상권,1000470,동교로38길,622,255,367
2019,2,A,골목상권,1000469,동교로27길,1193,731,462
2019,2,A,골목상권,1000468,동교로25길,1133,701,432
2019,2,A,골목상권,1000467,동교로19길,1139,729,410
2019,2,A,골목상권,1000466,동교로17길,459,264,195
2019,2,A,골목상권,1000465,독막로8길,575,372,203
2019,2,A,골목상권,1000464,독막로32길,416,211,205
2019,2,A,골목상권,1000463,독막로22길,100,67,33
2019,2,A,골목상권,1000462,도화길,57,27,30
2019,2,A,골목상권,1000461,도화4길,687,298,389
2019,2,A,골목상권,1000460,대흥로28길,97,50,47
2019,2,A,골목상권,1000459,대흥로21길,363,205,158
2019,2,A,골목상권,1000458,광성로6길,344,200,144
2019,2,A,골목상권,1000457,홍제내길,280,131,149
2019,2,A,골목상권,1000456,홍연길,79,49,30
2019,2,A,골목상권,1000455,통일로39길,53,24,29
2019,2,A,골목상권,1000454,통일로37길,722,448,274
2019,2,A,골목상권,1000453,통일로11길,76,30,46
2019,2,A,골목상권,1000452,충정로6길,3745,2262,1483
2019,2,A,골목상권,1000451,충정로4길,2596,1459,1137
2019,2,A,골목상권,1000450,증가로6길,375,305,70
2019,2,A,골목상권,1000449,증가로23나길,869,405,464
2019,2,A,골목상권,1000448,증가로20가길,280,111,169
2019,2,A,골목상권,1000447,증가로10길,136,78,58
2019,2,A,골목상권,1000446,응암로1길,652,405,247
2019,2,A,골목상권,1000445,연희로10길,3486,3183,303
2019,2,A,골목상권,1000444,신촌로37길,36,16,20
2019,2,A,골목상권,1000443,수색로8길,2502,2197,305
2019,2,A,골목상권,1000442,세무서길,449,174,275
2019,2,A,골목상권,1000441,세무서2길,185,92,93
2019,2,A,골목상권,1000440,세검정로1길,179,40,139
2019,2,A,골목상권,1000439,북아현로4길,212,96,116
2019,2,A,골목상권,1000438,모래내로15길,137,31,106
2019,2,A,골목상권,1000437,명지대길,312,209,103
2019,2,A,골목상권,1000436,독립문로8길,734,453,281
2019,2,A,골목상권,1000435,가재울로6길,135,78,57
2019,2,A,골목상권,1000434,통일로92길,184,79,105
2019,2,A,골목상권,1000433,통일로87길,308,158,150
2019,2,A,골목상권,1000432,통일로78길,154,49,105
2019,2,A,골목상권,1000431,통일로69길,112,43,69
2019,2,A,골목상권,1000430,진흥로1길,319,179,140
2019,2,A,골목상권,1000429,진흥로12길,379,186,193
2019,2,A,골목상권,1000428,증산서길,264,170,94
2019,2,A,골목상권,1000427,증산로9길,665,578,87
2019,2,A,골목상권,1000426,증산로5길,469,262,207
2019,2,A,골목상권,1000425,증산로21길,270,131,139
2019,2,A,골목상권,1000424,증산로17길,164,101,63
2019,2,A,골목상권,1000423,증산로15길,427,323,104
2019,2,A,골목상권,1000422,증산로13길,89,48,41
2019,2,A,골목상권,1000421,응암로34길,225,119,106
2019,2,A,골목상권,1000420,응암로22길,126,62,64
2019,2,A,골목상권,1000419,응암로14길,92,56,36
2019,2,A,골목상권,1000418,응암로13길,129,30,99
2019,2,A,골목상권,1000417,응암로12길,63,38,25
2019,2,A,골목상권,1000416,은평로8길,265,176,89
2019,2,A,골목상권,1000415,은평로3길,290,131,159
2019,2,A,골목상권,1000414,은평로20길,48,9,39
2019,2,A,골목상권,1000413,은평로13길,661,309,352
2019,2,A,골목상권,1000412,은평로10길,305,178,127
2019,2,A,골목상권,1000411,연서로5길,583,226,357
2019,2,A,골목상권,1000410,연서로41길,114,42,72
2019,2,A,골목상권,1000409,연서로3길,153,65,88
2019,2,A,골목상권,1000408,연서로34길,1175,602,573
2019,2,A,골목상권,1000407,연서로33길,111,49,62
2019,2,A,골목상권,1000406,연서로29길,96,64,32
2019,2,A,골목상권,1000405,연서로28길,271,146,125
2019,2,A,골목상권,1000404,연서로27길,404,187,217
2019,2,A,골목상권,1000403,연서로21길,249,151,98
2019,2,A,골목상권,1000402,연서로17길,623,157,466
2019,2,A,골목상권,1000401,연서로16길,316,187,129
2019,2,A,골목상권,1000400,연서로13길,388,274,114
2019,2,A,골목상권,1000399,연서로11길,614,256,358
2019,2,A,골목상권,1000398,역말로9길,195,101,94
2019,2,A,골목상권,1000397,수색로18길,146,100,46
2019,2,A,골목상권,1000396,서오릉로8길,152,98,54
2019,2,A,골목상권,1000395,서오릉로21길,130,40,90
2019,2,A,골목상권,1000394,불광천길,197,99,98
2019,2,A,골목상권,1000393,갈현로7길,285,154,131
2019,2,A,골목상권,1000392,갈현로41길,155,59,96
2019,2,A,골목상권,1000391,갈현로33길,272,159,113
2019,2,A,골목상권,1000390,갈현로1길,93,44,49
2019,2,A,골목상권,1000389,가좌로7길,429,223,206
2019,2,A,골목상권,1000388,한글비석로44길,235,91,144
2019,2,A,골목상권,1000387,한글비석로24길,197,76,121
2019,2,A,골목상권,1000386,한글비석로22길,156,73,83
2019,2,A,골목상권,1000385,석계로1길,619,268,351
2019,2,A,골목상권,1000384,상계로9가길,288,106,182
2019,2,A,골목상권,1000383,상계로1길,280,189,91
2019,2,A,골목상권,1000382,상계로12길,143,88,55
2019,2,A,골목상권,1000381,동일로242길,557,352,205
2019,2,A,골목상권,1000380,동일로192길,390,283,107
2019,2,A,골목상권,1000379,동일로173가길,1133,839,294
2019,2,A,골목상권,1000378,공릉로58길,118,55,63
2019,2,A,골목상권,1000377,해등로16길,98,56,42
2019,2,A,골목상권,1000376,우이천로4다길,101,69,32
2019,2,A,골목상권,1000375,우이천로32길,193,70,123
2019,2,A,골목상권,1000374,시루봉로23길,309,177,132
2019,2,A,골목상권,1000373,삼양로144길,51,23,28
2019,2,A,골목상권,1000372,방학로6가길,178,87,91
2019,2,A,골목상권,1000371,방학로5길,206,114,92
2019,2,A,골목상권,1000370,방학로15길,613,413,200
2019,2,A,골목상권,1000369,방학로10길,79,49,30
2019,2,A,골목상권,1000368,도봉산길,1194,445,749
2019,2,A,골목상권,1000367,도봉산4길,27,24,3
2019,2,A,골목상권,1000366,도봉로181길,108,36,72
2019,2,A,골목상권,1000365,도봉로169나길,268,194,74
2019,2,A,골목상권,1000364,도봉로156길,66,38,28
2019,2,A,골목상권,1000363,도봉로152가길,376,337,39
2019,2,A,골목상권,1000362,도봉로147길,190,88,102
2019,2,A,골목상권,1000361,도봉로143길,118,83,35
2019,2,A,골목상권,1000360,도봉로114길,421,178,243
2019,2,A,골목상권,1000359,도봉로109길,212,159,53
2019,2,A,골목상권,1000358,도당로29길,188,98,90
2019,2,A,골목상권,1000357,도당로19길,116,52,64
2019,2,A,골목상권,1000356,도당로13바길,89,45,44
2019,2,A,골목상권,1000355,도당로13가길,39,23,16
2019,2,A,골목상권,1000354,덕릉로60길,160,115,45
2019,2,A,골목상권,1000353,노해로63다길,34,13,21
2019,2,A,골목상권,1000352,노해로60길,184,99,85
2019,2,A,골목상권,1000351,한천로140길,37,24,13
2019,2,A,골목상권,1000350,한천로139가길,112,41,71
2019,2,A,골목상권,1000349,한천로132길,76,43,33
2019,2,A,골목상권,1000348,한천로130길,74,55,19
2019,2,A,골목상권,1000347,한천로124나길,36,18,18
2019,2,A,골목상권,1000346,한천로109길,549,347,202
2019,2,A,골목상권,1000345,인수봉로79길,226,155,71
2019,2,A,골목상권,1000344,인수봉로72길,67,25,42
2019,2,A,골목상권,1000343,인수봉로56길,35,22,13
2019,2,A,골목상권,1000342,오패산로67길,307,111,196
2019,2,A,골목상권,1000341,오패산로52길,120,53,67
2019,2,A,골목상권,1000340,오패산로30길,41,26,15
2019,2,A,골목상권,1000339,수유로12길,190,119,71
2019,2,A,골목상권,1000338,솔샘로65길,353,99,254
2019,2,A,골목상권,1000337,솔매로50길,314,93,221
2019,2,A,골목상권,1000336,솔매로45길,44,15,29
2019,2,A,골목상권,1000335,솔매로41길,91,53,38
2019,2,A,골목상권,1000334,삼양로93길,210,92,118
2019,2,A,골목상권,1000333,삼양로77길,158,67,91
2019,2,A,골목상권,1000332,삼양로54길,317,73,244
2019,2,A,골목상권,1000331,삼양로41길,324,256,68
2019,2,A,골목상권,1000330,삼양로27길,12,5,7
2019,2,A,골목상권,1000329,삼양로24길,32,19,13
2019,2,A,골목상권,1000328,삼양로20길,210,186,24
2019,2,A,골목상권,1000327,삼각산로28길,98,43,55
2019,2,A,골목상권,1000326,도봉로99길,227,135,92
2019,2,A,골목상권,1000325,도봉로8길,8,6,2
2019,2,A,골목상권,1000324,도봉로76길,325,151,174
2019,2,A,골목상권,1000323,도봉로67길,124,65,59
2019,2,A,골목상권,1000322,도봉로45길,109,55,54
2019,2,A,골목상권,1000321,도봉로18길,202,156,46
2019,2,A,골목상권,1000320,도봉로13길,16,14,2
2019,2,A,골목상권,1000319,덕릉로41길,171,89,82
2019,2,A,골목상권,1000318,덕릉로40길,159,89,70
2019,2,A,골목상권,1000317,노해로33길,104,40,64
2019,2,A,골목상권,1000316,노해로23길,87,48,39
2019,2,A,골목상권,1000315,노해로17길,103,50,53
2019,2,A,골목상권,1000314,화랑로40길,86,53,33
2019,2,A,골목상권,1000313,화랑로32길,359,266,93
2019,2,A,골목상권,1000312,화랑로1길,943,668,275
2019,2,A,골목상권,1000311,화랑로19길,57,25,32
2019,2,A,골목상권,1000310,화랑로14길,141,96,45
2019,2,A,골목상권,1000309,화랑로13길,196,85,111
2019,2,A,골목상권,1000308,한천로76길,345,284,61
2019,2,A,골목상권,1000307,한천로101가길,8,4,4
2019,2,A,골목상권,1000306,창경궁로43길,576,353,223
2019,2,A,골목상권,1000305,지봉로20길,3833,3171,662
2019,2,A,골목상권,1000304,종암로5길,411,209,202
2019,2,A,골목상권,1000303,종암로24가길,75,18,57
2019,2,A,골목상권,1000302,종암로21길,558,351,207
2019,2,A,골목상권,1000301,종암로19길,2396,1433,963
2019,2,A,골목상권,1000300,종암로16길,175,69,106
2019,2,A,골목상권,1000299,정릉로8길,1372,1139,233
2019,2,A,골목상권,1000298,정릉로27길,114,51,63
2019,2,A,골목상권,1000297,정릉로26길,277,137,140
2019,2,A,골목상권,1000296,장위로50길,397,188,209
2019,2,A,골목상권,1000295,장월로1길,78,16,62
2019,2,A,골목상권,1000294,인촌로6길,222,156,66
2019,2,A,골목상권,1000293,인촌로5길,72,36,36
2019,2,A,골목상권,1000292,인촌로24길,1559,1001,558
2019,2,A,골목상권,1000291,개운사길,190,100,90
2019,2,A,골목상권,1000290,인촌로1길,188,88,100
2019,2,A,골목상권,1000289,인촌로17가길,116,70,46
2019,2,A,골목상권,1000288,오패산로4길,662,406,256
2019,2,A,골목상권,1000287,오패산로3길,600,364,236
2019,2,A,골목상권,1000286,오패산로19길,122,52,70
2019,2,A,골목상권,1000285,안암로5길,579,427,152
2019,2,A,골목상권,1000284,아리랑로4길,489,221,268
2019,2,A,골목상권,1000283,솔샘로6길,61,45,16
2019,2,A,골목상권,1000282,성북로8길,212,119,93
2019,2,A,골목상권,1000281,삼양로8길,184,88,96
2019,2,A,골목상권,1000280,삼선교로16가길,110,59,51
2019,2,A,골목상권,1000279,삼선교로10다길,35,14,21
2019,2,A,골목상권,1000278,삼선교로10길,182,104,78
2019,2,A,골목상권,1000277,보문로32길,300,142,158
2019,2,A,골목상권,1000276,보문로31길,318,191,127
2019,2,A,골목상권,1000275,보문로26길,109,47,62
2019,2,A,골목상권,1000274,보문로13길,1236,766,470
2019,2,A,골목상권,1000273,보국문로16길,228,128,100
2019,2,A,골목상권,1000272,동소문로6길,46,21,25
2019,2,A,골목상권,1000271,동소문로2길,73,25,48
2019,2,A,골목상권,1000270,동소문로26가길,305,140,165
2019,2,A,골목상권,1000269,동소문로15길,204,142,62
2019,2,A,골목상권,1000268,동소문로13길,603,289,314
2019,2,A,골목상권,1000267,돌곶이로8길,96,61,35
2019,2,A,골목상권,1000266,돌곶이로41길,55,20,35
2019,2,A,골목상권,1000265,돌곶이로28길,247,127,120
2019,2,A,골목상권,1000264,돌곶이로27길,147,96,51
2019,2,A,골목상권,1000263,돌곶이로22길,74,41,33
2019,2,A,골목상권,1000262,돌곶이로14길,51,34,17
2019,2,A,골목상권,1000261,길음로7길,15,6,9
2019,2,A,골목상권,1000260,중랑천로10길,235,116,119
2019,2,A,골목상권,1000259,용마산로94길,91,63,28
2019,2,A,골목상권,1000258,용마산로118길,173,107,66
2019,2,A,골목상권,1000257,용마산로112길,115,62,53
2019,2,A,골목상권,1000256,용마산로100길,135,54,81
2019,2,A,골목상권,1000255,신내로7가길,280,114,166
2019,2,A,골목상권,1000254,사가정로54길,94,35,59
2019,2,A,골목상권,1000253,사가정로42길,223,84,139
2019,2,A,골목상권,1000252,봉화산로56길,601,309,292
2019,2,A,골목상권,1000251,봉화산로4길,129,42,87
2019,2,A,골목상권,1000250,봉화산로30길,150,33,117
2019,2,A,골목상권,1000249,봉우재로33길,142,52,90
2019,2,A,골목상권,1000248,면목로78길,108,52,56
2019,2,A,골목상권,1000247,면목로56길,141,63,78
2019,2,A,골목상권,1000246,면목로55길,473,308,165
2019,2,A,골목상권,1000245,면목로49길,116,70,46
2019,2,A,골목상권,1000244,면목로48길,842,541,301
2019,2,A,골목상권,1000243,면목로45길,170,95,75
2019,2,A,골목상권,1000242,면목로33길,37,22,15
2019,2,A,골목상권,1000241,면목로21길,37,24,13
2019,2,A,골목상권,1000240,망우로73길,39,28,11
2019,2,A,골목상권,1000239,망우로68길,183,92,91
2019,2,A,골목상권,1000238,동일로163길,137,88,49
2019,2,A,골목상권,1000237,동일로157길,504,286,218
2019,2,A,골목상권,1000236,동일로149길,853,741,112
2019,2,A,골목상권,1000235,동일로140길,321,175,146
2019,2,A,골목상권,1000234,동일로139길,92,61,31
2019,2,A,골목상권,1000233,동일로139가길,215,99,116
2019,2,A,골목상권,1000232,동일로130길,167,121,46
2019,2,A,골목상권,1000231,동일로123길,153,83,70
2019,2,A,골목상권,1000230,동일로112길,318,172,146
2019,2,A,골목상권,1000229,동일로101길,120,50,70
2019,2,A,골목상권,1000228,동일로100길,331,252,79
2019,2,A,골목상권,1000227,답십리로75길,59,32,27
2019,2,A,골목상권,1000226,공릉로2길,398,236,162
2019,2,A,골목상권,1000225,공릉로12가길,139,75,64
2019,2,A,골목상권,1000224,겸재로54길,113,67,46
2019,2,A,골목상권,1000223,겸재로36길,171,72,99
2019,2,A,골목상권,1000222,겸재로29길,160,91,69
2019,2,A,골목상권,1000221,휘경로3길,135,64,71
2019,2,A,골목상권,1000220,휘경로2길,95,47,48
2019,2,A,골목상권,1000219,휘경로23길,181,136,45
2019,2,A,골목상권,1000218,휘경로14길,119,47,72
2019,2,A,골목상권,1000217,한천로46길,240,97,143
2019,2,A,골목상권,1000216,한천로40길,101,66,35
2019,2,A,골목상권,1000215,한천로33길,208,74,134
2019,2,A,골목상권,1000214,한천로14길,781,497,284
2019,2,A,골목상권,1000213,천호대로97길,527,429,98
2019,2,A,골목상권,1000212,천호대로77길,207,132,75
2019,2,A,골목상권,1000211,천호대로45길,61,47,14
2019,2,A,골목상권,1000210,천호대로17길,2981,2142,839
2019,2,A,골목상권,1000209,천호대로12길,96,53,43
2019,2,A,골목상권,1000208,천장산로7길,82,34,48
2019,2,A,골목상권,1000207,제기로5길,63,51,12
2019,2,A,골목상권,1000206,제기로21길,93,53,40
2019,2,A,골목상권,1000205,전농로4길,356,277,79
2019,2,A,골목상권,1000204,전농로3길,184,131,53
2019,2,A,골목상권,1000203,전농로29길,557,400,157
2019,2,A,골목상권,1000202,장한로8길,394,240,154
2019,2,A,골목상권,1000201,장한로5길,419,227,192
2019,2,A,골목상권,1000200,장한로27길,221,120,101
2019,2,A,골목상권,1000199,장한로27가길,190,93,97
2019,2,A,골목상권,1000198,장한로26길,2391,1660,731
2019,2,A,골목상권,1000197,장한로26가길,290,169,121
2019,2,A,골목상권,1000196,장한로25길,314,217,97
2019,2,A,골목상권,1000195,장한로14길,204,127,77
2019,2,A,골목상권,1000194,이문로42길,62,39,23
2019,2,A,골목상권,1000193,왕산로43길,581,225,356
2019,2,A,골목상권,1000192,왕산로33길,78,33,45
2019,2,A,골목상권,1000191,왕산로32길,51,28,23
2019,2,A,골목상권,1000190,약령시로17길,106,73,33
2019,2,A,골목상권,1000189,서울시립대로4길,380,244,136
2019,2,A,골목상권,1000188,서울시립대로29길,431,311,120
2019,2,A,골목상권,1000187,서울시립대로16길,20,9,11
2019,2,A,골목상권,1000186,사가정로2길,283,192,91
2019,2,A,골목상권,1000185,사가정로23가길,109,47,62
2019,2,A,골목상권,1000184,사가정로13길,206,72,134
2019,2,A,골목상권,1000183,무학로45길,296,172,124
2019,2,A,골목상권,1000182,무학로16길,700,430,270
2019,2,A,골목상권,1000181,망우로21길,131,89,42
2019,2,A,골목상권,1000180,망우로18길,232,79,153
2019,2,A,골목상권,1000179,망우로18가길,101,72,29
2019,2,A,골목상권,1000178,답십리로72길,95,36,59
2019,2,A,골목상권,1000177,답십리로69길,487,280,207
2019,2,A,골목상권,1000176,답십리로68길,429,199,230
2019,2,A,골목상권,1000175,답십리로64길,137,88,49
2019,2,A,골목상권,1000174,답십리로63길,1756,1034,722
2019,2,A,골목상권,1000173,답십리로60길,354,216,138
2019,2,A,골목상권,1000172,답십리로56길,90,47,43
2019,2,A,골목상권,1000171,답십리로23길,57,32,25
2019,2,A,골목상권,1000170,난계로30길,5259,2277,2982
2019,2,A,골목상권,1000169,경희대로4길,36,12,24
2019,2,A,골목상권,1000168,경희대로3길,20,9,11
2019,2,A,골목상권,1000167,천호대로129길,376,233,143
2019,2,A,골목상권,1000166,천호대로123길,566,273,293
2019,2,A,골목상권,1000165,천호대로109길,1000,525,475
2019,2,A,골목상권,1000164,자양번영로3길,254,148,106
2019,2,A,골목상권,1000163,자양로53길,222,137,85
2019,2,A,골목상권,1000162,자양로50길,246,143,103
2019,2,A,골목상권,1000161,자양로45길,449,177,272
2019,2,A,골목상권,1000160,자양로26길,173,97,76
2019,2,A,골목상권,1000159,자양로15길,81,42,39
2019,2,A,골목상권,1000158,자양로11길,705,274,431
2019,2,A,골목상권,1000157,용마산로3길,564,432,132
2019,2,A,골목상권,1000156,용마산로21길,364,223,141
2019,2,A,골목상권,1000155,아차산로78길,660,474,186
2019,2,A,골목상권,1000154,아차산로65길,525,358,167
2019,2,A,골목상권,1000153,아차산로55길,322,204,118
2019,2,A,골목상권,1000152,아차산로51길,475,130,345
2019,2,A,골목상권,1000151,아차산로40길,465,253,212
2019,2,A,골목상권,1000150,면목로17길,194,104,90
2019,2,A,골목상권,1000149,뚝섬로64길,306,169,137
2019,2,A,골목상권,1000148,뚝섬로58길,389,185,204
2019,2,A,골목상권,1000147,뚝섬로54길,981,835,146
2019,2,A,골목상권,1000146,뚝섬로48길,243,144,99
2019,2,A,골목상권,1000145,뚝섬로24길,119,74,45
2019,2,A,골목상권,1000144,뚝섬로23길,219,155,64
2019,2,A,골목상권,1000143,동일로24길,62,50,12
2019,2,A,골목상권,1000142,동일로18길,116,58,58
2019,2,A,골목상권,1000141,능동로4길,963,843,120
2019,2,A,골목상권,1000140,능동로3길,70,45,25
2019,2,A,골목상권,1000139,능동로34길,1054,699,355
2019,2,A,골목상권,1000138,능동로19길,170,99,71
2019,2,A,골목상권,1000137,능동로13길,233,114,119
2019,2,A,골목상권,1000136,긴고랑로9길,79,25,54
2019,2,A,골목상권,1000135,긴고랑로8길,954,608,346
2019,2,A,골목상권,1000134,긴고랑로7길,563,443,120
2019,2,A,골목상권,1000133,긴고랑로20길,242,121,121
2019,2,A,골목상권,1000132,광나루로52길,656,440,216
2019,2,A,골목상권,1000131,광나루로40길,305,185,120
2019,2,A,골목상권,1000130,광나루로37길,72,31,41
2019,2,A,골목상권,1000129,광나루로36길,428,176,252
2019,2,A,골목상권,1000128,광나루로24길,32,21,11
2019,2,A,골목상권,1000127,광나루로12길,55,18,37
2019,2,A,골목상권,1000126,한림말길,348,165,183
2019,2,A,골목상권,1000125,한림말3길,2979,1079,1900
2019,2,A,골목상권,1000124,청계천로10나길,972,621,351
2019,2,A,골목상권,1000123,장터길,118,56,62
2019,2,A,골목상권,1000122,용답중앙길,344,121,223
2019,2,A,골목상권,1000121,용답29길,548,346,202
2019,2,A,골목상권,1000120,왕십리로6길,753,483,270
2019,2,A,골목상권,1000119,왕십리로31길,243,104,139
2019,2,A,골목상권,1000118,왕십리로26길,1414,738,676
2019,2,A,골목상권,1000117,왕십리로21길,132,62,70
2019,2,A,골목상권,1000116,왕십리로14길,1050,758,292
2019,2,A,골목상권,1000115,아차산로5길,1961,1073,888
2019,2,A,골목상권,1000114,아차산로15길,3698,2616,1082
2019,2,A,골목상권,1000113,아차산로11길,3847,2751,1096
2019,2,A,골목상권,1000112,송정4가길,443,269,174
2019,2,A,골목상권,1000111,송정12라길,127,44,83
2019,2,A,골목상권,1000110,성수일로6길,1732,1101,631
2019,2,A,골목상권,1000109,성수이로7길,1947,1198,749
2019,2,A,골목상권,1000108,성수이로18길,3060,2001,1059
2019,2,A,골목상권,1000107,성덕정길,266,180,86
2019,2,A,골목상권,1000106,성덕정17길,452,287,165
2019,2,A,골목상권,1000105,서울숲2길,447,274,173
2019,2,A,골목상권,1000104,상원길,2490,1650,840
2019,2,A,골목상권,1000103,상원12길,339,197,142
2019,2,A,골목상권,1000102,사근동길,107,57,50
2019,2,A,골목상권,1000101,무학봉길,45,22,23
2019,2,A,골목상권,1000100,무학봉28길,202,89,113
2019,2,A,골목상권,1000099,무학로6길,771,332,439
2019,2,A,골목상권,1000098,무수막길,200,148,52
2019,2,A,골목상권,1000097,매봉길,67,39,28
2019,2,A,골목상권,1000096,마조로1길,79,53,26
2019,2,A,골목상권,1000095,마조로16길,168,103,65
2019,2,A,골목상권,1000094,마장로39길,477,278,199
2019,2,A,골목상권,1000093,마장로27길,213,109,104
2019,2,A,골목상권,1000092,뚝섬로5길,1930,1347,583
2019,2,A,골목상권,1000091,둘레9길,450,282,168
2019,2,A,골목상권,1000090,금호산길,167,88,79
2019,2,A,골목상권,1000089,금호산2길,89,66,23
2019,2,A,골목상권,1000088,고산자로6길,7561,2336,5225
2019,2,A,골목상권,1000087,후암로28길,600,312,288
2019,2,A,골목상권,1000086,효창원로39길,181,104,77
2019,2,A,골목상권,1000085,회나무로13길,1739,704,1035
2019,2,A,골목상권,1000084,한남대로20길,460,247,213
2019,2,A,골목상권,1000083,한강대로88길,173,131,42
2019,2,A,골목상권,1000082,한강대로7길,500,370,130
2019,2,A,골목상권,1000081,한강대로62길,658,436,222
2019,2,A,골목상권,1000080,한강대로52길,8103,2393,5710
2019,2,A,골목상권,1000079,한강대로43길,1702,976,726
2019,2,A,골목상권,1000078,한강대로15길,720,400,320
2019,2,A,골목상권,1000077,한강대로104길,8558,1934,6624
2019,2,A,골목상권,1000076,청파로73길,236,126,110
2019,2,A,골목상권,1000075,청파로71길,781,568,213
2019,2,A,골목상권,1000074,청파로47나길,242,147,95
2019,2,A,골목상권,1000073,청파로47길,257,126,131
2019,2,A,골목상권,1000072,장문로45길,141,75,66
2019,2,A,골목상권,1000071,이태원로54길,889,578,311
2019,2,A,골목상권,1000070,이태원로27길,1061,681,380
2019,2,A,골목상권,1000069,이촌로22길,376,305,71
2019,2,A,골목상권,1000068,원효로89길,1495,1046,449
2019,2,A,골목상권,1000067,원효로53길,408,260,148
2019,2,A,골목상권,1000066,원효로41길,200,123,77
2019,2,A,골목상권,1000065,원효로19길,481,316,165
2019,2,A,골목상권,1000064,우사단로4길,302,143,159
2019,2,A,골목상권,1000063,우사단로14길,2002,973,1029
2019,2,A,골목상권,1000062,우사단로10길,533,489,44
2019,2,A,골목상권,1000061,신흥로20길,171,120,51
2019,2,A,골목상권,1000060,소월로20길,106,39,67
2019,2,A,골목상권,1000059,서빙고로71길,423,264,159
2019,2,A,골목상권,1000058,백범로90길,533,292,241
2019,2,A,골목상권,1000057,백범로79길,945,583,362
2019,2,A,골목상권,1000056,두텁바위로1길,616,340,276
2019,2,A,골목상권,1000055,대사관로34길,648,430,218
2019,2,A,골목상권,1000054,녹사평대로46길,53,17,36
2019,2,A,골목상권,1000053,녹사평대로40나길,67,31,36
2019,2,A,골목상권,1000052,녹사평대로32길,66,39,27
2019,2,A,골목상권,1000051,녹사평대로26길,466,244,222
2019,2,A,골목상권,1000050,녹사평대로11길,123,92,31
2019,2,A,골목상권,1000049,퇴계로90길,569,244,325
2019,2,A,골목상권,1000048,퇴계로8길,418,196,222
2019,2,A,골목상권,1000047,퇴계로56길,877,655,222
2019,2,A,골목상권,1000046,퇴계로46길,1150,556,594
2019,2,A,골목상권,1000045,퇴계로18길,919,556,363
2019,2,A,골목상권,1000044,퇴계로12길,278,147,131
2019,2,A,골목상권,1000043,청구로1길,91,71,20
2019,2,A,골목상권,1000042,청구로17길,523,344,179
2019,2,A,골목상권,1000041,장충단로8길,3859,1945,1914
2019,2,A,골목상권,1000040,삼일대로4길,1704,1211,493
2019,2,A,골목상권,1000039,명동길,7051,4474,2577
2019,2,A,골목상권,1000038,동호로8길,273,116,157
2019,2,A,골목상권,1000037,동호로20길,1860,879,981
2019,2,A,골목상권,1000036,동호로15길,915,567,348
2019,2,A,골목상권,1000035,동호로11길,354,239,115
2019,2,A,골목상권,1000034,동호로10길,1597,859,738
2019,2,A,골목상권,1000033,다산로39길,49,22,27
2019,2,A,골목상권,1000032,다산로38길,492,213,279
2019,2,A,골목상권,1000031,다산로36길,107,45,62
2019,2,A,골목상권,1000030,다산로33길,354,218,136
2019,2,A,골목상권,1000029,난계로21길,124,85,39
2019,2,A,골목상권,1000028,난계로11길,310,193,117
2019,2,A,골목상권,1000027,필운대로1길,244,79,165
2019,2,A,골목상권,1000026,평창길,2679,1515,1164
2019,2,A,골목상권,1000025,통일로12길,7,4,3
2019,2,A,골목상권,1000024,창신길,173,28,145
2019,2,A,골목상권,1000023,창신5길,22,6,16
2019,2,A,골목상권,1000022,창신2길,61,26,35
2019,2,A,골목상권,1000021,창경궁로35길,134,65,69
2019,2,A,골목상권,1000020,지봉로8길,198,101,97
2019,2,A,골목상권,1000019,종로65길,261,151,110
2019,2,A,골목상권,1000018,종로58가길,170,87,83
2019,2,A,골목상권,1000017,종로24길,1123,778,345
2019,2,A,골목상권,1000016,자하문로7길,507,243,264
2019,2,A,골목상권,1000015,이화장길,540,236,304
2019,2,A,골목상권,1000014,율곡로16길,319,204,115
2019,2,A,골목상권,1000013,율곡로10길,351,224,127
2019,2,A,골목상권,1000012,옥인길,85,48,37
2019,2,A,골목상권,1000011,숭인동길,352,153,199
2019,2,A,골목상권,1000010,성균관로5길,169,91,78
2019,2,A,골목상권,1000009,삼청로5길,2709,2629,80
2019,2,A,골목상권,1000008,북촌로5나길,235,118,117
2019,2,A,골목상권,1000007,북촌로5길,548,431,117
2019,2,A,골목상권,1000006,북촌로11길,501,186,315
2019,2,A,골목상권,1000005,백석동길,1686,1005,681
2019,2,A,골목상권,1000004,명륜길,42,29,13
2019,2,A,골목상권,1000003,돈화문로11가길,3804,2773,1031
2019,2,A,골목상권,1000002,난계로27길,348,159,189
2019,2,A,골목상권,1000001,계동길,609,224,385
2019,1,U,관광특구,1001496,강남 마이스 관광특구,26319,15076,11243
2019,1,U,관광특구,1001495,잠실 관광특구,23104,13243,9861
2019,1,U,관광특구,1001494,종로?청계 관광특구,38037,24023,14014
2019,1,U,관광특구,1001493,동대문패션타운 관광특구,20637,11058,9579
2019,1,U,관광특구,1001492,명동 남대문 북창동 다동 무교동 관광특구,174313,82227,92086
2019,1,U,관광특구,1001491,이태원 관광특구,8383,4582,3801
2019,1,R,전통시장,1001490,길동복조리시장,965,485,480
2019,1,R,전통시장,1001489,둔촌역전통시장,1365,852,513
2019,1,R,전통시장,1001488,성내골목시장,48,23,25
2019,1,R,전통시장,1001487,천호시장,99,56,43
2019,1,R,전통시장,1001486,동서울시장,10,5,5
2019,1,R,전통시장,1001485,고분다리골목시장,37,15,22
2019,1,R,전통시장,1001484,양지골목시장,96,42,54
2019,1,R,전통시장,1001483,암사종합시장,237,136,101
2019,1,R,전통시장,1001482,고덕전통시장,161,101,60
2019,1,R,전통시장,1001481,명일골목시장,418,205,213
2019,1,R,전통시장,1001480,새마을시장,575,315,260
2019,1,R,전통시장,1001479,석촌시장,488,233,255
2019,1,R,전통시장,1001478,방이시장,1555,801,754
2019,1,R,전통시장,1001477,마천시장,155,77,78
2019,1,R,전통시장,1001476,풍납시장,62,23,39
2019,1,R,전통시장,1001475,강남개포시장,237,112,125
2019,1,R,전통시장,1001474,도곡시장,164,75,89
2019,1,R,전통시장,1001473,청담삼익시장,133,66,67
2019,1,R,전통시장,1001472,논현종합시장,164,103,61
2019,1,R,전통시장,1001471,영동전통시장,532,308,224
2019,1,R,전통시장,1001470,강남시장_강남,81,38,43
2019,1,R,전통시장,1001469,양재시장,135,73,62
2019,1,R,전통시장,1001468,남부종합시장,47,30,17
2019,1,R,전통시장,1001467,우림시장,55,33,22
2019,1,R,전통시장,1001466,미성동도깨비시장,112,34,78
2019,1,R,전통시장,1001465,신신림시장,36,18,18
2019,1,R,전통시장,1001464,삼성동시장,16,7,9
2019,1,R,전통시장,1001463,신림중앙시장,65,40,25
2019,1,R,전통시장,1001462,강남골목시장,67,33,34
2019,1,R,전통시장,1001461,신림종합시장,48,29,19
2019,1,R,전통시장,1001460,관악신사시장,126,60,66
2019,1,R,전통시장,1001459,신원시장,145,39,106
2019,1,R,전통시장,1001458,인헌시장,306,114,192
2019,1,R,전통시장,1001457,봉천중앙시장,150,60,90
2019,1,R,전통시장,1001456,봉천현대시장,65,31,34
2019,1,R,전통시장,1001455,봉일시장,109,50,59
2019,1,R,전통시장,1001454,봉천제일종합시장,31,15,16
2019,1,R,전통시장,1001453,낙성대시장,95,69,26
2019,1,R,전통시장,1001452,중부시장,288,98,190
2019,1,R,전통시장,1001451,사당시장,194,65,129
2019,1,R,전통시장,1001450,남성역골목시장,261,109,152
2019,1,R,전통시장,1001449,남성사계시장,404,183,221
2019,1,R,전통시장,1001448,흑석시장,204,84,120
2019,1,R,전통시장,1001447,상도4동도깨비골목시장,93,34,59
2019,1,R,전통시장,1001446,성대시장,238,99,139
2019,1,R,전통시장,1001445,영도시장,117,25,92
2019,1,R,전통시장,1001444,상도전통시장,309,187,122
2019,1,R,전통시장,1001443,강남시장_동작,20,9,11
2019,1,R,전통시장,1001442,신노량진시장,26,10,16
2019,1,R,전통시장,1001441,본동인정시장,64,33,31
2019,1,R,전통시장,1001440,노량진중앙시장,304,156,148
2019,1,R,전통시장,1001439,대림중앙시장,20,13,7
2019,1,R,전통시장,1001438,우리시장,37,29,8
2019,1,R,전통시장,1001437,영진시장A동,27,16,11
2019,1,R,전통시장,1001436,사러가시장,173,92,81
2019,1,R,전통시장,1001435,대신시장,40,22,18
2019,1,R,전통시장,1001433,영일시장,222,151,71
2019,1,R,전통시장,1001432,도림시장,44,29,15
2019,1,R,전통시장,1001431,영등포청과시장,185,118,67
2019,1,R,전통시장,1001430,영등포전통시장,4220,1995,2225
2019,1,R,전통시장,1001429,은행나무시장,100,34,66
2019,1,R,전통시장,1001428,박미시장,20,8,12
2019,1,R,전통시장,1001427,현대시장,239,80,159
2019,1,R,전통시장,1001426,대명시장,77,34,43
2019,1,R,전통시장,1001424,남문시장,167,73,94
2019,1,R,전통시장,1001423,독산동 우시장,929,673,256
2019,1,R,전통시장,1001422,오류시장,134,42,92
2019,1,R,전통시장,1001421,개봉중앙시장,32,16,16
2019,1,R,전통시장,1001420,고척근린시장,162,61,101
2019,1,R,전통시장,1001419,가리봉시장,26,17,9
2019,1,R,전통시장,1001418,남구로시장,438,225,213
2019,1,R,전통시장,1001417,구로시장,16,5,11
2019,1,R,전통시장,1001416,공항시장,20,13,7
2019,1,R,전통시장,1001415,방신전통시장,490,251,239
2019,1,R,전통시장,1001414,송화골목시장,320,123,197
2019,1,R,전통시장,1001413,까치산시장,510,129,381
2019,1,R,전통시장,1001412,화곡본동시장,158,66,92
2019,1,R,전통시장,1001411,남부골목시장,253,109,144
2019,1,R,전통시장,1001410,대원종합시장,27,19,8
2019,1,R,전통시장,1001409,화곡중앙골목시장,91,31,60
2019,1,R,전통시장,1001408,신월중앙시장,217,92,125
2019,1,R,전통시장,1001407,등마루시장,10,6,4
2019,1,R,전통시장,1001406,신정3동골목시장,300,178,122
2019,1,R,전통시장,1001405,신정2동골목시장,19,8,11
2019,1,R,전통시장,1001404,신정제일시장,71,22,49
2019,1,R,전통시장,1001403,신월7동골목시장,123,49,74
2019,1,R,전통시장,1001402,신월6동골목시장,331,176,155
2019,1,R,전통시장,1001401,신곡종합시장,13,9,4
2019,1,R,전통시장,1001400,신월3동골목시장,7,6,1
2019,1,R,전통시장,1001399,경창시장,170,54,116
2019,1,R,전통시장,1001398,월정로시장,49,30,19
2019,1,R,전통시장,1001397,신영시장,173,72,101
2019,1,R,전통시장,1001396,목4동시장,80,21,59
2019,1,R,전통시장,1001395,목3동시장,615,306,309
2019,1,R,전통시장,1001394,목2동시장,263,94,169
2019,1,R,전통시장,1001393,마포농수산물시장,795,518,277
2019,1,R,전통시장,1001392,동진시장,50,23,27
2019,1,R,전통시장,1001391,망원월드컵시장,267,156,111
2019,1,R,전통시장,1001390,망원시장,255,111,144
2019,1,R,전통시장,1001389,합정시장,24,10,14
2019,1,R,전통시장,1001388,영진시장,38,23,15
2019,1,R,전통시장,1001387,서교시장,200,106,94
2019,1,R,전통시장,1001386,신수시장,40,15,25
2019,1,R,전통시장,1001385,아현시장,356,101,255
2019,1,R,전통시장,1001384,마포시장,49,21,28
2019,1,R,전통시장,1001383,공덕시장,1829,769,1060
2019,1,R,전통시장,1001382,백련시장,8,4,4
2019,1,R,전통시장,1001381,모래내시장,18,14,4
2019,1,R,전통시장,1001380,포방터시장,24,15,9
2019,1,R,전통시장,1001379,인왕시장,122,38,84
2019,1,R,전통시장,1001378,아현가구거리상점가,117,66,51
2019,1,R,전통시장,1001377,영천시장,169,76,93
2019,1,R,전통시장,1001376,수일시장,17,5,12
2019,1,R,전통시장,1001375,증산종합시장,92,27,65
2019,1,R,전통시장,1001374,대림골목시장,333,83,250
2019,1,R,전통시장,1001373,신응암시장,35,18,17
2019,1,R,전통시장,1001372,녹번시장,100,38,62
2019,1,R,전통시장,1001371,대조시장,74,21,53
2019,1,R,전통시장,1001370,역촌중앙시장,30,12,18
2019,1,R,전통시장,1001369,갈현시장,57,28,29
2019,1,R,전통시장,1001368,연서시장,287,137,150
2019,1,R,전통시장,1001367,상계중앙시장,299,122,177
2019,1,R,전통시장,1001365,공릉동도깨비시장,448,247,201
2019,1,R,전통시장,1001364,방학동도깨비시장,168,72,96
2019,1,R,전통시장,1001363,쌍문역골목시장,32,16,16
2019,1,R,전통시장,1001362,백운시장,44,21,23
2019,1,R,전통시장,1001361,신도봉시장,48,23,25
2019,1,R,전통시장,1001360,창동골목시장,105,36,69
2019,1,R,전통시장,1001359,창동신창시장,246,115,131
2019,1,R,전통시장,1001358,수유북부시장,24,16,8
2019,1,R,전통시장,1001357,장미원골목시장,93,37,56
2019,1,R,전통시장,1001356,수유중앙시장,41,23,18
2019,1,R,전통시장,1001355,강북종합시장,104,50,54
2019,1,R,전통시장,1001354,우이시장,133,48,85
2019,1,R,전통시장,1001353,수유전통시장,298,145,153
2019,1,R,전통시장,1001352,번동북부골목시장,85,40,45
2019,1,R,전통시장,1001351,솔샘시장,171,59,112
2019,1,R,전통시장,1001350,숭인시장,246,100,146
2019,1,R,전통시장,1001349,방천골목시장,199,110,89
2019,1,R,전통시장,1001348,동북시장,132,61,71
2019,1,R,전통시장,1001347,석관황금시장,39,23,16
2019,1,R,전통시장,1001346,석관시장,27,15,12
2019,1,R,전통시장,1001345,새석관시장,23,17,6
2019,1,R,전통시장,1001344,번동시장,15,11,4
2019,1,R,전통시장,1001343,장위전통시장,127,68,59
2019,1,R,전통시장,1001342,밤나무골시장,25,5,20
2019,1,R,전통시장,1001341,길음시장,94,51,43
2019,1,R,전통시장,1001340,정릉시장,313,156,157
2019,1,R,전통시장,1001339,정릉아리랑시장,80,32,48
2019,1,R,전통시장,1001338,돈암제일시장,232,96,136
2019,1,R,전통시장,1001337,유영시장,70,20,50
2019,1,R,전통시장,1001336,우림골목시장,584,217,367
2019,1,R,전통시장,1001335,묵1동도깨비시장,38,20,18
2019,1,R,전통시장,1001334,태능시장,160,45,115
2019,1,R,전통시장,1001333,중화제일시장,66,20,46
2019,1,R,전통시장,1001332,사가정시장,250,85,165
2019,1,R,전통시장,1001331,면목골목시장,129,57,72
2019,1,R,전통시장,1001330,동원시장,558,251,307
2019,1,R,전통시장,1001329,동부골목시장,307,111,196
2019,1,R,전통시장,1001328,이문제일시장,25,10,15
2019,1,R,전통시장,1001327,이경시장,40,21,19
2019,1,R,전통시장,1001326,회기시장,141,57,84
2019,1,R,전통시장,1001325,청량리청과물시장,107,62,45
2019,1,R,전통시장,1001324,전곡시장,88,42,46
2019,1,R,전통시장,1001323,답십리시장,257,93,164
2019,1,R,전통시장,1001322,동부시장,40,20,20
2019,1,R,전통시장,1001321,답십리현대시장,124,91,33
2019,1,R,전통시장,1001320,전농로터리시장,105,49,56
2019,1,R,전통시장,1001319,청량리종합시장,69,47,22
2019,1,R,전통시장,1001318,청량리전통시장,20,12,8
2019,1,R,전통시장,1001317,청량리농수산물시장,15,12,3
2019,1,R,전통시장,1001316,서울약령시장,1874,1146,728
2019,1,R,전통시장,1001315,동서시장,26,18,8
2019,1,R,전통시장,1001314,경동시장,274,182,92
2019,1,R,전통시장,1001313,청량리수산시장,175,83,92
2019,1,R,전통시장,1001312,용두시장,6,4,2
2019,1,R,전통시장,1001310,구의시장,8,4,4
2019,1,R,전통시장,1001309,조양시장,152,91,61
2019,1,R,전통시장,1001308,영동교골목시장,27,10,17
2019,1,R,전통시장,1001307,능동로골목시장,37,19,18
2019,1,R,전통시장,1001306,노룬산골목시장,85,43,42
2019,1,R,전통시장,1001305,자양종합시장,14,10,4
2019,1,R,전통시장,1001304,자양골목시장,75,43,32
2019,1,R,전통시장,1001303,신성골목시장,118,55,63
2019,1,R,전통시장,1001302,면곡골목시장,135,45,90
2019,1,R,전통시장,1001301,중곡제일시장,622,132,490
2019,1,R,전통시장,1001300,화양제일골목시장,63,31,32
2019,1,R,전통시장,1001299,한아름시장,109,60,49
2019,1,R,전통시장,1001298,성동용답상가시장,149,69,80
2019,1,R,전통시장,1001297,뚝도시장,145,77,68
2019,1,R,전통시장,1001296,금남시장,111,27,84
2019,1,R,전통시장,1001295,행당시장,637,278,359
2019,1,R,전통시장,1001294,마장축산물시장,1715,1162,553
2019,1,R,전통시장,1001293,보광시장,48,21,27
2019,1,R,전통시장,1001292,이태원제일시장,28,13,15
2019,1,R,전통시장,1001291,이태원시장,220,127,93
2019,1,R,전통시장,1001290,이촌종합시장,162,92,70
2019,1,R,전통시장,1001289,용문전통시장,97,49,48
2019,1,R,전통시장,1001288,만리시장,37,28,9
2019,1,R,전통시장,1001287,신흥시장,35,21,14
2019,1,R,전통시장,1001286,후암시장,28,11,17
2019,1,R,전통시장,1001285,합동(새벽)시장,1138,653,485
2019,1,R,전통시장,1001284,서울중앙시장,858,542,316
2019,1,R,전통시장,1001283,백학시장,201,112,89
2019,1,R,전통시장,1001282,약수시장,623,275,348
2019,1,R,전통시장,1001281,청평화시장,987,363,624
2019,1,R,전통시장,1001280,제일평화시장,397,162,235
2019,1,R,전통시장,1001279,동평화시장,978,522,456
2019,1,R,전통시장,1001278,남평화시장,241,168,73
2019,1,R,전통시장,1001277,방산종합시장,2936,1886,1050
2019,1,R,전통시장,1001276,평화시장,3741,2568,1173
2019,1,R,전통시장,1001275,인현시장,556,361,195
2019,1,R,전통시장,1001274,신중부시장,1767,1140,627
2019,1,R,전통시장,1001273,남대문시장,11688,5396,6292
2019,1,R,전통시장,1001272,신설종합시장,156,116,40
2019,1,R,전통시장,1001271,동묘시장,414,247,167
2019,1,R,전통시장,1001270,창신골목시장,127,62,65
2019,1,R,전통시장,1001269,동문시장,33,27,6
2019,1,R,전통시장,1001268,충신시장,314,186,128
2019,1,R,전통시장,1001267,종로신진시장,592,334,258
2019,1,R,전통시장,1001266,동대문종합시장,4641,3247,1394
2019,1,R,전통시장,1001265,광장시장,971,623,348
2019,1,R,전통시장,1001264,통인시장,252,172,80
2019,1,D,발달상권,1001263,서울 노원구 노원역_3,1843,739,1104
2019,1,D,발달상권,1001262,서울 노원구 노원역_2,931,334,597
2019,1,D,발달상권,1001261,서울 노원구 노원역_1,929,271,658
2019,1,D,발달상권,1001260,창동역,1964,1023,941
2019,1,D,발달상권,1001259,서울 강북구 수유역_3,250,112,138
2019,1,D,발달상권,1001258,등나무근린공원 주변,277,110,167
2019,1,D,발달상권,1001257,서울 강북구 수유역_2,3287,1703,1584
2019,1,D,발달상권,1001256,서울 강북구 수유역_1,1690,796,894
2019,1,D,발달상권,1001255,서울 은평구 연신내역_3,156,40,116
2019,1,D,발달상권,1001254,서울 은평구 연신내역_2,1164,430,734
2019,1,D,발달상권,1001253,서울 은평구 연신내역_1,218,73,145
2019,1,D,발달상권,1001252,서울 성북구 미아삼거리역_2,495,190,305
2019,1,D,발달상권,1001251,서울 강북구 미아삼거리역_1,1081,458,623
2019,1,D,발달상권,1001250,서울 은평구 불광역_3,259,88,171
2019,1,D,발달상권,1001249,서울 은평구 불광역_2,441,134,307
2019,1,D,발달상권,1001248,서울 은평구 불광역_1,634,287,347
2019,1,D,발달상권,1001247,미아사거리_2,258,98,160
2019,1,D,발달상권,1001246,미아사거리_1,387,139,248
2019,1,D,발달상권,1001245,서울 성북구 성신여대입구역,3952,2161,1791
2019,1,D,발달상권,1001244,경희대학교,329,161,168
2019,1,D,발달상권,1001243,서울 성북구 안암역,361,215,146
2019,1,D,발달상권,1001242,혜화역 대학로_3,1193,548,645
2019,1,D,발달상권,1001241,혜화역 대학로_2,336,144,192
2019,1,D,발달상권,1001240,혜화역 대학로_1,1786,795,991
2019,1,D,발달상권,1001239,디지털미디어시티,18781,11285,7496
2019,1,D,발달상권,1001238,서울 동대문구 청량리역,1781,786,995
2019,1,D,발달상권,1001237,서울 종로구 경복궁역_2,593,259,334
2019,1,D,발달상권,1001236,서울 종로구 안국역_2,976,443,533
2019,1,D,발달상권,1001235,서울 종로구 안국역_1,19553,17300,2253
2019,1,D,발달상권,1001234,서울 종로구 경복궁역_1,507,255,252
2019,1,D,발달상권,1001233,서울 종로구 종로3가역_3,3047,1575,1472
2019,1,D,발달상권,1001232,서울 종로구 종로3가역_2,2652,1308,1344
2019,1,D,발달상권,1001231,서울 동대문구 신설동역_2,1246,575,671
2019,1,D,발달상권,1001230,인사동,19641,12064,7577
2019,1,D,발달상권,1001229,서울 종로구 종로5가역_4,1421,841,580
2019,1,D,발달상권,1001228,서울 종로구 종로5가역_3,3106,1868,1238
2019,1,D,발달상권,1001227,종로구청,55674,34488,21186
2019,1,D,발달상권,1001226,서울 종로구 종로5가역_2,15994,9901,6093
2019,1,D,발달상권,1001225,신설동역,561,269,292
2019,1,D,발달상권,1001224,서울 동대문구 신설동역_1,1755,789,966
2019,1,D,발달상권,1001223,서울 종로구 광화문역_2,44020,25468,18552
2019,1,D,발달상권,1001222,동묘앞역,396,181,215
2019,1,D,발달상권,1001221,장안동사거리,2032,939,1093
2019,1,D,발달상권,1001220,서울 종로구 동대문역_2,1685,650,1035
2019,1,D,발달상권,1001219,서울 종로구 동대문역_1,109,57,52
2019,1,D,발달상권,1001218,동대문시장_2,544,316,228
2019,1,D,발달상권,1001217,서울 종로구 종로5가역_1,148,58,90
2019,1,D,발달상권,1001216,서울 종로구 종로3가역_1,3768,1701,2067
2019,1,D,발달상권,1001215,서울 종로구 광화문역_1,18896,10887,8009
2019,1,D,발달상권,1001214,종각역,9951,7527,2424
2019,1,D,발달상권,1001213,종각역 젊음의 거리,3769,1603,2166
2019,1,D,발달상권,1001212,서대문구 서대문역_1,378,275,103
2019,1,D,발달상권,1001211,동대문시장_1,2174,738,1436
2019,1,D,발달상권,1001210,시청역_2,16175,9365,6810
2019,1,D,발달상권,1001209,서울시청,18067,7982,10085
2019,1,D,발달상권,1001208,서울 중구 을지로3가역_2,24690,15687,9003
2019,1,D,발달상권,1001207,서울 중구 신당역_2,3935,1888,2047
2019,1,D,발달상권,1001206,서대문구 서대문역_2,3320,2079,1241
2019,1,D,발달상권,1001205,동대문역사문화공원역,1958,1103,855
2019,1,D,발달상권,1001204,서울 중구 을지로3가역_1,17794,10301,7493
2019,1,D,발달상권,1001203,명동거리,17311,5640,11671
2019,1,D,발달상권,1001202,롯데백화점,35154,13936,21218
2019,1,D,발달상권,1001201,서울 중구 신당역_1,1100,538,562
2019,1,D,발달상권,1001200,북창동,8135,4122,4013
2019,1,D,발달상권,1001199,서울 중구 충무로역_2,25323,12995,12328
2019,1,D,발달상권,1001198,서울 강서구 송정역,633,301,332
2019,1,D,발달상권,1001197,장한평역_2,2933,1826,1107
2019,1,D,발달상권,1001196,시청역_1,49346,32844,16502
2019,1,D,발달상권,1001195,왕십리역_2,1715,538,1177
2019,1,D,발달상권,1001194,서울 강서구 발산역,2123,1180,943
2019,1,D,발달상권,1001193,장한평역_1,2614,1567,1047
2019,1,D,발달상권,1001192,서울 중구 충무로역_1,4871,3075,1796
2019,1,D,발달상권,1001191,왕십리역_1,43,17,26
2019,1,D,발달상권,1001190,장한평역,6926,4422,2504
2019,1,D,발달상권,1001189,서울 중구 명동역,8002,4224,3778
2019,1,D,발달상권,1001188,장충동 족발거리,1592,1124,468
2019,1,D,발달상권,1001187,한양시장,330,171,159
2019,1,D,발달상권,1001186,서울 서대문구 이대역,1207,555,652
2019,1,D,발달상권,1001185,서울 서대문구 신촌역,4002,1723,2279
2019,1,D,발달상권,1001184,서울 마포구 홍대입구역_3,2794,1105,1689
2019,1,D,발달상권,1001183,서울 마포구 홍대입구역_2,2503,925,1578
2019,1,D,발달상권,1001182,홍익대학교 주변,17048,8543,8505
2019,1,D,발달상권,1001181,서울 광진구 군자역,1982,1215,767
2019,1,D,발달상권,1001180,신촌역,5384,2673,2711
2019,1,D,발달상권,1001179,강서구청,5321,3082,2239
2019,1,D,발달상권,1001178,서울 마포구 홍대입구역_1,3131,1518,1613
2019,1,D,발달상권,1001177,서울 중구 약수역_2,515,215,300
2019,1,D,발달상권,1001176,서울 중구 약수역_1,41,14,27
2019,1,D,발달상권,1001175,서울 강동구 고덕역,1397,634,763
2019,1,D,발달상권,1001174,등촌역,633,246,387
2019,1,D,발달상권,1001173,서울 강동구 명일역,1407,444,963
2019,1,D,발달상권,1001172,어린이대공원역,169,86,83
2019,1,D,발달상권,1001171,서울 마포구 공덕역_2,957,495,462
2019,1,D,발달상권,1001170,공덕역,4855,3061,1794
2019,1,D,발달상권,1001169,서울 용산구 숙대입구역,5761,3373,2388
2019,1,D,발달상권,1001168,남영역,12123,6406,5717
2019,1,D,발달상권,1001167,서울 마포구 공덕역_1,8182,4971,3211
2019,1,D,발달상권,1001166,서울 마포구 마포역_2,14367,8130,6237
2019,1,D,발달상권,1001165,서울 광진구 건대입구역_2,1569,741,828
2019,1,D,발달상권,1001164,서울 마포구 마포역_1,4891,3266,1625
2019,1,D,발달상권,1001163,서울 강동구 천호역_2,3905,1728,2177
2019,1,D,발달상권,1001162,서울 광진구 건대입구역_1,581,233,348
2019,1,D,발달상권,1001161,건대입구역,865,447,418
2019,1,D,발달상권,1001160,서울 광진구 구의역,1490,866,624
2019,1,D,발달상권,1001159,서울 강동구 천호역,625,243,382
2019,1,D,발달상권,1001158,당산역_2,5817,3691,2126
2019,1,D,발달상권,1001157,서울 강동구 천호역_1,336,140,196
2019,1,D,발달상권,1001156,서울 강동구 길동역,3638,1597,2041
2019,1,D,발달상권,1001155,용산 전자상가_5,3269,2378,891
2019,1,D,발달상권,1001154,용산 전자상가_4,539,346,193
2019,1,D,발달상권,1001153,당산역_1,859,412,447
2019,1,D,발달상권,1001152,서울 광진구 강변역,2766,1747,1019
2019,1,D,발달상권,1001151,용산 전자상가_3,2637,1941,696
2019,1,D,발달상권,1001150,서울 용산구 이태원역,1473,863,610
2019,1,D,발달상권,1001149,한남오거리,1156,679,477
2019,1,D,발달상권,1001148,목동사거리,182,58,124
2019,1,D,발달상권,1001147,용산 전자상가_2,2290,1883,407
2019,1,D,발달상권,1001146,용산구청,1979,1007,972
2019,1,D,발달상권,1001145,용산 전자상가_1,12218,7169,5049
2019,1,D,발달상권,1001144,국회의사당역_2,22362,12621,9741
2019,1,D,발달상권,1001143,서울 용산구 신용산역,12319,5744,6575
2019,1,D,발달상권,1001142,국회의사당역_1,2806,1542,1264
2019,1,D,발달상권,1001141,압구정 로데오거리_2,12954,4842,8112
2019,1,D,발달상권,1001140,서울 강남구 압구정역,10385,4717,5668
2019,1,D,발달상권,1001139,서울 영등포구 영등포구청역,884,465,419
2019,1,D,발달상권,1001138,압구정 로데오거리_1,10220,3605,6615
2019,1,D,발달상권,1001137,서울 강동구 둔촌동역,687,325,362
2019,1,D,발달상권,1001136,오목교역,303,139,164
2019,1,D,발달상권,1001135,신사동 가로수길,25750,11279,14471
2019,1,D,발달상권,1001134,서울 영등포구 여의도역_2,56221,36723,19498
2019,1,D,발달상권,1001133,청담사거리_3,3459,1125,2334
2019,1,D,발달상권,1001132,영등포유통상가,2041,1208,833
2019,1,D,발달상권,1001131,청담역_2,6290,4287,2003
2019,1,D,발달상권,1001130,청담역_1,4644,2935,1709
2019,1,D,발달상권,1001129,청담사거리_2,920,327,593
2019,1,D,발달상권,1001128,청담사거리_1,2085,640,1445
2019,1,D,발달상권,1001127,서울 영등포구 여의도역_1,49466,27413,22053
2019,1,D,발달상권,1001126,서울 양천구 신정네거리역_2,49,27,22
2019,1,D,발달상권,1001125,학동사거리_2,2897,2139,758
2019,1,D,발달상권,1001124,서울 영등포구 영등포시장역,982,614,368
2019,1,D,발달상권,1001123,학동사거리_1,8375,4508,3867
2019,1,D,발달상권,1001122,여의도 시범아파트앞,13574,6841,6733
2019,1,D,발달상권,1001121,영등포역_3,944,563,381
2019,1,D,발달상권,1001120,도산공원사거리_1,5906,3015,2891
2019,1,D,발달상권,1001119,영등포역_2,969,512,457
2019,1,D,발달상권,1001118,문래동 주민센터,16718,8110,8608
2019,1,D,발달상권,1001117,강남구 신사역_2,10284,4700,5584
2019,1,D,발달상권,1001116,영등포역_1,451,259,192
2019,1,D,발달상권,1001115,서울 강남구 강남구청역_2,5291,2804,2487
2019,1,D,발달상권,1001114,강남구 신사역_1,1587,819,768
2019,1,D,발달상권,1001113,서울 동작구 노량진1동_1,235,142,93
2019,1,D,발달상권,1001112,서울 강남구 학동역_3,5416,2694,2722
2019,1,D,발달상권,1001111,서울 강남구 강남구청역_1,4603,2720,1883
2019,1,D,발달상권,1001110,잠실역,40450,17880,22570
2019,1,D,발달상권,1001109,강남구 논현역_4,9949,5407,4542
2019,1,D,발달상권,1001108,학동역,2812,1340,1472
2019,1,D,발달상권,1001107,방이동 먹자골목,5226,3150,2076
2019,1,D,발달상권,1001106,서울 강남구 학동역_2,3399,2080,1319
2019,1,D,발달상권,1001105,서울 동작구 노량진역,1445,965,480
2019,1,D,발달상권,1001104,삼성역_3,11446,7449,3997
2019,1,D,발달상권,1001103,코엑스,26319,15076,11243
2019,1,D,발달상권,1001102,서울 강남구 학동역_1,2579,1598,981
2019,1,D,발달상권,1001101,선정릉역_2,3671,2006,1665
2019,1,D,발달상권,1001100,강남구 논현역_3,2978,1668,1310
2019,1,D,발달상권,1001099,포스코사거리_2,18461,10767,7694
2019,1,D,발달상권,1001098,포스코사거리_1,10442,6163,4279
2019,1,D,발달상권,1001097,잠실역 롯데월드,3374,1680,1694
2019,1,D,발달상권,1001096,신도림역,7280,2951,4329
2019,1,D,발달상권,1001095,강남구 논현역_2,9710,5491,4219
2019,1,D,발달상권,1001094,선정릉역_1,3281,2011,1270
2019,1,D,발달상권,1001093,신천역,7698,4381,3317
2019,1,D,발달상권,1001092,강남구 논현역_1,4234,2242,1992
2019,1,D,발달상권,1001091,삼성역_2,9260,4425,4835
2019,1,D,발달상권,1001090,삼정역_2,2885,1564,1321
2019,1,D,발달상권,1001089,삼정역_1,3558,1541,2017
2019,1,D,발달상권,1001088,삼성역_1,30803,19253,11550
2019,1,D,발달상권,1001087,서울 강남구 선릉역_2,16076,9844,6232
2019,1,D,발달상권,1001086,고속터미널역,3888,2173,1715
2019,1,D,발달상권,1001085,서울 서초구 강남역,35271,19691,15580
2019,1,D,발달상권,1001084,서울 강남구 선릉역_1,29179,12392,16787
2019,1,D,발달상권,1001083,서울 송파구 석촌역_2,354,193,161
2019,1,D,발달상권,1001082,선릉역_2,21601,12688,8913
2019,1,D,발달상권,1001081,서울 강남구 역삼역_2,35830,23745,12085
2019,1,D,발달상권,1001080,서울 송파구 석촌역_1,238,121,117
2019,1,D,발달상권,1001079,석촌역,216,162,54
2019,1,D,발달상권,1001078,서울 강남구 강남역_2,12707,5534,7173
2019,1,D,발달상권,1001077,선릉역_1,19230,11361,7869
2019,1,D,발달상권,1001076,구로역,458,149,309
2019,1,D,발달상권,1001075,역삼역_2,6667,3349,3318
2019,1,D,발달상권,1001074,대림역_2,8108,5936,2172
2019,1,D,발달상권,1001073,서울 강남구 역삼역_1,32290,19359,12931
2019,1,D,발달상권,1001072,신대방삼거리역,672,287,385
2019,1,D,발달상권,1001071,서울 강남구 한티역,1356,659,697
2019,1,D,발달상권,1001070,은마아파트입구사거리_4,498,194,304
2019,1,D,발달상권,1001069,은마아파트입구사거리_3,292,138,154
2019,1,D,발달상권,1001068,은마아파트입구사거리_2,207,99,108
2019,1,D,발달상권,1001067,오류동역,1862,961,901
2019,1,D,발달상권,1001066,서울 강남구 강남역,33083,12913,20170
2019,1,D,발달상권,1001065,은마아파트입구사거리_1,480,147,333
2019,1,D,발달상권,1001064,대림역_1,565,290,275
2019,1,D,발달상권,1001063,교대역_4,6657,3414,3243
2019,1,D,발달상권,1001062,서울 강남구 강남역_1,30628,17117,13511
2019,1,D,발달상권,1001061,방배동카페골목,523,234,289
2019,1,D,발달상권,1001060,가락시장,61,50,11
2019,1,D,발달상권,1001059,교대역_3,3023,1690,1333
2019,1,D,발달상권,1001058,역삼역_1,4310,2476,1834
2019,1,D,발달상권,1001057,교대역_2,4587,2523,2064
2019,1,D,발달상권,1001056,서울 송파구 가락시장역,5688,3485,2203
2019,1,D,발달상권,1001055,서울 서초구 서초역,3711,1932,1779
2019,1,D,발달상권,1001054,서울 강남구 대치역_2,1138,562,576
2019,1,D,발달상권,1001053,서울 강남구 대치역_1,319,115,204
2019,1,D,발달상권,1001052,뱅뱅사거리_2,15677,9515,6162
2019,1,D,발달상권,1001051,보라매공원,11978,6495,5483
2019,1,D,발달상권,1001050,교대역_1,24301,11781,12520
2019,1,D,발달상권,1001049,개봉동 현대아파트 인근,620,196,424
2019,1,D,발달상권,1001048,뱅뱅사거리,5660,3302,2358
2019,1,D,발달상권,1001047,뱅뱅사거리_1,4376,3049,1327
2019,1,D,발달상권,1001046,서울 관악구 신림역_4,1154,529,625
2019,1,D,발달상권,1001045,동작구 총신대입구역_1,1294,636,658
2019,1,D,발달상권,1001044,양재역_3,8624,5484,3140
2019,1,D,발달상권,1001043,동작구 총신대입구역_2,2016,1090,926
2019,1,D,발달상권,1001042,서울 서초구 남부터미널역_3,4845,1969,2876
2019,1,D,발달상권,1001041,서울 강남구 수서역,12474,6372,6102
2019,1,D,발달상권,1001040,서울 관악구 신림역_3,448,171,277
2019,1,D,발달상권,1001039,서울 서초구 남부터미널역_2,7655,5244,2411
2019,1,D,발달상권,1001038,구로디지탈1단지,69308,42662,26646
2019,1,D,발달상권,1001037,양재역,2585,1352,1233
2019,1,D,발달상권,1001036,문정역,131,79,52
2019,1,D,발달상권,1001035,매봉역,2456,1402,1054
2019,1,D,발달상권,1001034,서울 서초구 방배역,2820,1547,1273
2019,1,D,발달상권,1001033,서울 서초구 남부터미널역_1,4040,2601,1439
2019,1,D,발달상권,1001032,서울 관악구 신림역_2,462,167,295
2019,1,D,발달상권,1001031,서울 관악구 신림역_1,1442,736,706
2019,1,D,발달상권,1001030,양재역_2,5961,2597,3364
2019,1,D,발달상권,1001029,양재역_1,1363,603,760
2019,1,D,발달상권,1001028,서울 관악구 서울대입구역_2,248,106,142
2019,1,D,발달상권,1001027,가산디지털단지역_3,37770,22520,15250
2019,1,D,발달상권,1001026,구로디지털단지역,115,78,37
2019,1,D,발달상권,1001025,서울 관악구 서울대입구역_1,3202,1502,1700
2019,1,D,발달상권,1001024,관악구 사당역_1,3324,1194,2130
2019,1,D,발달상권,1001023,가산디지털단지역_2,41516,26488,15028
2019,1,D,발달상권,1001022,관악구 사당역_2,1647,856,791
2019,1,D,발달상권,1001021,가산디지털단지역_1,22554,14370,8184
2019,1,D,발달상권,1001020,장지역,8994,6106,2888
2019,1,D,발달상권,1001019,포이사거리_1,582,326,256
2019,1,D,발달상권,1001018,포이사거리_2,15004,8391,6613
2019,1,D,발달상권,1001017,관악구 사당역_3,2050,1363,687
2019,1,D,발달상권,1001016,서울 관악구 대학동_1,932,703,229
2019,1,D,발달상권,1001015,서울 금천구 독산1동_1,4841,2882,1959
2019,1,D,발달상권,1001014,양재동 꽃시장,750,349,401
2019,1,D,발달상권,1001013,양재 화물트럭터미널앞_2,2333,1733,600
2019,1,D,발달상권,1001012,양재 화물트럭터미널앞_1,2535,2089,446
2019,1,D,발달상권,1001011,서울 금천구 시흥1동_4,1128,425,703
2019,1,A,골목상권,1001010,풍성로37가길,271,61,210
2019,1,A,골목상권,1001009,천호옛길,728,463,265
2019,1,A,골목상권,1001008,천호옛14길,252,151,101
2019,1,A,골목상권,1001007,천호대로219길,823,262,561
2019,1,A,골목상권,1001006,천호대로197길,239,117,122
2019,1,A,골목상권,1001005,천호대로187길,595,309,286
2019,1,A,골목상권,1001004,천호대로170길,798,504,294
2019,1,A,골목상권,1001003,천호대로162길,234,103,131
2019,1,A,골목상권,1001002,천중로51길,596,264,332
2019,1,A,골목상권,1001001,천중로39길,538,316,222
2019,1,A,골목상권,1001000,진황도로47길,190,83,107
2019,1,A,골목상권,1000999,진황도로27길,452,225,227
2019,1,A,골목상권,1000998,올림픽로98길,176,99,77
2019,1,A,골목상권,1000997,올림픽로80길,300,100,200
2019,1,A,골목상권,1000996,올림픽로78길,339,117,222
2019,1,A,골목상권,1000995,올림픽로77길,144,84,60
2019,1,A,골목상권,1000994,올림픽로71길,225,145,80
2019,1,A,골목상권,1000993,올림픽로48길,2031,1260,771
2019,1,A,골목상권,1000992,양재대로96길,233,137,96
2019,1,A,골목상권,1000991,양재대로95길,741,404,337
2019,1,A,골목상권,1000990,양재대로91길,395,224,171
2019,1,A,골목상권,1000989,양재대로133길,342,149,193
2019,1,A,골목상권,1000988,양재대로124길,500,269,231
2019,1,A,골목상권,1000987,양재대로116길,170,60,110
2019,1,A,골목상권,1000986,양재대로101길,655,357,298
2019,1,A,골목상권,1000985,암사길,257,116,141
2019,1,A,골목상권,1000984,성안로3길,1781,1077,704
2019,1,A,골목상권,1000983,성내로5길,1516,844,672
2019,1,A,골목상권,1000982,상일로5길,437,194,243
2019,1,A,골목상권,1000981,상암로5길,649,289,360
2019,1,A,골목상권,1000980,상암로51길,489,166,323
2019,1,A,골목상권,1000979,상암로4길,488,277,211
2019,1,A,골목상권,1000978,상암로14길,405,203,202
2019,1,A,골목상권,1000977,명일로13길,459,236,223
2019,1,A,골목상권,1000976,동남로85길,150,63,87
2019,1,A,골목상권,1000975,동남로82길,128,47,81
2019,1,A,골목상권,1000974,동남로65길,278,104,174
2019,1,A,골목상권,1000973,구천면로42길,207,101,106
2019,1,A,골목상권,1000972,구천면로41길,468,221,247
2019,1,A,골목상권,1000971,구천면로36길,57,27,30
2019,1,A,골목상권,1000970,고덕로61길,206,71,135
2019,1,A,골목상권,1000969,고덕로25길,143,70,73
2019,1,A,골목상권,1000968,고덕로10길,402,133,269
2019,1,A,골목상권,1000967,강동대로53길,1010,604,406
2019,1,A,골목상권,1000966,풍성로25길,382,136,246
2019,1,A,골목상권,1000965,오금로46길,1258,669,589
2019,1,A,골목상권,1000964,오금로36길,1661,916,745
2019,1,A,골목상권,1000963,오금로11길,1028,605,423
2019,1,A,골목상권,1000962,양재대로72길,526,238,288
2019,1,A,골목상권,1000961,양재대로71길,2401,1585,816
2019,1,A,골목상권,1000960,양재대로64길,1766,868,898
2019,1,A,골목상권,1000959,양재대로62길,1204,697,507
2019,1,A,골목상권,1000958,송파대로30길,1601,698,903
2019,1,A,골목상권,1000957,송이로36길,1095,695,400
2019,1,A,골목상권,1000956,송이로32길,1043,527,516
2019,1,A,골목상권,1000955,송이로23길,1818,993,825
2019,1,A,골목상권,1000954,삼전로13길,1347,638,709
2019,1,A,골목상권,1000953,백제고분로50길,759,472,287
2019,1,A,골목상권,1000952,백제고분로46길,642,357,285
2019,1,A,골목상권,1000951,백제고분로45길,999,627,372
2019,1,A,골목상권,1000950,백제고분로42길,359,208,151
2019,1,A,골목상권,1000949,백제고분로39길,685,373,312
2019,1,A,골목상권,1000948,백제고분로34길,845,530,315
2019,1,A,골목상권,1000947,백제고분로33길,1395,525,870
2019,1,A,골목상권,1000946,백제고분로32길,778,520,258
2019,1,A,골목상권,1000945,백제고분로31길,1977,1404,573
2019,1,A,골목상권,1000944,백제고분로22길,1019,576,443
2019,1,A,골목상권,1000943,백제고분로21길,547,303,244
2019,1,A,골목상권,1000942,마천로51길,421,253,168
2019,1,A,골목상권,1000941,동남로20길,1179,580,599
2019,1,A,골목상권,1000940,거마로20길,588,245,343
2019,1,A,골목상권,1000939,학동로77길,1692,650,1042
2019,1,A,골목상권,1000938,학동로6길,625,347,278
2019,1,A,골목상권,1000937,학동로56길,3119,1317,1802
2019,1,A,골목상권,1000936,학동로38길,1984,823,1161
2019,1,A,골목상권,1000935,테헤란로81길,5013,2759,2254
2019,1,A,골목상권,1000934,일원로9길,601,344,257
2019,1,A,골목상권,1000933,일원로3길,475,203,272
2019,1,A,골목상권,1000932,영동대로65길,1301,712,589
2019,1,A,골목상권,1000931,영동대로112길,12892,9901,2991
2019,1,A,골목상권,1000930,언주로81길,10678,4715,5963
2019,1,A,골목상권,1000929,압구정로2길,1636,841,795
2019,1,A,골목상권,1000928,선릉로18길,370,186,184
2019,1,A,골목상권,1000927,선릉로146길,1683,769,914
2019,1,A,골목상권,1000926,선릉로133길,1015,507,508
2019,1,A,골목상권,1000925,선릉로132길,901,386,515
2019,1,A,골목상권,1000924,선릉로121길,2303,982,1321
2019,1,A,골목상권,1000923,삼성로75길,1458,803,655
2019,1,A,골목상권,1000922,삼성로69길,802,433,369
2019,1,A,골목상권,1000921,삼성로64길,246,121,125
2019,1,A,골목상권,1000920,삼성로63길,719,293,426
2019,1,A,골목상권,1000919,삼성로57길,318,114,204
2019,1,A,골목상권,1000918,삼성로147길,257,118,139
2019,1,A,골목상권,1000917,삼성로115길,674,329,345
2019,1,A,골목상권,1000916,봉은사로68길,1524,908,616
2019,1,A,골목상권,1000915,봉은사로57길,750,493,257
2019,1,A,골목상권,1000914,봉은사로43길,4240,2060,2180
2019,1,A,골목상권,1000913,봉은사로29길,3670,1718,1952
2019,1,A,골목상권,1000912,봉은사로109길,814,406,408
2019,1,A,골목상권,1000911,도산대로89길,665,310,355
2019,1,A,골목상권,1000910,도산대로81길,1942,556,1386
2019,1,A,골목상권,1000909,도산대로50길,2054,1105,949
2019,1,A,골목상권,1000908,도산대로38길,1159,623,536
2019,1,A,골목상권,1000907,도산대로30길,2122,1036,1086
2019,1,A,골목상권,1000906,도산대로23길,617,358,259
2019,1,A,골목상권,1000905,도산대로15길,430,191,239
2019,1,A,골목상권,1000904,도곡로37길,4932,3048,1884
2019,1,A,골목상권,1000903,논현로8길,1227,821,406
2019,1,A,골목상권,1000902,논현로63길,1757,1061,696
2019,1,A,골목상권,1000901,논현로28길,1579,905,674
2019,1,A,골목상권,1000900,논현로26길,5802,3219,2583
2019,1,A,골목상권,1000899,논현로159길,450,167,283
2019,1,A,골목상권,1000898,논현로139길,3912,1986,1926
2019,1,A,골목상권,1000897,논현로123길,333,192,141
2019,1,A,골목상권,1000896,논현로115길,1176,658,518
2019,1,A,골목상권,1000895,논현로10길,1262,765,497
2019,1,A,골목상권,1000894,논현로106길,1094,678,416
2019,1,A,골목상권,1000893,남부순환로365길,616,389,227
2019,1,A,골목상권,1000892,개포로82길,195,98,97
2019,1,A,골목상권,1000891,개포로28길,863,571,292
2019,1,A,골목상권,1000890,개포로20길,1412,861,551
2019,1,A,골목상권,1000889,개포로17길,1134,679,455
2019,1,A,골목상권,1000888,강남대로140길,1455,762,693
2019,1,A,골목상권,1000887,강남대로136길,2216,1062,1154
2019,1,A,골목상권,1000886,강남대로118길,205,104,101
2019,1,A,골목상권,1000885,서초중앙로8길,4963,3101,1862
2019,1,A,골목상권,1000884,방배중앙로21길,508,316,192
2019,1,A,골목상권,1000883,효령로72길,1200,804,396
2019,1,A,골목상권,1000882,효령로34길,1100,651,449
2019,1,A,골목상권,1000881,효령로31길,2062,840,1222
2019,1,A,골목상권,1000880,효령로23길,853,455,398
2019,1,A,골목상권,1000879,청두곶길,626,363,263
2019,1,A,골목상권,1000878,주흥길,140,99,41
2019,1,A,골목상권,1000877,주흥15길,986,642,344
2019,1,A,골목상권,1000876,언남길,2069,1238,831
2019,1,A,골목상권,1000875,신반포로45길,1829,1175,654
2019,1,A,골목상권,1000874,서초대로8길,113,57,56
2019,1,A,골목상권,1000873,서초대로64길,1200,488,712
2019,1,A,골목상권,1000872,서초대로4길,976,623,353
2019,1,A,골목상권,1000871,서초대로25길,2284,1370,914
2019,1,A,골목상권,1000870,서초대로23길,1817,1017,800
2019,1,A,골목상권,1000869,서초대로15길,475,283,192
2019,1,A,골목상권,1000868,사평대로57길,184,97,87
2019,1,A,골목상권,1000867,사평대로26길,832,467,365
2019,1,A,골목상권,1000866,사평대로22길,1570,822,748
2019,1,A,골목상권,1000865,사임당로17길,1517,930,587
2019,1,A,골목상권,1000864,방배로42길,1401,1059,342
2019,1,A,골목상권,1000863,방배로35길,1616,1052,564
2019,1,A,골목상권,1000862,방배로18길,1631,811,820
2019,1,A,골목상권,1000861,반포대로9길,572,357,215
2019,1,A,골목상권,1000860,바우뫼로39길,2680,1675,1005
2019,1,A,골목상권,1000859,마방로2길,3566,2408,1158
2019,1,A,골목상권,1000858,방배천로4안길,778,443,335
2019,1,A,골목상권,1000857,동산로19길,1027,654,373
2019,1,A,골목상권,1000856,동산로10길,1766,854,912
2019,1,A,골목상권,1000855,동광로39길,705,349,356
2019,1,A,골목상권,1000854,동광로1길,1471,899,572
2019,1,A,골목상권,1000853,동광로12길,1171,582,589
2019,1,A,골목상권,1000852,논현로27길,2566,1675,891
2019,1,A,골목상권,1000851,논현로1길,1537,893,644
2019,1,A,골목상권,1000850,남부순환로339길,11681,5256,6425
2019,1,A,골목상권,1000849,남부순환로325길,1320,698,622
2019,1,A,골목상권,1000848,남부순환로317길,3467,2349,1118
2019,1,A,골목상권,1000847,고무래로8길,3715,1907,1808
2019,1,A,골목상권,1000846,강남대로8길,2349,1567,782
2019,1,A,골목상권,1000845,강남대로34길,1774,1234,540
2019,1,A,골목상권,1000844,강남대로23길,2739,1882,857
2019,1,A,골목상권,1000843,소담길,72,23,49
2019,1,A,골목상권,1000842,원신길,109,44,65
2019,1,A,골목상권,1000841,양지길,14,8,6
2019,1,A,골목상권,1000840,양산길,64,25,39
2019,1,A,골목상권,1000839,호암로24길,775,346,429
2019,1,A,골목상권,1000838,호암로20길,89,42,47
2019,1,A,골목상권,1000837,행운길,851,610,241
2019,1,A,골목상권,1000836,행운1길,514,247,267
2019,1,A,골목상권,1000835,청림3길,273,123,150
2019,1,A,골목상권,1000834,청룡길,471,291,180
2019,1,A,골목상권,1000833,청룡8길,234,96,138
2019,1,A,골목상권,1000832,중앙길,157,49,108
2019,1,A,골목상권,1000831,조원중앙로2길,1122,778,344
2019,1,A,골목상권,1000830,조원로18길,374,192,182
2019,1,A,골목상권,1000829,조원로10길,510,261,249
2019,1,A,골목상권,1000828,장군봉2길,290,128,162
2019,1,A,골목상권,1000827,장군봉1길,527,241,286
2019,1,A,골목상권,1000826,인헌길,71,43,28
2019,1,A,골목상권,1000825,은천로25길,100,51,49
2019,1,A,골목상권,1000824,양녕로6길,128,63,65
2019,1,A,골목상권,1000823,신원로3길,157,60,97
2019,1,A,골목상권,1000822,신사로20길,120,79,41
2019,1,A,골목상권,1000821,신림로65길,115,61,54
2019,1,A,골목상권,1000820,신림로64길,280,139,141
2019,1,A,골목상권,1000819,신림로48길,72,36,36
2019,1,A,골목상권,1000818,신림로38길,85,36,49
2019,1,A,골목상권,1000817,신림로28길,782,508,274
2019,1,A,골목상권,1000816,신림로11길,109,55,54
2019,1,A,골목상권,1000815,신림동길,230,123,107
2019,1,A,골목상권,1000814,승방길,678,452,226
2019,1,A,골목상권,1000813,서림7길,70,44,26
2019,1,A,골목상권,1000812,봉천로33길,303,117,186
2019,1,A,골목상권,1000811,봉천로13길,222,83,139
2019,1,A,골목상권,1000810,복은길,87,41,46
2019,1,A,골목상권,1000809,법원단지길,92,34,58
2019,1,A,골목상권,1000808,법원단지9길,42,20,22
2019,1,A,골목상권,1000807,미성5길,263,113,150
2019,1,A,골목상권,1000806,대학길,97,41,56
2019,1,A,골목상권,1000805,대학14길,20,7,13
2019,1,A,골목상권,1000804,당곡길,295,112,183
2019,1,A,골목상권,1000803,남현길,81,29,52
2019,1,A,골목상권,1000802,남현3길,241,102,139
2019,1,A,골목상권,1000801,남현2길,1320,684,636
2019,1,A,골목상권,1000800,남부순환로248길,431,195,236
2019,1,A,골목상권,1000799,남부순환로234길,297,109,188
2019,1,A,골목상권,1000798,남부순환로172길,732,344,388
2019,1,A,골목상권,1000797,남부순환로161길,551,235,316
2019,1,A,골목상권,1000796,남부순환로151길,488,212,276
2019,1,A,골목상권,1000795,남부순환로142길,415,187,228
2019,1,A,골목상권,1000794,난향길,183,55,128
2019,1,A,골목상권,1000793,난우길,304,165,139
2019,1,A,골목상권,1000792,난곡로74길,105,37,68
2019,1,A,골목상권,1000791,난곡로34길,132,48,84
2019,1,A,골목상권,1000790,난곡로26길,95,42,53
2019,1,A,골목상권,1000789,난곡로24길,74,22,52
2019,1,A,골목상권,1000788,낙성대역길,162,89,73
2019,1,A,골목상권,1000787,국회단지길,87,42,45
2019,1,A,골목상권,1000786,구암길,250,86,164
2019,1,A,골목상권,1000785,관천로22길,169,69,100
2019,1,A,골목상권,1000784,관천로15길,220,138,82
2019,1,A,골목상권,1000783,관악로30길,240,89,151
2019,1,A,골목상권,1000782,관악로28길,190,63,127
2019,1,A,골목상권,1000781,관악로14길,275,154,121
2019,1,A,골목상권,1000780,관악로10길,577,355,222
2019,1,A,골목상권,1000779,흑석로9길,118,56,62
2019,1,A,골목상권,1000778,흑석로13길,80,30,50
2019,1,A,골목상권,1000777,장승배기로27길,141,89,52
2019,1,A,골목상권,1000776,장승배기로19길,528,379,149
2019,1,A,골목상권,1000775,장승배기로10길,500,325,175
2019,1,A,골목상권,1000774,여의대방로46길,1325,584,741
2019,1,A,골목상권,1000773,여의대방로24길,1107,677,430
2019,1,A,골목상권,1000772,여의대방로22카길,330,169,161
2019,1,A,골목상권,1000771,여의대방로22나길,70,26,44
2019,1,A,골목상권,1000770,여의대방로22길,260,146,114
2019,1,A,골목상권,1000769,양녕로26길,137,46,91
2019,1,A,골목상권,1000768,신대방길,244,90,154
2019,1,A,골목상권,1000767,성대로29길,69,25,44
2019,1,A,골목상권,1000766,성대로1길,410,152,258
2019,1,A,골목상권,1000765,서달로8가길,137,60,77
2019,1,A,골목상권,1000764,서달로15길,170,59,111
2019,1,A,골목상권,1000763,서달로14길,23,12,11
2019,1,A,골목상권,1000762,서달로10길,25,13,12
2019,1,A,골목상권,1000761,상도로62길,515,204,311
2019,1,A,골목상권,1000760,상도로61길,357,157,200
2019,1,A,골목상권,1000759,상도로47길,221,156,65
2019,1,A,골목상권,1000758,상도로37길,199,88,111
2019,1,A,골목상권,1000757,상도로15길,452,203,249
2019,1,A,골목상권,1000756,사당로8길,163,83,80
2019,1,A,골목상권,1000755,사당로30길,474,257,217
2019,1,A,골목상권,1000754,사당로2차길,343,236,107
2019,1,A,골목상권,1000753,사당로29길,181,112,69
2019,1,A,골목상권,1000752,사당로26길,208,94,114
2019,1,A,골목상권,1000751,사당로23나길,133,108,25
2019,1,A,골목상권,1000750,사당로23길,72,18,54
2019,1,A,골목상권,1000749,사당로20길,99,55,44
2019,1,A,골목상권,1000748,사당로16길,274,185,89
2019,1,A,골목상권,1000747,사당로16가길,169,73,96
2019,1,A,골목상권,1000746,만양로8길,237,80,157
2019,1,A,골목상권,1000745,만양로14길,168,95,73
2019,1,A,골목상권,1000744,등용로14길,407,209,198
2019,1,A,골목상권,1000743,동작대로7길,370,158,212
2019,1,A,골목상권,1000742,동작대로35길,869,88,781
2019,1,A,골목상권,1000741,동작대로33길,340,183,157
2019,1,A,골목상권,1000740,동작대로29길,255,56,199
2019,1,A,골목상권,1000739,동작대로17길,760,429,331
2019,1,A,골목상권,1000738,대방동2길,405,185,220
2019,1,A,골목상권,1000737,대방동27길,225,169,56
2019,1,A,골목상권,1000736,노량진로6길,90,41,49
2019,1,A,골목상권,1000735,국사봉길,281,78,203
2019,1,A,골목상권,1000734,국사봉2길,55,34,21
2019,1,A,골목상권,1000733,국사봉1길,182,71,111
2019,1,A,골목상권,1000732,영신로9길,325,200,125
2019,1,A,골목상권,1000731,영등포로84길,1150,316,834
2019,1,A,골목상권,1000730,영등포로80길,64,35,29
2019,1,A,골목상권,1000729,영등포로62길,231,107,124
2019,1,A,골목상권,1000728,영등포로35길,547,317,230
2019,1,A,골목상권,1000727,영등포로27길,492,278,214
2019,1,A,골목상권,1000726,영등포로25길,556,370,186
2019,1,A,골목상권,1000725,여의대방로61길,438,313,125
2019,1,A,골목상권,1000724,여의대방로43나길,912,623,289
2019,1,A,골목상권,1000723,여의대방로39길,178,106,72
2019,1,A,골목상권,1000722,여의대방로35길,363,187,176
2019,1,A,골목상권,1000721,양평로28길,753,535,218
2019,1,A,골목상권,1000720,양평로22라길,1980,1233,747
2019,1,A,골목상권,1000719,양평로19길,5726,4125,1601
2019,1,A,골목상권,1000718,신길로60길,136,58,78
2019,1,A,골목상권,1000717,신길로42길,214,77,137
2019,1,A,골목상권,1000716,신길로42가길,67,25,42
2019,1,A,골목상권,1000715,신길로39길,178,61,117
2019,1,A,골목상권,1000714,신길로17길,217,115,102
2019,1,A,골목상권,1000713,선유서로28길,221,127,94
2019,1,A,골목상권,1000712,선유서로25길,2709,1532,1177
2019,1,A,골목상권,1000711,선유서로24길,497,284,213
2019,1,A,골목상권,1000710,선유로55길,795,423,372
2019,1,A,골목상권,1000709,디지털로74길,88,55,33
2019,1,A,골목상권,1000708,디지털로57길,207,86,121
2019,1,A,골목상권,1000707,디지털로37길,269,116,153
2019,1,A,골목상권,1000706,도신로62길,77,45,32
2019,1,A,골목상권,1000705,도신로60길,239,89,150
2019,1,A,골목상권,1000704,도신로29길,139,52,87
2019,1,A,골목상권,1000703,도신로15길,510,298,212
2019,1,A,골목상권,1000702,도림천로21길,210,138,72
2019,1,A,골목상권,1000701,도림로63길,75,41,34
2019,1,A,골목상권,1000700,도림로147길,689,494,195
2019,1,A,골목상권,1000699,도림로112길,125,69,56
2019,1,A,골목상권,1000698,대림로8길,473,207,266
2019,1,A,골목상권,1000697,대림로7길,122,64,58
2019,1,A,골목상권,1000696,대림로44길,612,298,314
2019,1,A,골목상권,1000695,대림로34길,453,257,196
2019,1,A,골목상권,1000694,대림로31길,1091,551,540
2019,1,A,골목상권,1000693,대림로29길,1199,673,526
2019,1,A,골목상권,1000692,대림로22길,131,62,69
2019,1,A,골목상권,1000691,당산로46길,2976,1859,1117
2019,1,A,골목상권,1000690,당산로38길,1156,757,399
2019,1,A,골목상권,1000689,당산로37길,14894,6860,8034
2019,1,A,골목상권,1000688,당산로31길,1503,917,586
2019,1,A,골목상권,1000687,국회대로56길,3178,1840,1338
2019,1,A,골목상권,1000686,경인로90길,547,414,133
2019,1,A,골목상권,1000685,경인로80길,1766,1254,512
2019,1,A,골목상권,1000684,경인로77길,1318,881,437
2019,1,A,골목상권,1000683,가마산로61길,117,82,35
2019,1,A,골목상권,1000682,시흥대로94길,294,118,176
2019,1,A,골목상권,1000681,시흥대로84길,133,71,62
2019,1,A,골목상권,1000680,시흥대로68길,1287,321,966
2019,1,A,골목상권,1000679,시흥대로63길,2087,1051,1036
2019,1,A,골목상권,1000678,시흥대로62가길,131,33,98
2019,1,A,골목상권,1000677,시흥대로36길,277,137,140
2019,1,A,골목상권,1000676,시흥대로22길,323,190,133
2019,1,A,골목상권,1000675,시흥대로153길,195,80,115
2019,1,A,골목상권,1000674,시흥대로150길,220,103,117
2019,1,A,골목상권,1000673,시흥대로141길,637,341,296
2019,1,A,골목상권,1000672,시흥대로138길,395,255,140
2019,1,A,골목상권,1000671,시흥대로120길,315,115,200
2019,1,A,골목상권,1000670,벚꽃로56길,356,286,70
2019,1,A,골목상권,1000669,범안로17길,903,631,272
2019,1,A,골목상권,1000668,범안로11길,3300,2210,1090
2019,1,A,골목상권,1000667,문성로5길,216,105,111
2019,1,A,골목상권,1000666,독산로85길,90,37,53
2019,1,A,골목상권,1000665,독산로78다길,111,51,60
2019,1,A,골목상권,1000664,독산로70길,175,62,113
2019,1,A,골목상권,1000663,독산로64길,306,187,119
2019,1,A,골목상권,1000662,독산로50길,109,51,58
2019,1,A,골목상권,1000661,독산로40길,208,81,127
2019,1,A,골목상권,1000660,독산로108길,1855,1493,362
2019,1,A,골목상권,1000659,남부순환로112길,272,154,118
2019,1,A,골목상권,1000658,금하로24길,57,12,45
2019,1,A,골목상권,1000657,금하로1길,156,73,83
2019,1,A,골목상권,1000656,금하로14길,80,47,33
2019,1,A,골목상권,1000655,가산로5길,664,460,204
2019,1,A,골목상권,1000654,가산로3길,1487,1165,322
2019,1,A,골목상권,1000653,중앙로1길,1556,955,601
2019,1,A,골목상권,1000652,중앙로15길,133,72,61
2019,1,A,골목상권,1000651,우마길,36,26,10
2019,1,A,골목상권,1000650,오류로8길,489,190,299
2019,1,A,골목상권,1000649,신도림로13길,406,254,152
2019,1,A,골목상권,1000648,새말로18길,560,342,218
2019,1,A,골목상권,1000647,부일로1길,499,419,80
2019,1,A,골목상권,1000646,부일로15길,174,109,65
2019,1,A,골목상권,1000645,부일로11길,242,111,131
2019,1,A,골목상권,1000644,디지털로32길,1383,588,795
2019,1,A,골목상권,1000643,디지털로32가길,2405,1146,1259
2019,1,A,골목상권,1000642,디지털로27길,66,33,33
2019,1,A,골목상권,1000641,도림로6길,301,109,192
2019,1,A,골목상권,1000640,도림로12길,63,22,41
2019,1,A,골목상권,1000639,남부순환로97길,151,49,102
2019,1,A,골목상권,1000638,구로중앙로8길,137,47,90
2019,1,A,골목상권,1000637,구로중앙로7길,198,83,115
2019,1,A,골목상권,1000636,구로중앙로42길,394,294,100
2019,1,A,골목상권,1000635,구로중앙로34길,215,159,56
2019,1,A,골목상권,1000634,구로중앙로28길,1007,601,406
2019,1,A,골목상권,1000633,구로중앙로19길,362,177,185
2019,1,A,골목상권,1000632,구로동로8길,256,73,183
2019,1,A,골목상권,1000631,구로동로7길,138,77,61
2019,1,A,골목상권,1000630,구로동로42길,200,98,102
2019,1,A,골목상권,1000629,구로동로41길,197,82,115
2019,1,A,골목상권,1000628,구로동로38길,348,105,243
2019,1,A,골목상권,1000627,구로동로28길,57,21,36
2019,1,A,골목상권,1000626,구로동로15길,101,51,50
2019,1,A,골목상권,1000625,공원로6가길,1325,864,461
2019,1,A,골목상권,1000624,고척로52길,90,45,45
2019,1,A,골목상권,1000623,고척로27다길,105,32,73
2019,1,A,골목상권,1000622,고척로27길,202,105,97
2019,1,A,골목상권,1000621,고척로21나길,194,89,105
2019,1,A,골목상권,1000620,경인로47길,661,183,478
2019,1,A,골목상권,1000619,경인로35길,251,91,160
2019,1,A,골목상권,1000618,경인로31길,117,37,80
2019,1,A,골목상권,1000617,경인로15길,281,130,151
2019,1,A,골목상권,1000616,개봉로3길,267,130,137
2019,1,A,골목상권,1000615,개봉로2길,3645,2157,1488
2019,1,A,골목상권,1000614,개봉로23가길,857,511,346
2019,1,A,골목상권,1000613,개봉로20길,453,189,264
2019,1,A,골목상권,1000612,개봉로1길,67,40,27
2019,1,A,골목상권,1000611,개봉로17다길,194,73,121
2019,1,A,골목상권,1000610,개봉로17길,104,48,56
2019,1,A,골목상권,1000609,개봉로11길,122,39,83
2019,1,A,골목상권,1000608,화곡로64길,787,442,345
2019,1,A,골목상권,1000607,화곡로59길,376,174,202
2019,1,A,골목상권,1000606,화곡로44나길,1075,841,234
2019,1,A,골목상권,1000605,화곡로31길,399,148,251
2019,1,A,골목상권,1000604,화곡로20길,556,271,285
2019,1,A,골목상권,1000603,화곡로13길,203,86,117
2019,1,A,골목상권,1000602,초원로16길,298,95,203
2019,1,A,골목상권,1000601,초록마을로8길,97,24,73
2019,1,A,골목상권,1000600,초록마을로3길,251,107,144
2019,1,A,골목상권,1000599,월정로20길,138,71,67
2019,1,A,골목상권,1000598,우장산로6길,241,104,137
2019,1,A,골목상권,1000597,양천로73가길,630,439,191
2019,1,A,골목상권,1000596,양천로71길,271,99,172
2019,1,A,골목상권,1000595,양천로49길,770,492,278
2019,1,A,골목상권,1000594,양천로26길,279,158,121
2019,1,A,골목상권,1000593,양천로24길,266,88,178
2019,1,A,골목상권,1000592,양천로24가길,372,143,229
2019,1,A,골목상권,1000591,양천로14길,257,114,143
2019,1,A,골목상권,1000590,방화대로6라길,772,497,275
2019,1,A,골목상권,1000589,방화대로21길,581,427,154
2019,1,A,골목상권,1000588,등촌로5길,306,146,160
2019,1,A,골목상권,1000587,등촌로55길,428,274,154
2019,1,A,골목상권,1000586,등촌로51길,300,169,131
2019,1,A,골목상권,1000585,등촌로39길,403,142,261
2019,1,A,골목상권,1000584,등촌로13길,131,80,51
2019,1,A,골목상권,1000583,남부순환로11길,441,299,142
2019,1,A,골목상권,1000582,까치산로4길,164,55,109
2019,1,A,골목상권,1000581,국회대로7길,452,263,189
2019,1,A,골목상권,1000580,공항대로8길,427,204,223
2019,1,A,골목상권,1000579,공항대로61길,335,255,80
2019,1,A,골목상권,1000578,공항대로59다길,895,496,399
2019,1,A,골목상권,1000577,공항대로59길,1296,819,477
2019,1,A,골목상권,1000576,공항대로55길,911,594,317
2019,1,A,골목상권,1000575,공항대로42길,501,306,195
2019,1,A,골목상권,1000574,공항대로38길,605,299,306
2019,1,A,골목상권,1000573,곰달래로60길,412,220,192
2019,1,A,골목상권,1000572,곰달래로53길,136,49,87
2019,1,A,골목상권,1000571,곰달래로47길,85,43,42
2019,1,A,골목상권,1000570,곰달래로31길,142,74,68
2019,1,A,골목상권,1000569,곰달래로25길,345,168,177
2019,1,A,골목상권,1000568,개화동로25길,210,131,79
2019,1,A,골목상권,1000567,개화동로23길,762,549,213
2019,1,A,골목상권,1000566,강서로8길,616,217,399
2019,1,A,골목상권,1000565,강서로5라길,657,389,268
2019,1,A,골목상권,1000564,강서로5나길,185,102,83
2019,1,A,골목상권,1000563,강서로5가길,461,209,252
2019,1,A,골목상권,1000562,강서로47라길,181,64,117
2019,1,A,골목상권,1000561,강서로47길,314,117,197
2019,1,A,골목상권,1000560,강서로45다길,220,90,130
2019,1,A,골목상권,1000559,강서로45길,216,83,133
2019,1,A,골목상권,1000558,강서로35길,95,33,62
2019,1,A,골목상권,1000557,강서로29길,290,128,162
2019,1,A,골목상권,1000556,강서로18길,138,54,84
2019,1,A,골목상권,1000555,강서로17가길,192,68,124
2019,1,A,골목상권,1000554,강서로15길,416,206,210
2019,1,A,골목상권,1000553,가로공원로80길,265,109,156
2019,1,A,골목상권,1000552,가로공원로76가길,132,66,66
2019,1,A,골목상권,1000551,화곡로4길,417,145,272
2019,1,A,골목상권,1000550,화곡로3길,246,104,142
2019,1,A,골목상권,1000549,지양로7길,215,82,133
2019,1,A,골목상권,1000548,중앙로55길,167,77,90
2019,1,A,골목상권,1000547,중앙로51길,165,67,98
2019,1,A,골목상권,1000546,중앙로47길,37,9,28
2019,1,A,골목상권,1000545,중앙로45길,177,67,110
2019,1,A,골목상권,1000544,중앙로36길,272,118,154
2019,1,A,골목상권,1000543,중앙로32길,614,278,336
2019,1,A,골목상권,1000542,중앙로25길,185,70,115
2019,1,A,골목상권,1000541,은행정로7길,568,206,362
2019,1,A,골목상권,1000540,은행정로5길,349,160,189
2019,1,A,골목상권,1000539,오목로5길,226,77,149
2019,1,A,골목상권,1000538,오목로3길,381,293,88
2019,1,A,골목상권,1000537,오목로30길,344,165,179
2019,1,A,골목상권,1000536,오목로23길,296,147,149
2019,1,A,골목상권,1000535,신월로20길,119,63,56
2019,1,A,골목상권,1000534,신월로15길,367,136,231
2019,1,A,골목상권,1000533,신목로6길,437,219,218
2019,1,A,골목상권,1000532,신목로5길,263,115,148
2019,1,A,골목상권,1000531,신목로2길,160,83,77
2019,1,A,골목상권,1000530,목동중앙서로8가길,347,178,169
2019,1,A,골목상권,1000529,목동중앙서로7길,188,82,106
2019,1,A,골목상권,1000528,목동중앙북로8길,172,64,108
2019,1,A,골목상권,1000527,목동중앙북로16길,51,22,29
2019,1,A,골목상권,1000526,목동중앙본로7길,233,115,118
2019,1,A,골목상권,1000525,목동중앙로3길,50,17,33
2019,1,A,골목상권,1000524,목동중앙로13나길,258,177,81
2019,1,A,골목상권,1000523,목동중앙남로3가길,513,189,324
2019,1,A,골목상권,1000522,목동로9길,1421,878,543
2019,1,A,골목상권,1000521,목동로19길,417,145,272
2019,1,A,골목상권,1000520,목동동로8길,196,79,117
2019,1,A,골목상권,1000519,목동동로12길,571,240,331
2019,1,A,골목상권,1000518,목동남로4길,274,132,142
2019,1,A,골목상권,1000517,남부순환로88길,568,461,107
2019,1,A,골목상권,1000516,남부순환로79길,254,115,139
2019,1,A,골목상권,1000515,남부순환로70길,335,160,175
2019,1,A,골목상권,1000514,남부순환로58길,244,146,98
2019,1,A,골목상권,1000513,남부순환로40길,143,54,89
2019,1,A,골목상권,1000512,남부순환로33길,133,57,76
2019,1,A,골목상권,1000511,곰달래로5길,270,159,111
2019,1,A,골목상권,1000510,곰달래로3길,305,141,164
2019,1,A,골목상권,1000509,곰달래로2길,492,256,236
2019,1,A,골목상권,1000508,곰달래로10길,727,583,144
2019,1,A,골목상권,1000507,가로공원로58길,72,16,56
2019,1,A,골목상권,1000506,효창원로93길,775,436,339
2019,1,A,골목상권,1000505,토정로37길,457,230,227
2019,1,A,골목상권,1000504,월드컵로8길,1505,790,715
2019,1,A,골목상권,1000503,월드컵로7길,728,471,257
2019,1,A,골목상권,1000502,월드컵로36길,577,318,259
2019,1,A,골목상권,1000501,월드컵로25길,304,131,173
2019,1,A,골목상권,1000500,월드컵로19길,694,318,376
2019,1,A,골목상권,1000499,월드컵로16길,2793,1491,1302
2019,1,A,골목상권,1000498,월드컵로11길,515,178,337
2019,1,A,골목상권,1000497,월드컵로10길,1785,951,834
2019,1,A,골목상권,1000496,와우산로3길,328,180,148
2019,1,A,골목상권,1000495,와우산로29길,375,221,154
2019,1,A,골목상권,1000494,와우산로29가길,1165,743,422
2019,1,A,골목상권,1000493,양화진길,1079,647,432
2019,1,A,골목상권,1000492,양화로1길,768,408,360
2019,1,A,골목상권,1000491,양화로11길,2503,936,1567
2019,1,A,골목상권,1000490,신촌로30길,57,28,29
2019,1,A,골목상권,1000489,신촌로28가길,34,8,26
2019,1,A,골목상권,1000488,신촌로12길,573,316,257
2019,1,A,골목상권,1000487,숭문길,3813,2815,998
2019,1,A,골목상권,1000486,숭문8길,75,35,40
2019,1,A,골목상권,1000485,성지3길,485,273,212
2019,1,A,골목상권,1000484,성산로4길,1594,851,743
2019,1,A,골목상권,1000483,성미산로32길,252,135,117
2019,1,A,골목상권,1000482,성미산로1길,673,433,240
2019,1,A,골목상권,1000481,성미산로11길,2453,1874,579
2019,1,A,골목상권,1000480,백범로16길,3061,2199,862
2019,1,A,골목상권,1000479,방울내로9안길,345,190,155
2019,1,A,골목상권,1000478,모래내로7길,1080,977,103
2019,1,A,골목상권,1000477,매봉산로2길,1373,865,508
2019,1,A,골목상권,1000476,망원로2길,379,214,165
2019,1,A,골목상권,1000475,망원로11길,275,136,139
2019,1,A,골목상권,1000474,만리재옛길,1933,917,1016
2019,1,A,골목상권,1000473,마포대로4길,1940,1267,673
2019,1,A,골목상권,1000472,마포대로20길,822,352,470
2019,1,A,골목상권,1000471,마포대로12길,470,177,293
2019,1,A,골목상권,1000470,동교로38길,1036,568,468
2019,1,A,골목상권,1000469,동교로27길,1815,970,845
2019,1,A,골목상권,1000468,동교로25길,1992,1100,892
2019,1,A,골목상권,1000467,동교로19길,2239,1414,825
2019,1,A,골목상권,1000466,동교로17길,939,539,400
2019,1,A,골목상권,1000465,독막로8길,786,476,310
2019,1,A,골목상권,1000464,독막로32길,245,102,143
2019,1,A,골목상권,1000463,독막로22길,295,95,200
2019,1,A,골목상권,1000462,도화길,371,167,204
2019,1,A,골목상권,1000461,도화4길,453,184,269
2019,1,A,골목상권,1000460,대흥로28길,162,97,65
2019,1,A,골목상권,1000459,대흥로21길,310,142,168
2019,1,A,골목상권,1000458,광성로6길,608,321,287
2019,1,A,골목상권,1000457,홍제내길,272,150,122
2019,1,A,골목상권,1000456,홍연길,145,92,53
2019,1,A,골목상권,1000455,통일로39길,159,68,91
2019,1,A,골목상권,1000454,통일로37길,239,82,157
2019,1,A,골목상권,1000453,통일로11길,120,51,69
2019,1,A,골목상권,1000452,충정로6길,4645,2804,1841
2019,1,A,골목상권,1000451,충정로4길,5040,3125,1915
2019,1,A,골목상권,1000450,증가로6길,359,258,101
2019,1,A,골목상권,1000449,증가로23나길,405,186,219
2019,1,A,골목상권,1000448,증가로20가길,353,104,249
2019,1,A,골목상권,1000447,증가로10길,255,129,126
2019,1,A,골목상권,1000446,응암로1길,681,401,280
2019,1,A,골목상권,1000445,연희로10길,175,77,98
2019,1,A,골목상권,1000444,신촌로37길,87,43,44
2019,1,A,골목상권,1000443,수색로8길,342,235,107
2019,1,A,골목상권,1000442,세무서길,294,90,204
2019,1,A,골목상권,1000441,세무서2길,446,204,242
2019,1,A,골목상권,1000440,세검정로1길,294,85,209
2019,1,A,골목상권,1000439,북아현로4길,422,85,337
2019,1,A,골목상권,1000438,모래내로15길,351,145,206
2019,1,A,골목상권,1000437,명지대길,428,297,131
2019,1,A,골목상권,1000436,독립문로8길,326,131,195
2019,1,A,골목상권,1000435,가재울로6길,246,121,125
2019,1,A,골목상권,1000434,통일로92길,82,28,54
2019,1,A,골목상권,1000433,통일로87길,310,169,141
2019,1,A,골목상권,1000432,통일로78길,92,40,52
2019,1,A,골목상권,1000431,통일로69길,57,14,43
2019,1,A,골목상권,1000430,진흥로1길,284,117,167
2019,1,A,골목상권,1000429,진흥로12길,209,80,129
2019,1,A,골목상권,1000428,증산서길,634,472,162
2019,1,A,골목상권,1000427,증산로9길,174,96,78
2019,1,A,골목상권,1000426,증산로5길,342,223,119
2019,1,A,골목상권,1000425,증산로21길,209,93,116
2019,1,A,골목상권,1000424,증산로17길,443,156,287
2019,1,A,골목상권,1000423,증산로15길,256,138,118
2019,1,A,골목상권,1000422,증산로13길,328,243,85
2019,1,A,골목상권,1000421,응암로34길,215,79,136
2019,1,A,골목상권,1000420,응암로22길,145,74,71
2019,1,A,골목상권,1000419,응암로14길,174,62,112
2019,1,A,골목상권,1000418,응암로13길,218,99,119
2019,1,A,골목상권,1000417,응암로12길,125,56,69
2019,1,A,골목상권,1000416,은평로8길,184,75,109
2019,1,A,골목상권,1000415,은평로3길,257,131,126
2019,1,A,골목상권,1000414,은평로20길,28,7,21
2019,1,A,골목상권,1000413,은평로13길,904,436,468
2019,1,A,골목상권,1000412,은평로10길,259,117,142
2019,1,A,골목상권,1000411,연서로5길,276,137,139
2019,1,A,골목상권,1000410,연서로41길,194,54,140
2019,1,A,골목상권,1000409,연서로3길,120,46,74
2019,1,A,골목상권,1000408,연서로34길,133,41,92
2019,1,A,골목상권,1000407,연서로33길,57,13,44
2019,1,A,골목상권,1000406,연서로29길,139,68,71
2019,1,A,골목상권,1000405,연서로28길,353,190,163
2019,1,A,골목상권,1000404,연서로27길,389,117,272
2019,1,A,골목상권,1000403,연서로21길,292,126,166
2019,1,A,골목상권,1000402,연서로17길,587,231,356
2019,1,A,골목상권,1000401,연서로16길,315,160,155
2019,1,A,골목상권,1000400,연서로13길,197,42,155
2019,1,A,골목상권,1000399,연서로11길,158,80,78
2019,1,A,골목상권,1000398,역말로9길,143,75,68
2019,1,A,골목상권,1000397,수색로18길,190,110,80
2019,1,A,골목상권,1000396,서오릉로8길,161,72,89
2019,1,A,골목상권,1000395,서오릉로21길,81,15,66
2019,1,A,골목상권,1000394,불광천길,298,110,188
2019,1,A,골목상권,1000393,갈현로7길,176,82,94
2019,1,A,골목상권,1000392,갈현로41길,82,21,61
2019,1,A,골목상권,1000391,갈현로33길,188,77,111
2019,1,A,골목상권,1000390,갈현로1길,133,63,70
2019,1,A,골목상권,1000389,가좌로7길,269,124,145
2019,1,A,골목상권,1000388,한글비석로44길,338,149,189
2019,1,A,골목상권,1000387,한글비석로24길,291,117,174
2019,1,A,골목상권,1000386,한글비석로22길,397,152,245
2019,1,A,골목상권,1000385,석계로1길,253,92,161
2019,1,A,골목상권,1000384,상계로9가길,276,129,147
2019,1,A,골목상권,1000383,상계로1길,199,64,135
2019,1,A,골목상권,1000382,상계로12길,271,145,126
2019,1,A,골목상권,1000381,동일로242길,1271,885,386
2019,1,A,골목상권,1000380,동일로192길,651,353,298
2019,1,A,골목상권,1000379,동일로173가길,1373,860,513
2019,1,A,골목상권,1000378,공릉로58길,280,112,168
2019,1,A,골목상권,1000377,해등로16길,183,98,85
2019,1,A,골목상권,1000376,우이천로4다길,169,67,102
2019,1,A,골목상권,1000375,우이천로32길,199,97,102
2019,1,A,골목상권,1000374,시루봉로23길,253,136,117
2019,1,A,골목상권,1000373,삼양로144길,186,68,118
2019,1,A,골목상권,1000372,방학로6가길,272,96,176
2019,1,A,골목상권,1000371,방학로5길,224,89,135
2019,1,A,골목상권,1000370,방학로15길,214,161,53
2019,1,A,골목상권,1000369,방학로10길,135,43,92
2019,1,A,골목상권,1000368,도봉산길,217,103,114
2019,1,A,골목상권,1000367,도봉산4길,70,42,28
2019,1,A,골목상권,1000366,도봉로181길,164,82,82
2019,1,A,골목상권,1000365,도봉로169나길,346,201,145
2019,1,A,골목상권,1000364,도봉로156길,204,106,98
2019,1,A,골목상권,1000363,도봉로152가길,411,322,89
2019,1,A,골목상권,1000362,도봉로147길,327,108,219
2019,1,A,골목상권,1000361,도봉로143길,282,145,137
2019,1,A,골목상권,1000360,도봉로114길,843,345,498
2019,1,A,골목상권,1000359,도봉로109길,269,178,91
2019,1,A,골목상권,1000358,도당로29길,228,94,134
2019,1,A,골목상권,1000357,도당로19길,104,41,63
2019,1,A,골목상권,1000356,도당로13바길,137,44,93
2019,1,A,골목상권,1000355,도당로13가길,80,32,48
2019,1,A,골목상권,1000354,덕릉로60길,119,69,50
2019,1,A,골목상권,1000353,노해로63다길,114,48,66
2019,1,A,골목상권,1000352,노해로60길,389,168,221
2019,1,A,골목상권,1000351,한천로140길,82,40,42
2019,1,A,골목상권,1000350,한천로139가길,134,53,81
2019,1,A,골목상권,1000349,한천로132길,358,147,211
2019,1,A,골목상권,1000348,한천로130길,82,30,52
2019,1,A,골목상권,1000347,한천로124나길,187,68,119
2019,1,A,골목상권,1000346,한천로109길,798,416,382
2019,1,A,골목상권,1000345,인수봉로79길,146,56,90
2019,1,A,골목상권,1000344,인수봉로72길,89,29,60
2019,1,A,골목상권,1000343,인수봉로56길,245,209,36
2019,1,A,골목상권,1000342,오패산로67길,436,220,216
2019,1,A,골목상권,1000341,오패산로52길,31,17,14
2019,1,A,골목상권,1000340,오패산로30길,130,61,69
2019,1,A,골목상권,1000339,수유로12길,446,308,138
2019,1,A,골목상권,1000338,솔샘로65길,318,124,194
2019,1,A,골목상권,1000337,솔매로50길,941,398,543
2019,1,A,골목상권,1000336,솔매로45길,189,85,104
2019,1,A,골목상권,1000335,솔매로41길,99,41,58
2019,1,A,골목상권,1000334,삼양로93길,116,50,66
2019,1,A,골목상권,1000333,삼양로77길,376,137,239
2019,1,A,골목상권,1000332,삼양로54길,76,32,44
2019,1,A,골목상권,1000331,삼양로41길,291,170,121
2019,1,A,골목상권,1000330,삼양로27길,152,50,102
2019,1,A,골목상권,1000329,삼양로24길,65,33,32
2019,1,A,골목상권,1000328,삼양로20길,51,33,18
2019,1,A,골목상권,1000327,삼각산로28길,93,40,53
2019,1,A,골목상권,1000326,도봉로99길,122,71,51
2019,1,A,골목상권,1000325,도봉로8길,27,17,10
2019,1,A,골목상권,1000324,도봉로76길,523,210,313
2019,1,A,골목상권,1000323,도봉로67길,223,71,152
2019,1,A,골목상권,1000322,도봉로45길,286,110,176
2019,1,A,골목상권,1000321,도봉로18길,153,89,64
2019,1,A,골목상권,1000320,도봉로13길,57,29,28
2019,1,A,골목상권,1000319,덕릉로41길,320,86,234
2019,1,A,골목상권,1000318,덕릉로40길,373,190,183
2019,1,A,골목상권,1000317,노해로33길,71,25,46
2019,1,A,골목상권,1000316,노해로23길,127,62,65
2019,1,A,골목상권,1000315,노해로17길,194,90,104
2019,1,A,골목상권,1000314,화랑로40길,293,165,128
2019,1,A,골목상권,1000313,화랑로32길,216,129,87
2019,1,A,골목상권,1000312,화랑로1길,327,187,140
2019,1,A,골목상권,1000311,화랑로19길,187,92,95
2019,1,A,골목상권,1000310,화랑로14길,278,118,160
2019,1,A,골목상권,1000309,화랑로13길,374,149,225
2019,1,A,골목상권,1000308,한천로76길,487,364,123
2019,1,A,골목상권,1000307,한천로101가길,83,68,15
2019,1,A,골목상권,1000306,창경궁로43길,442,196,246
2019,1,A,골목상권,1000305,지봉로20길,571,316,255
2019,1,A,골목상권,1000304,종암로5길,307,126,181
2019,1,A,골목상권,1000303,종암로24가길,99,35,64
2019,1,A,골목상권,1000302,종암로21길,380,92,288
2019,1,A,골목상권,1000301,종암로19길,260,112,148
2019,1,A,골목상권,1000300,종암로16길,138,67,71
2019,1,A,골목상권,1000299,정릉로8길,496,402,94
2019,1,A,골목상권,1000298,정릉로27길,106,46,60
2019,1,A,골목상권,1000297,정릉로26길,140,55,85
2019,1,A,골목상권,1000296,장위로50길,299,124,175
2019,1,A,골목상권,1000295,장월로1길,184,72,112
2019,1,A,골목상권,1000294,인촌로6길,497,248,249
2019,1,A,골목상권,1000293,인촌로5길,62,36,26
2019,1,A,골목상권,1000292,인촌로24길,295,141,154
2019,1,A,골목상권,1000291,개운사길,362,197,165
2019,1,A,골목상권,1000290,인촌로1길,355,157,198
2019,1,A,골목상권,1000289,인촌로17가길,145,77,68
2019,1,A,골목상권,1000288,오패산로4길,731,264,467
2019,1,A,골목상권,1000287,오패산로3길,669,388,281
2019,1,A,골목상권,1000286,오패산로19길,224,118,106
2019,1,A,골목상권,1000285,안암로5길,474,280,194
2019,1,A,골목상권,1000284,아리랑로4길,797,360,437
2019,1,A,골목상권,1000283,솔샘로6길,56,25,31
2019,1,A,골목상권,1000282,성북로8길,554,183,371
2019,1,A,골목상권,1000281,삼양로8길,253,108,145
2019,1,A,골목상권,1000280,삼선교로16가길,742,432,310
2019,1,A,골목상권,1000279,삼선교로10다길,37,25,12
2019,1,A,골목상권,1000278,삼선교로10길,275,88,187
2019,1,A,골목상권,1000277,보문로32길,346,165,181
2019,1,A,골목상권,1000276,보문로31길,398,168,230
2019,1,A,골목상권,1000275,보문로26길,238,105,133
2019,1,A,골목상권,1000274,보문로13길,1136,731,405
2019,1,A,골목상권,1000273,보국문로16길,222,109,113
2019,1,A,골목상권,1000272,동소문로6길,106,40,66
2019,1,A,골목상권,1000271,동소문로2길,166,60,106
2019,1,A,골목상권,1000270,동소문로26가길,396,193,203
2019,1,A,골목상권,1000269,동소문로15길,316,168,148
2019,1,A,골목상권,1000268,동소문로13길,390,139,251
2019,1,A,골목상권,1000267,돌곶이로8길,111,59,52
2019,1,A,골목상권,1000266,돌곶이로41길,76,44,32
2019,1,A,골목상권,1000265,돌곶이로28길,322,148,174
2019,1,A,골목상권,1000264,돌곶이로27길,212,140,72
2019,1,A,골목상권,1000263,돌곶이로22길,84,45,39
2019,1,A,골목상권,1000262,돌곶이로14길,100,41,59
2019,1,A,골목상권,1000261,길음로7길,154,50,104
2019,1,A,골목상권,1000260,중랑천로10길,758,450,308
2019,1,A,골목상권,1000259,용마산로94길,145,86,59
2019,1,A,골목상권,1000258,용마산로118길,419,178,241
2019,1,A,골목상권,1000257,용마산로112길,439,175,264
2019,1,A,골목상권,1000256,용마산로100길,191,78,113
2019,1,A,골목상권,1000255,신내로7가길,241,62,179
2019,1,A,골목상권,1000254,사가정로54길,323,116,207
2019,1,A,골목상권,1000253,사가정로42길,160,65,95
2019,1,A,골목상권,1000252,봉화산로56길,1288,662,626
2019,1,A,골목상권,1000251,봉화산로4길,237,96,141
2019,1,A,골목상권,1000250,봉화산로30길,192,32,160
2019,1,A,골목상권,1000249,봉우재로33길,351,167,184
2019,1,A,골목상권,1000248,면목로78길,151,60,91
2019,1,A,골목상권,1000247,면목로56길,228,63,165
2019,1,A,골목상권,1000246,면목로55길,195,89,106
2019,1,A,골목상권,1000245,면목로49길,573,197,376
2019,1,A,골목상권,1000244,면목로48길,542,444,98
2019,1,A,골목상권,1000243,면목로45길,241,136,105
2019,1,A,골목상권,1000242,면목로33길,94,47,47
2019,1,A,골목상권,1000241,면목로21길,60,36,24
2019,1,A,골목상권,1000240,망우로73길,103,57,46
2019,1,A,골목상권,1000239,망우로68길,358,182,176
2019,1,A,골목상권,1000238,동일로163길,145,87,58
2019,1,A,골목상권,1000237,동일로157길,650,320,330
2019,1,A,골목상권,1000236,동일로149길,124,75,49
2019,1,A,골목상권,1000235,동일로140길,464,213,251
2019,1,A,골목상권,1000234,동일로139길,133,77,56
2019,1,A,골목상권,1000233,동일로139가길,1067,619,448
2019,1,A,골목상권,1000232,동일로130길,132,76,56
2019,1,A,골목상권,1000231,동일로123길,304,149,155
2019,1,A,골목상권,1000230,동일로112길,454,200,254
2019,1,A,골목상권,1000229,동일로101길,310,93,217
2019,1,A,골목상권,1000228,동일로100길,518,323,195
2019,1,A,골목상권,1000227,답십리로75길,93,53,40
2019,1,A,골목상권,1000226,공릉로2길,433,184,249
2019,1,A,골목상권,1000225,공릉로12가길,98,62,36
2019,1,A,골목상권,1000224,겸재로54길,169,60,109
2019,1,A,골목상권,1000223,겸재로36길,225,74,151
2019,1,A,골목상권,1000222,겸재로29길,236,97,139
2019,1,A,골목상권,1000221,휘경로3길,228,106,122
2019,1,A,골목상권,1000220,휘경로2길,240,112,128
2019,1,A,골목상권,1000219,휘경로23길,32,4,28
2019,1,A,골목상권,1000218,휘경로14길,96,28,68
2019,1,A,골목상권,1000217,한천로46길,116,63,53
2019,1,A,골목상권,1000216,한천로40길,165,97,68
2019,1,A,골목상권,1000215,한천로33길,443,155,288
2019,1,A,골목상권,1000214,한천로14길,1152,716,436
2019,1,A,골목상권,1000213,천호대로97길,752,536,216
2019,1,A,골목상권,1000212,천호대로77길,1168,580,588
2019,1,A,골목상권,1000211,천호대로45길,56,20,36
2019,1,A,골목상권,1000210,천호대로17길,1878,969,909
2019,1,A,골목상권,1000209,천호대로12길,322,165,157
2019,1,A,골목상권,1000208,천장산로7길,99,49,50
2019,1,A,골목상권,1000207,제기로5길,260,125,135
2019,1,A,골목상권,1000206,제기로21길,99,45,54
2019,1,A,골목상권,1000205,전농로4길,495,372,123
2019,1,A,골목상권,1000204,전농로3길,201,108,93
2019,1,A,골목상권,1000203,전농로29길,199,115,84
2019,1,A,골목상권,1000202,장한로8길,548,335,213
2019,1,A,골목상권,1000201,장한로5길,850,456,394
2019,1,A,골목상권,1000200,장한로27길,272,115,157
2019,1,A,골목상권,1000199,장한로27가길,342,147,195
2019,1,A,골목상권,1000198,장한로26길,424,140,284
2019,1,A,골목상권,1000197,장한로26가길,285,160,125
2019,1,A,골목상권,1000196,장한로25길,585,227,358
2019,1,A,골목상권,1000195,장한로14길,430,230,200
2019,1,A,골목상권,1000194,이문로42길,73,35,38
2019,1,A,골목상권,1000193,왕산로43길,843,341,502
2019,1,A,골목상권,1000192,왕산로33길,168,114,54
2019,1,A,골목상권,1000191,왕산로32길,114,59,55
2019,1,A,골목상권,1000190,약령시로17길,254,126,128
2019,1,A,골목상권,1000189,서울시립대로4길,358,200,158
2019,1,A,골목상권,1000188,서울시립대로29길,180,102,78
2019,1,A,골목상권,1000187,서울시립대로16길,166,57,109
2019,1,A,골목상권,1000186,사가정로2길,167,118,49
2019,1,A,골목상권,1000185,사가정로23가길,246,127,119
2019,1,A,골목상권,1000184,사가정로13길,250,101,149
2019,1,A,골목상권,1000183,무학로45길,314,191,123
2019,1,A,골목상권,1000182,무학로16길,1182,607,575
2019,1,A,골목상권,1000181,망우로21길,439,277,162
2019,1,A,골목상권,1000180,망우로18길,440,170,270
2019,1,A,골목상권,1000179,망우로18가길,23,13,10
2019,1,A,골목상권,1000178,답십리로72길,242,125,117
2019,1,A,골목상권,1000177,답십리로69길,930,429,501
2019,1,A,골목상권,1000176,답십리로68길,696,382,314
2019,1,A,골목상권,1000175,답십리로64길,347,219,128
2019,1,A,골목상권,1000174,답십리로63길,95,40,55
2019,1,A,골목상권,1000173,답십리로60길,536,312,224
2019,1,A,골목상권,1000172,답십리로56길,198,94,104
2019,1,A,골목상권,1000171,답십리로23길,89,59,30
2019,1,A,골목상권,1000170,난계로30길,5461,2369,3092
2019,1,A,골목상권,1000169,경희대로4길,147,63,84
2019,1,A,골목상권,1000168,경희대로3길,105,54,51
2019,1,A,골목상권,1000167,천호대로129길,293,114,179
2019,1,A,골목상권,1000166,천호대로123길,1171,536,635
2019,1,A,골목상권,1000165,천호대로109길,975,526,449
2019,1,A,골목상권,1000164,자양번영로3길,244,138,106
2019,1,A,골목상권,1000163,자양로53길,250,133,117
2019,1,A,골목상권,1000162,자양로50길,154,66,88
2019,1,A,골목상권,1000161,자양로45길,358,149,209
2019,1,A,골목상권,1000160,자양로26길,206,99,107
2019,1,A,골목상권,1000159,자양로15길,134,59,75
2019,1,A,골목상권,1000158,자양로11길,880,394,486
2019,1,A,골목상권,1000157,용마산로3길,604,317,287
2019,1,A,골목상권,1000156,용마산로21길,577,313,264
2019,1,A,골목상권,1000155,아차산로78길,1380,599,781
2019,1,A,골목상권,1000154,아차산로65길,534,277,257
2019,1,A,골목상권,1000153,아차산로55길,281,163,118
2019,1,A,골목상권,1000152,아차산로51길,349,130,219
2019,1,A,골목상권,1000151,아차산로40길,404,216,188
2019,1,A,골목상권,1000150,면목로17길,399,277,122
2019,1,A,골목상권,1000149,뚝섬로64길,227,115,112
2019,1,A,골목상권,1000148,뚝섬로58길,478,247,231
2019,1,A,골목상권,1000147,뚝섬로54길,157,83,74
2019,1,A,골목상권,1000146,뚝섬로48길,385,167,218
2019,1,A,골목상권,1000145,뚝섬로24길,259,132,127
2019,1,A,골목상권,1000144,뚝섬로23길,142,64,78
2019,1,A,골목상권,1000143,동일로24길,118,62,56
2019,1,A,골목상권,1000142,동일로18길,419,210,209
2019,1,A,골목상권,1000141,능동로4길,239,131,108
2019,1,A,골목상권,1000140,능동로3길,212,134,78
2019,1,A,골목상권,1000139,능동로34길,819,484,335
2019,1,A,골목상권,1000138,능동로19길,239,127,112
2019,1,A,골목상권,1000137,능동로13길,308,124,184
2019,1,A,골목상권,1000136,긴고랑로9길,356,156,200
2019,1,A,골목상권,1000135,긴고랑로8길,811,527,284
2019,1,A,골목상권,1000134,긴고랑로7길,346,189,157
2019,1,A,골목상권,1000133,긴고랑로20길,498,226,272
2019,1,A,골목상권,1000132,광나루로52길,398,198,200
2019,1,A,골목상권,1000131,광나루로40길,314,156,158
2019,1,A,골목상권,1000130,광나루로37길,100,38,62
2019,1,A,골목상권,1000129,광나루로36길,396,134,262
2019,1,A,골목상권,1000128,광나루로24길,215,118,97
2019,1,A,골목상권,1000127,광나루로12길,195,102,93
2019,1,A,골목상권,1000126,한림말길,470,172,298
2019,1,A,골목상권,1000125,한림말3길,332,165,167
2019,1,A,골목상권,1000124,청계천로10나길,5762,4131,1631
2019,1,A,골목상권,1000123,장터길,240,104,136
2019,1,A,골목상권,1000122,용답중앙길,361,244,117
2019,1,A,골목상권,1000121,용답29길,1334,779,555
2019,1,A,골목상권,1000120,왕십리로6길,5545,3231,2314
2019,1,A,골목상권,1000119,왕십리로31길,343,147,196
2019,1,A,골목상권,1000118,왕십리로26길,1785,1188,597
2019,1,A,골목상권,1000117,왕십리로21길,192,78,114
2019,1,A,골목상권,1000116,왕십리로14길,4319,2342,1977
2019,1,A,골목상권,1000115,아차산로5길,4273,2624,1649
2019,1,A,골목상권,1000114,아차산로15길,8949,5387,3562
2019,1,A,골목상권,1000113,아차산로11길,5637,3538,2099
2019,1,A,골목상권,1000112,송정4가길,399,168,231
2019,1,A,골목상권,1000111,송정12라길,180,103,77
2019,1,A,골목상권,1000110,성수일로6길,3304,1855,1449
2019,1,A,골목상권,1000109,성수이로7길,2336,1348,988
2019,1,A,골목상권,1000108,성수이로18길,4407,2605,1802
2019,1,A,골목상권,1000107,성덕정길,349,208,141
2019,1,A,골목상권,1000106,성덕정17길,637,404,233
2019,1,A,골목상권,1000105,서울숲2길,748,378,370
2019,1,A,골목상권,1000104,상원길,3915,2528,1387
2019,1,A,골목상권,1000103,상원12길,888,514,374
2019,1,A,골목상권,1000102,사근동길,112,66,46
2019,1,A,골목상권,1000101,무학봉길,147,61,86
2019,1,A,골목상권,1000100,무학봉28길,399,190,209
2019,1,A,골목상권,1000099,무학로6길,725,346,379
2019,1,A,골목상권,1000098,무수막길,209,96,113
2019,1,A,골목상권,1000097,매봉길,177,72,105
2019,1,A,골목상권,1000096,마조로1길,107,57,50
2019,1,A,골목상권,1000095,마조로16길,307,203,104
2019,1,A,골목상권,1000094,마장로39길,718,484,234
2019,1,A,골목상권,1000093,마장로27길,408,235,173
2019,1,A,골목상권,1000092,뚝섬로5길,3928,2375,1553
2019,1,A,골목상권,1000091,둘레9길,534,341,193
2019,1,A,골목상권,1000090,금호산길,304,114,190
2019,1,A,골목상권,1000089,금호산2길,26,15,11
2019,1,A,골목상권,1000088,고산자로6길,721,332,389
2019,1,A,골목상권,1000087,후암로28길,1018,511,507
2019,1,A,골목상권,1000086,효창원로39길,236,97,139
2019,1,A,골목상권,1000085,회나무로13길,237,107,130
2019,1,A,골목상권,1000084,한남대로20길,1036,528,508
2019,1,A,골목상권,1000083,한강대로88길,333,228,105
2019,1,A,골목상권,1000082,한강대로7길,1792,629,1163
2019,1,A,골목상권,1000081,한강대로62길,1132,513,619
2019,1,A,골목상권,1000080,한강대로52길,3331,2305,1026
2019,1,A,골목상권,1000079,한강대로43길,2117,1200,917
2019,1,A,골목상권,1000078,한강대로15길,913,454,459
2019,1,A,골목상권,1000077,한강대로104길,10510,2770,7740
2019,1,A,골목상권,1000076,청파로73길,285,146,139
2019,1,A,골목상권,1000075,청파로71길,1249,731,518
2019,1,A,골목상권,1000074,청파로47나길,226,144,82
2019,1,A,골목상권,1000073,청파로47길,642,300,342
2019,1,A,골목상권,1000072,장문로45길,207,103,104
2019,1,A,골목상권,1000071,이태원로54길,1630,916,714
2019,1,A,골목상권,1000070,이태원로27길,960,559,401
2019,1,A,골목상권,1000069,이촌로22길,231,132,99
2019,1,A,골목상권,1000068,원효로89길,1336,937,399
2019,1,A,골목상권,1000067,원효로53길,570,345,225
2019,1,A,골목상권,1000066,원효로41길,254,146,108
2019,1,A,골목상권,1000065,원효로19길,767,526,241
2019,1,A,골목상권,1000064,우사단로4길,76,45,31
2019,1,A,골목상권,1000063,우사단로14길,1702,879,823
2019,1,A,골목상권,1000062,우사단로10길,90,42,48
2019,1,A,골목상권,1000061,신흥로20길,235,105,130
2019,1,A,골목상권,1000060,소월로20길,95,48,47
2019,1,A,골목상권,1000059,서빙고로71길,449,260,189
2019,1,A,골목상권,1000058,백범로90길,2534,1735,799
2019,1,A,골목상권,1000057,백범로79길,869,527,342
2019,1,A,골목상권,1000056,두텁바위로1길,1204,767,437
2019,1,A,골목상권,1000055,대사관로34길,620,434,186
2019,1,A,골목상권,1000054,녹사평대로46길,355,176,179
2019,1,A,골목상권,1000053,녹사평대로40나길,402,233,169
2019,1,A,골목상권,1000052,녹사평대로32길,147,80,67
2019,1,A,골목상권,1000051,녹사평대로26길,379,226,153
2019,1,A,골목상권,1000050,녹사평대로11길,460,329,131
2019,1,A,골목상권,1000049,퇴계로90길,860,302,558
2019,1,A,골목상권,1000048,퇴계로8길,856,360,496
2019,1,A,골목상권,1000047,퇴계로56길,1332,829,503
2019,1,A,골목상권,1000046,퇴계로46길,1982,875,1107
2019,1,A,골목상권,1000045,퇴계로18길,1208,374,834
2019,1,A,골목상권,1000044,퇴계로12길,449,244,205
2019,1,A,골목상권,1000043,청구로1길,102,53,49
2019,1,A,골목상권,1000042,청구로17길,669,347,322
2019,1,A,골목상권,1000041,장충단로8길,890,520,370
2019,1,A,골목상권,1000040,삼일대로4길,3801,1992,1809
2019,1,A,골목상권,1000039,명동길,18565,9424,9141
2019,1,A,골목상권,1000038,동호로8길,487,248,239
2019,1,A,골목상권,1000037,동호로20길,1042,715,327
2019,1,A,골목상권,1000036,동호로15길,1963,907,1056
2019,1,A,골목상권,1000035,동호로11길,305,168,137
2019,1,A,골목상권,1000034,동호로10길,2116,1397,719
2019,1,A,골목상권,1000033,다산로39길,234,99,135
2019,1,A,골목상권,1000032,다산로38길,776,423,353
2019,1,A,골목상권,1000031,다산로36길,396,208,188
2019,1,A,골목상권,1000030,다산로33길,488,260,228
2019,1,A,골목상권,1000029,난계로21길,301,180,121
2019,1,A,골목상권,1000028,난계로11길,723,401,322
2019,1,A,골목상권,1000027,필운대로1길,609,363,246
2019,1,A,골목상권,1000026,평창길,510,207,303
2019,1,A,골목상권,1000025,통일로12길,89,36,53
2019,1,A,골목상권,1000024,창신길,168,22,146
2019,1,A,골목상권,1000023,창신5길,50,24,26
2019,1,A,골목상권,1000022,창신2길,120,56,64
2019,1,A,골목상권,1000021,창경궁로35길,485,344,141
2019,1,A,골목상권,1000020,지봉로8길,254,118,136
2019,1,A,골목상권,1000019,종로65길,227,106,121
2019,1,A,골목상권,1000018,종로58가길,331,152,179
2019,1,A,골목상권,1000017,종로24길,1898,1282,616
2019,1,A,골목상권,1000016,자하문로7길,457,223,234
2019,1,A,골목상권,1000015,이화장길,1158,567,591
2019,1,A,골목상권,1000014,율곡로16길,567,371,196
2019,1,A,골목상권,1000013,율곡로10길,615,353,262
2019,1,A,골목상권,1000012,옥인길,101,56,45
2019,1,A,골목상권,1000011,숭인동길,380,129,251
2019,1,A,골목상권,1000010,성균관로5길,220,114,106
2019,1,A,골목상권,1000009,삼청로5길,396,171,225
2019,1,A,골목상권,1000008,북촌로5나길,417,178,239
2019,1,A,골목상권,1000007,북촌로5길,443,163,280
2019,1,A,골목상권,1000006,북촌로11길,493,197,296
2019,1,A,골목상권,1000005,백석동길,1080,692,388
2019,1,A,골목상권,1000004,명륜길,104,58,46
2019,1,A,골목상권,1000003,돈화문로11가길,4822,2188,2634
2019,1,A,골목상권,1000002,난계로27길,486,254,232
2019,1,A,골목상권,1000001,계동길,348,142,206
2018,4,U,관광특구,1001496,강남 마이스 관광특구,22562,12970,9592
2018,4,U,관광특구,1001495,잠실 관광특구,30675,17928,12747
2018,4,U,관광특구,1001494,종로?청계 관광특구,31692,19002,12690
2018,4,U,관광특구,1001493,동대문패션타운 관광특구,10568,5953,4615
2018,4,U,관광특구,1001492,명동 남대문 북창동 다동 무교동 관광특구,158818,77955,80863
2018,4,U,관광특구,1001491,이태원 관광특구,5857,3193,2664
2018,4,R,전통시장,1001490,길동복조리시장,471,321,150
2018,4,R,전통시장,1001489,둔촌역전통시장,169,79,90
2018,4,R,전통시장,1001488,성내골목시장,6,2,4
2018,4,R,전통시장,1001487,천호시장,9,4,5
2018,4,R,전통시장,1001483,암사종합시장,829,387,442
2018,4,R,전통시장,1001482,고덕전통시장,400,387,13
2018,4,R,전통시장,1001481,명일골목시장,531,208,323
2018,4,R,전통시장,1001480,새마을시장,385,227,158
2018,4,R,전통시장,1001479,석촌시장,165,98,67
2018,4,R,전통시장,1001478,방이시장,611,372,239
2018,4,R,전통시장,1001477,마천시장,216,77,139
2018,4,R,전통시장,1001476,풍납시장,10,2,8
2018,4,R,전통시장,1001475,강남개포시장,36,31,5
2018,4,R,전통시장,1001474,도곡시장,484,215,269
2018,4,R,전통시장,1001471,영동전통시장,3036,2192,844
2018,4,R,전통시장,1001466,미성동도깨비시장,409,167,242
2018,4,R,전통시장,1001465,신신림시장,3,2,1
2018,4,R,전통시장,1001464,삼성동시장,94,38,56
2018,4,R,전통시장,1001463,신림중앙시장,12,7,5
2018,4,R,전통시장,1001462,강남골목시장,262,139,123
2018,4,R,전통시장,1001460,관악신사시장,171,79,92
2018,4,R,전통시장,1001459,신원시장,330,124,206
2018,4,R,전통시장,1001458,인헌시장,204,95,109
2018,4,R,전통시장,1001456,봉천현대시장,10,4,6
2018,4,R,전통시장,1001454,봉천제일종합시장,62,31,31
2018,4,R,전통시장,1001453,낙성대시장,16,9,7
2018,4,R,전통시장,1001452,중부시장,185,54,131
2018,4,R,전통시장,1001450,남성역골목시장,563,254,309
2018,4,R,전통시장,1001449,남성사계시장,1983,874,1109
2018,4,R,전통시장,1001448,흑석시장,171,54,117
2018,4,R,전통시장,1001447,상도4동도깨비골목시장,327,84,243
2018,4,R,전통시장,1001445,영도시장,83,41,42
2018,4,R,전통시장,1001441,본동인정시장,134,73,61
2018,4,R,전통시장,1001439,대림중앙시장,20,9,11
2018,4,R,전통시장,1001438,우리시장,18,9,9
2018,4,R,전통시장,1001437,영진시장A동,47,41,6
2018,4,R,전통시장,1001436,사러가시장,34,12,22
2018,4,R,전통시장,1001431,영등포청과시장,218,143,75
2018,4,R,전통시장,1001430,영등포전통시장,4063,1979,2084
2018,4,R,전통시장,1001429,은행나무시장,69,14,55
2018,4,R,전통시장,1001427,현대시장,45,11,34
2018,4,R,전통시장,1001424,남문시장,271,114,157
2018,4,R,전통시장,1001423,독산동 우시장,137,58,79
2018,4,R,전통시장,1001421,개봉중앙시장,10,5,5
2018,4,R,전통시장,1001419,가리봉시장,16,13,3
2018,4,R,전통시장,1001418,남구로시장,13,3,10
2018,4,R,전통시장,1001417,구로시장,60,19,41
2018,4,R,전통시장,1001415,방신전통시장,47,26,21
2018,4,R,전통시장,1001414,송화골목시장,563,187,376
2018,4,R,전통시장,1001413,까치산시장,46,27,19
2018,4,R,전통시장,1001411,남부골목시장,217,92,125
2018,4,R,전통시장,1001409,화곡중앙골목시장,2,2,0
2018,4,R,전통시장,1001407,등마루시장,799,452,347
2018,4,R,전통시장,1001406,신정3동골목시장,181,94,87
2018,4,R,전통시장,1001405,신정2동골목시장,6,6,0
2018,4,R,전통시장,1001402,신월6동골목시장,229,123,106
2018,4,R,전통시장,1001401,신곡종합시장,13,9,4
2018,4,R,전통시장,1001400,신월3동골목시장,68,24,44
2018,4,R,전통시장,1001399,경창시장,208,85,123
2018,4,R,전통시장,1001398,월정로시장,123,71,52
2018,4,R,전통시장,1001397,신영시장,56,20,36
2018,4,R,전통시장,1001396,목4동시장,211,70,141
2018,4,R,전통시장,1001395,목3동시장,768,376,392
2018,4,R,전통시장,1001394,목2동시장,228,108,120
2018,4,R,전통시장,1001393,마포농수산물시장,461,295,166
2018,4,R,전통시장,1001391,망원월드컵시장,16,11,5
2018,4,R,전통시장,1001390,망원시장,60,30,30
2018,4,R,전통시장,1001386,신수시장,121,83,38
2018,4,R,전통시장,1001385,아현시장,25,5,20
2018,4,R,전통시장,1001374,대림골목시장,411,134,277
2018,4,R,전통시장,1001367,상계중앙시장,42,20,22
2018,4,R,전통시장,1001364,방학동도깨비시장,160,66,94
2018,4,R,전통시장,1001363,쌍문역골목시장,71,35,36
2018,4,R,전통시장,1001361,신도봉시장,28,15,13
2018,4,R,전통시장,1001359,창동신창시장,141,60,81
2018,4,R,전통시장,1001358,수유북부시장,12,2,10
2018,4,R,전통시장,1001357,장미원골목시장,67,41,26
2018,4,R,전통시장,1001356,수유중앙시장,127,67,60
2018,4,R,전통시장,1001355,강북종합시장,65,28,37
2018,4,R,전통시장,1001354,우이시장,157,52,105
2018,4,R,전통시장,1001353,수유전통시장,411,152,259
2018,4,R,전통시장,1001352,번동북부골목시장,84,44,40
2018,4,R,전통시장,1001351,솔샘시장,109,45,64
2018,4,R,전통시장,1001349,방천골목시장,77,28,49
2018,4,R,전통시장,1001347,석관황금시장,78,26,52
2018,4,R,전통시장,1001343,장위전통시장,190,76,114
2018,4,R,전통시장,1001340,정릉시장,37,13,24
2018,4,R,전통시장,1001339,정릉아리랑시장,2,1,1
2018,4,R,전통시장,1001338,돈암제일시장,52,19,33
2018,4,R,전통시장,1001336,우림골목시장,218,108,110
2018,4,R,전통시장,1001335,묵1동도깨비시장,290,125,165
2018,4,R,전통시장,1001334,태능시장,3,1,2
2018,4,R,전통시장,1001333,중화제일시장,22,1,21
2018,4,R,전통시장,1001332,사가정시장,245,172,73
2018,4,R,전통시장,1001330,동원시장,72,35,37
2018,4,R,전통시장,1001329,동부골목시장,105,37,68
2018,4,R,전통시장,1001326,회기시장,114,52,62
2018,4,R,전통시장,1001323,답십리시장,31,10,21
2018,4,R,전통시장,1001321,답십리현대시장,98,79,19
2018,4,R,전통시장,1001319,청량리종합시장,10,6,4
2018,4,R,전통시장,1001317,청량리농수산물시장,21,16,5
2018,4,R,전통시장,1001316,서울약령시장,1319,793,526
2018,4,R,전통시장,1001313,청량리수산시장,227,115,112
2018,4,R,전통시장,1001310,구의시장,132,80,52
2018,4,R,전통시장,1001309,조양시장,91,48,43
2018,4,R,전통시장,1001308,영동교골목시장,18,12,6
2018,4,R,전통시장,1001307,능동로골목시장,275,240,35
2018,4,R,전통시장,1001304,자양골목시장,97,51,46
2018,4,R,전통시장,1001301,중곡제일시장,130,65,65
2018,4,R,전통시장,1001299,한아름시장,174,93,81
2018,4,R,전통시장,1001298,성동용답상가시장,312,155,157
2018,4,R,전통시장,1001297,뚝도시장,35,14,21
2018,4,R,전통시장,1001296,금남시장,29,13,16
2018,4,R,전통시장,1001295,행당시장,257,122,135
2018,4,R,전통시장,1001294,마장축산물시장,1516,1018,498
2018,4,R,전통시장,1001289,용문전통시장,41,20,21
2018,4,R,전통시장,1001286,후암시장,48,19,29
2018,4,R,전통시장,1001285,합동(새벽)시장,2365,1366,999
2018,4,R,전통시장,1001284,서울중앙시장,278,184,94
2018,4,R,전통시장,1001283,백학시장,463,238,225
2018,4,R,전통시장,1001282,약수시장,1786,703,1083
2018,4,R,전통시장,1001281,청평화시장,3360,2011,1349
2018,4,R,전통시장,1001280,제일평화시장,570,325,245
2018,4,R,전통시장,1001278,남평화시장,200,123,77
2018,4,R,전통시장,1001277,방산종합시장,1879,1180,699
2018,4,R,전통시장,1001275,인현시장,1084,665,419
2018,4,R,전통시장,1001274,신중부시장,2437,1607,830
2018,4,R,전통시장,1001273,남대문시장,7146,3645,3501
2018,4,R,전통시장,1001271,동묘시장,903,568,335
2018,4,R,전통시장,1001270,창신골목시장,223,116,107
2018,4,R,전통시장,1001268,충신시장,297,182,115
2018,4,R,전통시장,1001267,종로신진시장,39,19,20
2018,4,R,전통시장,1001266,동대문종합시장,320,185,135
2018,4,R,전통시장,1001265,광장시장,204,152,52
2018,4,D,발달상권,1001263,서울 노원구 노원역_3,775,329,446
2018,4,D,발달상권,1001261,서울 노원구 노원역_1,1068,309,759
2018,4,D,발달상권,1001260,창동역,2477,1573,904
2018,4,D,발달상권,1001259,서울 강북구 수유역_3,64,32,32
2018,4,D,발달상권,1001257,서울 강북구 수유역_2,4370,2230,2140
2018,4,D,발달상권,1001256,서울 강북구 수유역_1,43,30,13
2018,4,D,발달상권,1001255,서울 은평구 연신내역_3,676,207,469
2018,4,D,발달상권,1001254,서울 은평구 연신내역_2,451,195,256
2018,4,D,발달상권,1001253,서울 은평구 연신내역_1,74,30,44
2018,4,D,발달상권,1001252,서울 성북구 미아삼거리역_2,507,206,301
2018,4,D,발달상권,1001251,서울 강북구 미아삼거리역_1,542,200,342
2018,4,D,발달상권,1001250,서울 은평구 불광역_3,54,19,35
2018,4,D,발달상권,1001249,서울 은평구 불광역_2,69,26,43
2018,4,D,발달상권,1001248,서울 은평구 불광역_1,284,113,171
2018,4,D,발달상권,1001247,미아사거리_2,121,41,80
2018,4,D,발달상권,1001246,미아사거리_1,621,283,338
2018,4,D,발달상권,1001245,서울 성북구 성신여대입구역,5286,3156,2130
2018,4,D,발달상권,1001244,경희대학교,370,178,192
2018,4,D,발달상권,1001243,서울 성북구 안암역,112,69,43
2018,4,D,발달상권,1001242,혜화역 대학로_3,1727,826,901
2018,4,D,발달상권,1001241,혜화역 대학로_2,1513,820,693
2018,4,D,발달상권,1001240,혜화역 대학로_1,1225,637,588
2018,4,D,발달상권,1001239,디지털미디어시티,17010,11036,5974
2018,4,D,발달상권,1001238,서울 동대문구 청량리역,3509,2402,1107
2018,4,D,발달상권,1001236,서울 종로구 안국역_2,706,276,430
2018,4,D,발달상권,1001235,서울 종로구 안국역_1,11483,9242,2241
2018,4,D,발달상권,1001234,서울 종로구 경복궁역_1,207,80,127
2018,4,D,발달상권,1001233,서울 종로구 종로3가역_3,3411,1821,1590
2018,4,D,발달상권,1001232,서울 종로구 종로3가역_2,1922,1023,899
2018,4,D,발달상권,1001231,서울 동대문구 신설동역_2,4377,2078,2299
2018,4,D,발달상권,1001230,인사동,21052,13045,8007
2018,4,D,발달상권,1001229,서울 종로구 종로5가역_4,635,349,286
2018,4,D,발달상권,1001228,서울 종로구 종로5가역_3,4960,3352,1608
2018,4,D,발달상권,1001227,종로구청,18495,10125,8370
2018,4,D,발달상권,1001226,서울 종로구 종로5가역_2,17391,11598,5793
2018,4,D,발달상권,1001225,신설동역,738,421,317
2018,4,D,발달상권,1001224,서울 동대문구 신설동역_1,2,2,0
2018,4,D,발달상권,1001223,서울 종로구 광화문역_2,54371,32642,21729
2018,4,D,발달상권,1001222,동묘앞역,68,40,28
2018,4,D,발달상권,1001221,장안동사거리,503,249,254
2018,4,D,발달상권,1001220,서울 종로구 동대문역_2,1106,550,556
2018,4,D,발달상권,1001218,동대문시장_2,500,300,200
2018,4,D,발달상권,1001217,서울 종로구 종로5가역_1,50,38,12
2018,4,D,발달상권,1001216,서울 종로구 종로3가역_1,4034,1757,2277
2018,4,D,발달상권,1001215,서울 종로구 광화문역_1,2103,1344,759
2018,4,D,발달상권,1001214,종각역,20751,13526,7225
2018,4,D,발달상권,1001213,종각역 젊음의 거리,2712,1114,1598
2018,4,D,발달상권,1001212,서대문구 서대문역_1,348,250,98
2018,4,D,발달상권,1001211,동대문시장_1,437,223,214
2018,4,D,발달상권,1001210,시청역_2,21859,13798,8061
2018,4,D,발달상권,1001209,서울시청,23497,11478,12019
2018,4,D,발달상권,1001208,서울 중구 을지로3가역_2,7863,5061,2802
2018,4,D,발달상권,1001207,서울 중구 신당역_2,1354,683,671
2018,4,D,발달상권,1001206,서대문구 서대문역_2,1449,871,578
2018,4,D,발달상권,1001205,동대문역사문화공원역,2248,1277,971
2018,4,D,발달상권,1001204,서울 중구 을지로3가역_1,18018,11428,6590
2018,4,D,발달상권,1001203,명동거리,9026,4728,4298
2018,4,D,발달상권,1001202,롯데백화점,40463,21491,18972
2018,4,D,발달상권,1001201,서울 중구 신당역_1,1057,702,355
2018,4,D,발달상권,1001200,북창동,10548,5655,4893
2018,4,D,발달상권,1001199,서울 중구 충무로역_2,14898,6701,8197
2018,4,D,발달상권,1001198,서울 강서구 송정역,616,407,209
2018,4,D,발달상권,1001197,장한평역_2,5325,3255,2070
2018,4,D,발달상권,1001196,시청역_1,54859,33251,21608
2018,4,D,발달상권,1001195,왕십리역_2,668,280,388
2018,4,D,발달상권,1001194,서울 강서구 발산역,874,492,382
2018,4,D,발달상권,1001193,장한평역_1,2508,1570,938
2018,4,D,발달상권,1001192,서울 중구 충무로역_1,3239,2248,991
2018,4,D,발달상권,1001190,장한평역,2303,1580,723
2018,4,D,발달상권,1001189,서울 중구 명동역,3988,2012,1976
2018,4,D,발달상권,1001188,장충동 족발거리,187,89,98
2018,4,D,발달상권,1001187,한양시장,266,156,110
2018,4,D,발달상권,1001186,서울 서대문구 이대역,1395,638,757
2018,4,D,발달상권,1001185,서울 서대문구 신촌역,3278,1418,1860
2018,4,D,발달상권,1001184,서울 마포구 홍대입구역_3,342,155,187
2018,4,D,발달상권,1001183,서울 마포구 홍대입구역_2,3328,1284,2044
2018,4,D,발달상권,1001182,홍익대학교 주변,16818,8154,8664
2018,4,D,발달상권,1001181,서울 광진구 군자역,227,131,96
2018,4,D,발달상권,1001180,신촌역,221,106,115
2018,4,D,발달상권,1001179,강서구청,3558,2312,1246
2018,4,D,발달상권,1001178,서울 마포구 홍대입구역_1,871,475,396
2018,4,D,발달상권,1001175,서울 강동구 고덕역,450,255,195
2018,4,D,발달상권,1001173,서울 강동구 명일역,869,359,510
2018,4,D,발달상권,1001172,어린이대공원역,88,47,41
2018,4,D,발달상권,1001171,서울 마포구 공덕역_2,4328,2508,1820
2018,4,D,발달상권,1001170,공덕역,7954,4594,3360
2018,4,D,발달상권,1001169,서울 용산구 숙대입구역,2707,1969,738
2018,4,D,발달상권,1001168,남영역,12311,5453,6858
2018,4,D,발달상권,1001167,서울 마포구 공덕역_1,4905,2395,2510
2018,4,D,발달상권,1001166,서울 마포구 마포역_2,1002,557,445
2018,4,D,발달상권,1001165,서울 광진구 건대입구역_2,2990,1023,1967
2018,4,D,발달상권,1001164,서울 마포구 마포역_1,13134,7794,5340
2018,4,D,발달상권,1001163,서울 강동구 천호역_2,4128,1923,2205
2018,4,D,발달상권,1001162,서울 광진구 건대입구역_1,916,434,482
2018,4,D,발달상권,1001161,건대입구역,735,394,341
2018,4,D,발달상권,1001160,서울 광진구 구의역,906,569,337
2018,4,D,발달상권,1001159,서울 강동구 천호역,997,451,546
2018,4,D,발달상권,1001158,당산역_2,4707,2881,1826
2018,4,D,발달상권,1001156,서울 강동구 길동역,1286,691,595
2018,4,D,발달상권,1001155,용산 전자상가_5,2575,1881,694
2018,4,D,발달상권,1001153,당산역_1,1148,704,444
2018,4,D,발달상권,1001152,서울 광진구 강변역,1799,1410,389
2018,4,D,발달상권,1001151,용산 전자상가_3,2469,1782,687
2018,4,D,발달상권,1001150,서울 용산구 이태원역,661,400,261
2018,4,D,발달상권,1001149,한남오거리,574,297,277
2018,4,D,발달상권,1001147,용산 전자상가_2,479,380,99
2018,4,D,발달상권,1001146,용산구청,33,15,18
2018,4,D,발달상권,1001145,용산 전자상가_1,13047,8246,4801
2018,4,D,발달상권,1001144,국회의사당역_2,38083,21992,16091
2018,4,D,발달상권,1001143,서울 용산구 신용산역,505,240,265
2018,4,D,발달상권,1001142,국회의사당역_1,5707,4396,1311
2018,4,D,발달상권,1001141,압구정 로데오거리_2,16443,6701,9742
2018,4,D,발달상권,1001140,서울 강남구 압구정역,10265,4575,5690
2018,4,D,발달상권,1001139,서울 영등포구 영등포구청역,3733,1138,2595
2018,4,D,발달상권,1001138,압구정 로데오거리_1,9087,2833,6254
2018,4,D,발달상권,1001137,서울 강동구 둔촌동역,71,24,47
2018,4,D,발달상권,1001136,오목교역,198,85,113
2018,4,D,발달상권,1001135,신사동 가로수길,22466,10481,11985
2018,4,D,발달상권,1001134,서울 영등포구 여의도역_2,49729,33012,16717
2018,4,D,발달상권,1001133,청담사거리_3,1143,414,729
2018,4,D,발달상권,1001132,영등포유통상가,2109,1252,857
2018,4,D,발달상권,1001131,청담역_2,1317,899,418
2018,4,D,발달상권,1001130,청담역_1,194,154,40
2018,4,D,발달상권,1001129,청담사거리_2,1189,873,316
2018,4,D,발달상권,1001127,서울 영등포구 여의도역_1,51327,30887,20440
2018,4,D,발달상권,1001125,학동사거리_2,2997,1699,1298
2018,4,D,발달상권,1001124,서울 영등포구 영등포시장역,334,253,81
2018,4,D,발달상권,1001123,학동사거리_1,4479,2220,2259
2018,4,D,발달상권,1001122,여의도 시범아파트앞,2395,1580,815
2018,4,D,발달상권,1001121,영등포역_3,906,535,371
2018,4,D,발달상권,1001120,도산공원사거리_1,10355,6090,4265
2018,4,D,발달상권,1001119,영등포역_2,1259,661,598
2018,4,D,발달상권,1001118,문래동 주민센터,74,59,15
2018,4,D,발달상권,1001117,강남구 신사역_2,7930,4769,3161
2018,4,D,발달상권,1001115,서울 강남구 강남구청역_2,4663,2890,1773
2018,4,D,발달상권,1001114,강남구 신사역_1,2430,1008,1422
2018,4,D,발달상권,1001113,서울 동작구 노량진1동_1,19,6,13
2018,4,D,발달상권,1001112,서울 강남구 학동역_3,9665,5539,4126
2018,4,D,발달상권,1001111,서울 강남구 강남구청역_1,3642,2126,1516
2018,4,D,발달상권,1001110,잠실역,5868,4338,1530
2018,4,D,발달상권,1001109,강남구 논현역_4,6478,3331,3147
2018,4,D,발달상권,1001108,학동역,1572,574,998
2018,4,D,발달상권,1001107,방이동 먹자골목,5157,3223,1934
2018,4,D,발달상권,1001106,서울 강남구 학동역_2,6033,3234,2799
2018,4,D,발달상권,1001105,서울 동작구 노량진역,3829,2175,1654
2018,4,D,발달상권,1001104,삼성역_3,10170,5919,4251
2018,4,D,발달상권,1001103,코엑스,22562,12970,9592
2018,4,D,발달상권,1001102,서울 강남구 학동역_1,5305,3348,1957
2018,4,D,발달상권,1001101,선정릉역_2,6911,4247,2664
2018,4,D,발달상권,1001100,강남구 논현역_3,1533,932,601
2018,4,D,발달상권,1001099,포스코사거리_2,7881,5022,2859
2018,4,D,발달상권,1001098,포스코사거리_1,43841,29255,14586
2018,4,D,발달상권,1001097,잠실역 롯데월드,3871,1933,1938
2018,4,D,발달상권,1001096,신도림역,3373,1768,1605
2018,4,D,발달상권,1001095,강남구 논현역_2,10089,4811,5278
2018,4,D,발달상권,1001094,선정릉역_1,1924,1381,543
2018,4,D,발달상권,1001093,신천역,5931,3190,2741
2018,4,D,발달상권,1001092,강남구 논현역_1,3585,2076,1509
2018,4,D,발달상권,1001091,삼성역_2,18975,11521,7454
2018,4,D,발달상권,1001090,삼정역_2,2478,1346,1132
2018,4,D,발달상권,1001089,삼정역_1,3329,1696,1633
2018,4,D,발달상권,1001088,삼성역_1,35413,22502,12911
2018,4,D,발달상권,1001087,서울 강남구 선릉역_2,7288,4707,2581
2018,4,D,발달상권,1001086,고속터미널역,16485,4781,11704
2018,4,D,발달상권,1001085,서울 서초구 강남역,33758,18836,14922
2018,4,D,발달상권,1001084,서울 강남구 선릉역_1,19964,8319,11645
2018,4,D,발달상권,1001082,선릉역_2,20789,10769,10020
2018,4,D,발달상권,1001081,서울 강남구 역삼역_2,27706,21651,6055
2018,4,D,발달상권,1001080,서울 송파구 석촌역_1,37,21,16
2018,4,D,발달상권,1001078,서울 강남구 강남역_2,5638,3260,2378
2018,4,D,발달상권,1001077,선릉역_1,55373,30034,25339
2018,4,D,발달상권,1001076,구로역,153,85,68
2018,4,D,발달상권,1001075,역삼역_2,4513,2557,1956
2018,4,D,발달상권,1001074,대림역_2,7571,5787,1784
2018,4,D,발달상권,1001073,서울 강남구 역삼역_1,24525,15502,9023
2018,4,D,발달상권,1001072,신대방삼거리역,241,109,132
2018,4,D,발달상권,1001071,서울 강남구 한티역,1139,451,688
2018,4,D,발달상권,1001070,은마아파트입구사거리_4,105,53,52
2018,4,D,발달상권,1001067,오류동역,1589,803,786
2018,4,D,발달상권,1001066,서울 강남구 강남역,41280,19424,21856
2018,4,D,발달상권,1001063,교대역_4,5151,2877,2274
2018,4,D,발달상권,1001062,서울 강남구 강남역_1,135689,99243,36446
2018,4,D,발달상권,1001061,방배동카페골목,108,41,67
2018,4,D,발달상권,1001060,가락시장,17284,10739,6545
2018,4,D,발달상권,1001059,교대역_3,4422,2687,1735
2018,4,D,발달상권,1001058,역삼역_1,1540,911,629
2018,4,D,발달상권,1001057,교대역_2,3363,2149,1214
2018,4,D,발달상권,1001056,서울 송파구 가락시장역,5029,3136,1893
2018,4,D,발달상권,1001055,서울 서초구 서초역,11841,4670,7171
2018,4,D,발달상권,1001054,서울 강남구 대치역_2,1508,910,598
2018,4,D,발달상권,1001052,뱅뱅사거리_2,29870,20424,9446
2018,4,D,발달상권,1001051,보라매공원,14421,8102,6319
2018,4,D,발달상권,1001050,교대역_1,13316,7616,5700
2018,4,D,발달상권,1001049,개봉동 현대아파트 인근,145,60,85
2018,4,D,발달상권,1001048,뱅뱅사거리,7961,5087,2874
2018,4,D,발달상권,1001047,뱅뱅사거리_1,11051,7880,3171
2018,4,D,발달상권,1001046,서울 관악구 신림역_4,1027,467,560
2018,4,D,발달상권,1001045,동작구 총신대입구역_1,262,123,139
2018,4,D,발달상권,1001044,양재역_3,3614,2354,1260
2018,4,D,발달상권,1001043,동작구 총신대입구역_2,752,321,431
2018,4,D,발달상권,1001042,서울 서초구 남부터미널역_3,1491,797,694
2018,4,D,발달상권,1001041,서울 강남구 수서역,16052,11440,4612
2018,4,D,발달상권,1001039,서울 서초구 남부터미널역_2,10724,5529,5195
2018,4,D,발달상권,1001038,구로디지탈1단지,66367,42004,24363
2018,4,D,발달상권,1001037,양재역,133,61,72
2018,4,D,발달상권,1001035,매봉역,612,229,383
2018,4,D,발달상권,1001034,서울 서초구 방배역,3380,1969,1411
2018,4,D,발달상권,1001033,서울 서초구 남부터미널역_1,540,396,144
2018,4,D,발달상권,1001032,서울 관악구 신림역_2,34,17,17
2018,4,D,발달상권,1001031,서울 관악구 신림역_1,1979,936,1043
2018,4,D,발달상권,1001030,양재역_2,11338,6172,5166
2018,4,D,발달상권,1001029,양재역_1,923,654,269
2018,4,D,발달상권,1001028,서울 관악구 서울대입구역_2,41,3,38
2018,4,D,발달상권,1001027,가산디지털단지역_3,45037,29362,15675
2018,4,D,발달상권,1001026,구로디지털단지역,2524,1636,888
2018,4,D,발달상권,1001025,서울 관악구 서울대입구역_1,1936,848,1088
2018,4,D,발달상권,1001024,관악구 사당역_1,3503,1459,2044
2018,4,D,발달상권,1001023,가산디지털단지역_2,59807,36563,23244
2018,4,D,발달상권,1001022,관악구 사당역_2,494,285,209
2018,4,D,발달상권,1001021,가산디지털단지역_1,28461,19196,9265
2018,4,D,발달상권,1001020,장지역,4695,2900,1795
2018,4,D,발달상권,1001019,포이사거리_1,5851,3303,2548
2018,4,D,발달상권,1001018,포이사거리_2,8599,5946,2653
2018,4,D,발달상권,1001016,서울 관악구 대학동_1,112,67,45
2018,4,D,발달상권,1001015,서울 금천구 독산1동_1,3020,1946,1074
2018,4,D,발달상권,1001013,양재 화물트럭터미널앞_2,148,70,78
2018,4,D,발달상권,1001012,양재 화물트럭터미널앞_1,4525,3730,795
2018,4,D,발달상권,1001011,서울 금천구 시흥1동_4,957,409,548
2018,4,A,골목상권,1001010,풍성로37가길,40,20,20
2018,4,A,골목상권,1001009,천호옛길,476,320,156
2018,4,A,골목상권,1001008,천호옛14길,703,384,319
2018,4,A,골목상권,1001007,천호대로219길,1366,617,749
2018,4,A,골목상권,1001006,천호대로197길,22,8,14
2018,4,A,골목상권,1001005,천호대로187길,890,509,381
2018,4,A,골목상권,1001004,천호대로170길,257,149,108
2018,4,A,골목상권,1001003,천호대로162길,1306,831,475
2018,4,A,골목상권,1001002,천중로51길,425,222,203
2018,4,A,골목상권,1001001,천중로39길,564,213,351
2018,4,A,골목상권,1001000,진황도로47길,1602,638,964
2018,4,A,골목상권,1000999,진황도로27길,579,300,279
2018,4,A,골목상권,1000998,올림픽로98길,41,17,24
2018,4,A,골목상권,1000995,올림픽로77길,21,11,10
2018,4,A,골목상권,1000994,올림픽로71길,353,258,95
2018,4,A,골목상권,1000993,올림픽로48길,6417,3785,2632
2018,4,A,골목상권,1000992,양재대로96길,1304,791,513
2018,4,A,골목상권,1000991,양재대로95길,604,312,292
2018,4,A,골목상권,1000990,양재대로91길,1119,618,501
2018,4,A,골목상권,1000989,양재대로133길,358,133,225
2018,4,A,골목상권,1000988,양재대로124길,581,330,251
2018,4,A,골목상권,1000987,양재대로116길,213,88,125
2018,4,A,골목상권,1000986,양재대로101길,1389,809,580
2018,4,A,골목상권,1000985,암사길,395,174,221
2018,4,A,골목상권,1000984,성안로3길,1338,764,574
2018,4,A,골목상권,1000983,성내로5길,1078,551,527
2018,4,A,골목상권,1000982,상일로5길,41,23,18
2018,4,A,골목상권,1000981,상암로5길,566,238,328
2018,4,A,골목상권,1000980,상암로51길,788,343,445
2018,4,A,골목상권,1000979,상암로4길,204,131,73
2018,4,A,골목상권,1000978,상암로14길,407,217,190
2018,4,A,골목상권,1000977,명일로13길,104,47,57
2018,4,A,골목상권,1000976,동남로85길,116,66,50
2018,4,A,골목상권,1000975,동남로82길,10,4,6
2018,4,A,골목상권,1000974,동남로65길,81,25,56
2018,4,A,골목상권,1000973,구천면로42길,347,193,154
2018,4,A,골목상권,1000972,구천면로41길,583,246,337
2018,4,A,골목상권,1000971,구천면로36길,40,23,17
2018,4,A,골목상권,1000969,고덕로25길,14,8,6
2018,4,A,골목상권,1000968,고덕로10길,181,84,97
2018,4,A,골목상권,1000967,강동대로53길,887,492,395
2018,4,A,골목상권,1000966,풍성로25길,787,283,504
2018,4,A,골목상권,1000965,오금로46길,1431,710,721
2018,4,A,골목상권,1000964,오금로36길,1297,935,362
2018,4,A,골목상권,1000963,오금로11길,2163,1389,774
2018,4,A,골목상권,1000962,양재대로72길,621,301,320
2018,4,A,골목상권,1000961,양재대로71길,1434,887,547
2018,4,A,골목상권,1000960,양재대로64길,1458,635,823
2018,4,A,골목상권,1000959,양재대로62길,7052,4459,2593
2018,4,A,골목상권,1000958,송파대로30길,1629,990,639
2018,4,A,골목상권,1000957,송이로36길,1947,1366,581
2018,4,A,골목상권,1000956,송이로32길,732,412,320
2018,4,A,골목상권,1000955,송이로23길,1442,912,530
2018,4,A,골목상권,1000954,삼전로13길,1633,731,902
2018,4,A,골목상권,1000953,백제고분로50길,1512,922,590
2018,4,A,골목상권,1000952,백제고분로46길,1619,955,664
2018,4,A,골목상권,1000951,백제고분로45길,504,326,178
2018,4,A,골목상권,1000950,백제고분로42길,124,79,45
2018,4,A,골목상권,1000949,백제고분로39길,1696,1248,448
2018,4,A,골목상권,1000948,백제고분로34길,1516,980,536
2018,4,A,골목상권,1000947,백제고분로33길,1104,708,396
2018,4,A,골목상권,1000946,백제고분로32길,1121,500,621
2018,4,A,골목상권,1000945,백제고분로31길,347,186,161
2018,4,A,골목상권,1000944,백제고분로22길,1205,721,484
2018,4,A,골목상권,1000943,백제고분로21길,205,136,69
2018,4,A,골목상권,1000942,마천로51길,157,67,90
2018,4,A,골목상권,1000941,동남로20길,155,82,73
2018,4,A,골목상권,1000940,거마로20길,527,228,299
2018,4,A,골목상권,1000939,학동로77길,2922,1463,1459
2018,4,A,골목상권,1000938,학동로6길,1698,886,812
2018,4,A,골목상권,1000937,학동로56길,893,439,454
2018,4,A,골목상권,1000936,학동로38길,6922,4029,2893
2018,4,A,골목상권,1000935,테헤란로81길,524,204,320
2018,4,A,골목상권,1000934,일원로9길,489,274,215
2018,4,A,골목상권,1000933,일원로3길,234,125,109
2018,4,A,골목상권,1000932,영동대로65길,3214,1853,1361
2018,4,A,골목상권,1000931,영동대로112길,628,391,237
2018,4,A,골목상권,1000930,언주로81길,9998,4857,5141
2018,4,A,골목상권,1000929,압구정로2길,2822,1499,1323
2018,4,A,골목상권,1000928,선릉로18길,348,204,144
2018,4,A,골목상권,1000927,선릉로146길,1923,986,937
2018,4,A,골목상권,1000926,선릉로133길,270,147,123
2018,4,A,골목상권,1000925,선릉로132길,1089,619,470
2018,4,A,골목상권,1000924,선릉로121길,1565,874,691
2018,4,A,골목상권,1000923,삼성로75길,2635,1450,1185
2018,4,A,골목상권,1000922,삼성로69길,357,181,176
2018,4,A,골목상권,1000921,삼성로64길,522,249,273
2018,4,A,골목상권,1000920,삼성로63길,245,96,149
2018,4,A,골목상권,1000919,삼성로57길,846,267,579
2018,4,A,골목상권,1000918,삼성로147길,874,357,517
2018,4,A,골목상권,1000917,삼성로115길,256,151,105
2018,4,A,골목상권,1000916,봉은사로68길,204,91,113
2018,4,A,골목상권,1000915,봉은사로57길,1141,708,433
2018,4,A,골목상권,1000914,봉은사로43길,1058,705,353
2018,4,A,골목상권,1000913,봉은사로29길,138,95,43
2018,4,A,골목상권,1000912,봉은사로109길,329,175,154
2018,4,A,골목상권,1000911,도산대로89길,2258,953,1305
2018,4,A,골목상권,1000910,도산대로81길,4192,1529,2663
2018,4,A,골목상권,1000909,도산대로50길,2731,1870,861
2018,4,A,골목상권,1000908,도산대로38길,163,91,72
2018,4,A,골목상권,1000907,도산대로30길,3304,1620,1684
2018,4,A,골목상권,1000906,도산대로23길,1448,886,562
2018,4,A,골목상권,1000905,도산대로15길,1632,760,872
2018,4,A,골목상권,1000904,도곡로37길,4197,2203,1994
2018,4,A,골목상권,1000903,논현로8길,783,440,343
2018,4,A,골목상권,1000902,논현로63길,3203,2261,942
2018,4,A,골목상권,1000901,논현로28길,10510,7244,3266
2018,4,A,골목상권,1000900,논현로26길,7670,5050,2620
2018,4,A,골목상권,1000898,논현로139길,2712,1278,1434
2018,4,A,골목상권,1000897,논현로123길,100,59,41
2018,4,A,골목상권,1000896,논현로115길,2806,1441,1365
2018,4,A,골목상권,1000895,논현로10길,2570,1650,920
2018,4,A,골목상권,1000894,논현로106길,2765,1572,1193
2018,4,A,골목상권,1000893,남부순환로365길,171,122,49
2018,4,A,골목상권,1000891,개포로28길,296,193,103
2018,4,A,골목상권,1000890,개포로20길,4215,2408,1807
2018,4,A,골목상권,1000889,개포로17길,2622,1698,924
2018,4,A,골목상권,1000888,강남대로140길,4005,2014,1991
2018,4,A,골목상권,1000887,강남대로136길,1294,759,535
2018,4,A,골목상권,1000886,강남대로118길,588,330,258
2018,4,A,골목상권,1000885,서초중앙로8길,7653,5747,1906
2018,4,A,골목상권,1000884,방배중앙로21길,1297,640,657
2018,4,A,골목상권,1000883,효령로72길,204,124,80
2018,4,A,골목상권,1000882,효령로34길,37,31,6
2018,4,A,골목상권,1000881,효령로31길,1329,705,624
2018,4,A,골목상권,1000880,효령로23길,732,433,299
2018,4,A,골목상권,1000879,청두곶길,2220,1352,868
2018,4,A,골목상권,1000878,주흥길,333,224,109
2018,4,A,골목상권,1000877,주흥15길,1480,947,533
2018,4,A,골목상권,1000876,언남길,1642,1109,533
2018,4,A,골목상권,1000875,신반포로45길,451,275,176
2018,4,A,골목상권,1000874,서초대로8길,248,125,123
2018,4,A,골목상권,1000873,서초대로64길,623,435,188
2018,4,A,골목상권,1000872,서초대로4길,652,473,179
2018,4,A,골목상권,1000871,서초대로25길,3904,2399,1505
2018,4,A,골목상권,1000870,서초대로23길,556,339,217
2018,4,A,골목상권,1000869,서초대로15길,1535,711,824
2018,4,A,골목상권,1000868,사평대로57길,177,66,111
2018,4,A,골목상권,1000867,사평대로26길,13,9,4
2018,4,A,골목상권,1000866,사평대로22길,1484,903,581
2018,4,A,골목상권,1000865,사임당로17길,1851,1124,727
2018,4,A,골목상권,1000864,방배로42길,126,58,68
2018,4,A,골목상권,1000863,방배로35길,2371,1505,866
2018,4,A,골목상권,1000862,방배로18길,77,45,32
2018,4,A,골목상권,1000861,반포대로9길,658,422,236
2018,4,A,골목상권,1000860,바우뫼로39길,2652,1560,1092
2018,4,A,골목상권,1000859,마방로2길,3850,2366,1484
2018,4,A,골목상권,1000858,방배천로4안길,1298,851,447
2018,4,A,골목상권,1000857,동산로19길,1298,847,451
2018,4,A,골목상권,1000856,동산로10길,2806,1517,1289
2018,4,A,골목상권,1000855,동광로39길,54,27,27
2018,4,A,골목상권,1000854,동광로1길,966,534,432
2018,4,A,골목상권,1000853,동광로12길,794,508,286
2018,4,A,골목상권,1000852,논현로27길,3588,2542,1046
2018,4,A,골목상권,1000851,논현로1길,550,355,195
2018,4,A,골목상권,1000850,남부순환로339길,13336,5891,7445
2018,4,A,골목상권,1000849,남부순환로325길,8261,3970,4291
2018,4,A,골목상권,1000848,남부순환로317길,1663,1135,528
2018,4,A,골목상권,1000847,고무래로8길,6501,3376,3125
2018,4,A,골목상권,1000846,강남대로8길,2603,1629,974
2018,4,A,골목상권,1000845,강남대로34길,1069,705,364
2018,4,A,골목상권,1000844,강남대로23길,7309,5154,2155
2018,4,A,골목상권,1000843,소담길,34,11,23
2018,4,A,골목상권,1000842,원신길,297,116,181
2018,4,A,골목상권,1000840,양산길,356,242,114
2018,4,A,골목상권,1000839,호암로24길,788,262,526
2018,4,A,골목상권,1000838,호암로20길,55,29,26
2018,4,A,골목상권,1000837,행운길,21,5,16
2018,4,A,골목상권,1000836,행운1길,105,71,34
2018,4,A,골목상권,1000835,청림3길,74,37,37
2018,4,A,골목상권,1000834,청룡길,89,48,41
2018,4,A,골목상권,1000833,청룡8길,10,5,5
2018,4,A,골목상권,1000832,중앙길,260,94,166
2018,4,A,골목상권,1000831,조원중앙로2길,1189,848,341
2018,4,A,골목상권,1000830,조원로18길,1045,551,494
2018,4,A,골목상권,1000829,조원로10길,275,121,154
2018,4,A,골목상권,1000828,장군봉2길,400,277,123
2018,4,A,골목상권,1000827,장군봉1길,83,16,67
2018,4,A,골목상권,1000826,인헌길,82,52,30
2018,4,A,골목상권,1000825,은천로25길,284,92,192
2018,4,A,골목상권,1000824,양녕로6길,822,465,357
2018,4,A,골목상권,1000823,신원로3길,25,14,11
2018,4,A,골목상권,1000822,신사로20길,44,14,30
2018,4,A,골목상권,1000820,신림로64길,242,118,124
2018,4,A,골목상권,1000819,신림로48길,69,33,36
2018,4,A,골목상권,1000818,신림로38길,60,33,27
2018,4,A,골목상권,1000817,신림로28길,328,227,101
2018,4,A,골목상권,1000816,신림로11길,470,420,50
2018,4,A,골목상권,1000815,신림동길,354,198,156
2018,4,A,골목상권,1000814,승방길,571,365,206
2018,4,A,골목상권,1000813,서림7길,289,116,173
2018,4,A,골목상권,1000812,봉천로33길,308,199,109
2018,4,A,골목상권,1000811,봉천로13길,318,88,230
2018,4,A,골목상권,1000810,복은길,155,55,100
2018,4,A,골목상권,1000809,법원단지길,2,2,0
2018,4,A,골목상권,1000808,법원단지9길,87,39,48
2018,4,A,골목상권,1000807,미성5길,77,44,33
2018,4,A,골목상권,1000806,대학길,75,39,36
2018,4,A,골목상권,1000805,대학14길,13,4,9
2018,4,A,골목상권,1000804,당곡길,386,205,181
2018,4,A,골목상권,1000803,남현길,224,76,148
2018,4,A,골목상권,1000802,남현3길,270,140,130
2018,4,A,골목상권,1000800,남부순환로248길,251,112,139
2018,4,A,골목상권,1000799,남부순환로234길,173,116,57
2018,4,A,골목상권,1000798,남부순환로172길,1264,685,579
2018,4,A,골목상권,1000797,남부순환로161길,31,12,19
2018,4,A,골목상권,1000796,남부순환로151길,200,144,56
2018,4,A,골목상권,1000795,남부순환로142길,93,49,44
2018,4,A,골목상권,1000794,난향길,177,42,135
2018,4,A,골목상권,1000793,난우길,426,159,267
2018,4,A,골목상권,1000792,난곡로74길,117,53,64
2018,4,A,골목상권,1000791,난곡로34길,25,7,18
2018,4,A,골목상권,1000790,난곡로26길,141,50,91
2018,4,A,골목상권,1000789,난곡로24길,26,16,10
2018,4,A,골목상권,1000788,낙성대역길,698,446,252
2018,4,A,골목상권,1000787,국회단지길,572,272,300
2018,4,A,골목상권,1000786,구암길,88,34,54
2018,4,A,골목상권,1000785,관천로22길,19,6,13
2018,4,A,골목상권,1000784,관천로15길,150,82,68
2018,4,A,골목상권,1000783,관악로30길,187,62,125
2018,4,A,골목상권,1000782,관악로28길,151,71,80
2018,4,A,골목상권,1000781,관악로14길,464,257,207
2018,4,A,골목상권,1000780,관악로10길,223,156,67
2018,4,A,골목상권,1000779,흑석로9길,171,71,100
2018,4,A,골목상권,1000778,흑석로13길,149,11,138
2018,4,A,골목상권,1000777,장승배기로27길,46,21,25
2018,4,A,골목상권,1000776,장승배기로19길,8,4,4
2018,4,A,골목상권,1000774,여의대방로46길,465,161,304
2018,4,A,골목상권,1000773,여의대방로24길,18249,9804,8445
2018,4,A,골목상권,1000772,여의대방로22카길,306,125,181
2018,4,A,골목상권,1000771,여의대방로22나길,129,52,77
2018,4,A,골목상권,1000770,여의대방로22길,248,147,101
2018,4,A,골목상권,1000769,양녕로26길,135,67,68
2018,4,A,골목상권,1000768,신대방길,99,63,36
2018,4,A,골목상권,1000767,성대로29길,3,2,1
2018,4,A,골목상권,1000766,성대로1길,343,143,200
2018,4,A,골목상권,1000765,서달로8가길,247,99,148
2018,4,A,골목상권,1000763,서달로14길,42,18,24
2018,4,A,골목상권,1000762,서달로10길,66,32,34
2018,4,A,골목상권,1000761,상도로62길,185,56,129
2018,4,A,골목상권,1000760,상도로61길,46,21,25
2018,4,A,골목상권,1000759,상도로47길,46,33,13
2018,4,A,골목상권,1000758,상도로37길,1920,932,988
2018,4,A,골목상권,1000757,상도로15길,359,155,204
2018,4,A,골목상권,1000756,사당로8길,121,66,55
2018,4,A,골목상권,1000755,사당로30길,298,204,94
2018,4,A,골목상권,1000754,사당로2차길,113,76,37
2018,4,A,골목상권,1000753,사당로29길,26,22,4
2018,4,A,골목상권,1000752,사당로26길,260,148,112
2018,4,A,골목상권,1000751,사당로23나길,141,45,96
2018,4,A,골목상권,1000750,사당로23길,16,12,4
2018,4,A,골목상권,1000749,사당로20길,194,146,48
2018,4,A,골목상권,1000748,사당로16길,135,40,95
2018,4,A,골목상권,1000747,사당로16가길,772,471,301
2018,4,A,골목상권,1000746,만양로8길,95,46,49
2018,4,A,골목상권,1000745,만양로14길,347,154,193
2018,4,A,골목상권,1000744,등용로14길,670,456,214
2018,4,A,골목상권,1000743,동작대로7길,1829,746,1083
2018,4,A,골목상권,1000742,동작대로35길,945,116,829
2018,4,A,골목상권,1000741,동작대로33길,106,56,50
2018,4,A,골목상권,1000740,동작대로29길,38,21,17
2018,4,A,골목상권,1000739,동작대로17길,1402,710,692
2018,4,A,골목상권,1000738,대방동2길,462,215,247
2018,4,A,골목상권,1000737,대방동27길,125,78,47
2018,4,A,골목상권,1000736,노량진로6길,100,28,72
2018,4,A,골목상권,1000735,국사봉길,48,9,39
2018,4,A,골목상권,1000734,국사봉2길,50,18,32
2018,4,A,골목상권,1000733,국사봉1길,9,3,6
2018,4,A,골목상권,1000732,영신로9길,344,178,166
2018,4,A,골목상권,1000731,영등포로84길,378,96,282
2018,4,A,골목상권,1000730,영등포로80길,55,30,25
2018,4,A,골목상권,1000729,영등포로62길,7,4,3
2018,4,A,골목상권,1000728,영등포로35길,89,54,35
2018,4,A,골목상권,1000727,영등포로27길,301,171,130
2018,4,A,골목상권,1000724,여의대방로43나길,957,683,274
2018,4,A,골목상권,1000723,여의대방로39길,7,3,4
2018,4,A,골목상권,1000722,여의대방로35길,876,459,417
2018,4,A,골목상권,1000721,양평로28길,624,496,128
2018,4,A,골목상권,1000720,양평로22라길,29,15,14
2018,4,A,골목상권,1000719,양평로19길,4563,3515,1048
2018,4,A,골목상권,1000718,신길로60길,497,187,310
2018,4,A,골목상권,1000717,신길로42길,376,182,194
2018,4,A,골목상권,1000716,신길로42가길,99,33,66
2018,4,A,골목상권,1000715,신길로39길,129,52,77
2018,4,A,골목상권,1000714,신길로17길,52,35,17
2018,4,A,골목상권,1000713,선유서로28길,389,214,175
2018,4,A,골목상권,1000712,선유서로25길,2563,1872,691
2018,4,A,골목상권,1000711,선유서로24길,365,209,156
2018,4,A,골목상권,1000710,선유로55길,2479,1517,962
2018,4,A,골목상권,1000709,디지털로74길,46,30,16
2018,4,A,골목상권,1000708,디지털로57길,10,4,6
2018,4,A,골목상권,1000707,디지털로37길,215,99,116
2018,4,A,골목상권,1000706,도신로62길,189,58,131
2018,4,A,골목상권,1000705,도신로60길,64,12,52
2018,4,A,골목상권,1000704,도신로29길,81,35,46
2018,4,A,골목상권,1000703,도신로15길,85,43,42
2018,4,A,골목상권,1000702,도림천로21길,88,36,52
2018,4,A,골목상권,1000701,도림로63길,30,21,9
2018,4,A,골목상권,1000700,도림로147길,1783,1289,494
2018,4,A,골목상권,1000699,도림로112길,27,16,11
2018,4,A,골목상권,1000698,대림로8길,1910,568,1342
2018,4,A,골목상권,1000697,대림로7길,10,6,4
2018,4,A,골목상권,1000696,대림로44길,29,16,13
2018,4,A,골목상권,1000695,대림로34길,192,81,111
2018,4,A,골목상권,1000694,대림로31길,1055,545,510
2018,4,A,골목상권,1000693,대림로29길,1809,920,889
2018,4,A,골목상권,1000692,대림로22길,377,215,162
2018,4,A,골목상권,1000691,당산로46길,4383,2745,1638
2018,4,A,골목상권,1000690,당산로38길,164,113,51
2018,4,A,골목상권,1000689,당산로37길,4244,2743,1501
2018,4,A,골목상권,1000688,당산로31길,4394,2379,2015
2018,4,A,골목상권,1000687,국회대로56길,1741,1124,617
2018,4,A,골목상권,1000686,경인로90길,314,177,137
2018,4,A,골목상권,1000685,경인로80길,1576,1129,447
2018,4,A,골목상권,1000684,경인로77길,709,447,262
2018,4,A,골목상권,1000683,가마산로61길,204,70,134
2018,4,A,골목상권,1000682,시흥대로94길,689,350,339
2018,4,A,골목상권,1000681,시흥대로84길,185,85,100
2018,4,A,골목상권,1000680,시흥대로68길,960,251,709
2018,4,A,골목상권,1000679,시흥대로63길,2949,1450,1499
2018,4,A,골목상권,1000678,시흥대로62가길,443,108,335
2018,4,A,골목상권,1000677,시흥대로36길,409,232,177
2018,4,A,골목상권,1000676,시흥대로22길,511,362,149
2018,4,A,골목상권,1000675,시흥대로153길,640,368,272
2018,4,A,골목상권,1000674,시흥대로150길,537,248,289
2018,4,A,골목상권,1000673,시흥대로141길,653,381,272
2018,4,A,골목상권,1000672,시흥대로138길,18,9,9
2018,4,A,골목상권,1000671,시흥대로120길,470,311,159
2018,4,A,골목상권,1000670,벚꽃로56길,1863,1268,595
2018,4,A,골목상권,1000669,범안로17길,136,82,54
2018,4,A,골목상권,1000668,범안로11길,1073,839,234
2018,4,A,골목상권,1000667,문성로5길,166,58,108
2018,4,A,골목상권,1000666,독산로85길,99,25,74
2018,4,A,골목상권,1000665,독산로78다길,223,97,126
2018,4,A,골목상권,1000664,독산로70길,2,2,0
2018,4,A,골목상권,1000663,독산로64길,115,31,84
2018,4,A,골목상권,1000662,독산로50길,91,34,57
2018,4,A,골목상권,1000661,독산로40길,54,16,38
2018,4,A,골목상권,1000660,독산로108길,731,343,388
2018,4,A,골목상권,1000659,남부순환로112길,14,6,8
2018,4,A,골목상권,1000658,금하로24길,206,70,136
2018,4,A,골목상권,1000657,금하로1길,73,33,40
2018,4,A,골목상권,1000656,금하로14길,26,11,15
2018,4,A,골목상권,1000655,가산로5길,583,456,127
2018,4,A,골목상권,1000654,가산로3길,2320,1764,556
2018,4,A,골목상권,1000653,중앙로1길,1572,1085,487
2018,4,A,골목상권,1000652,중앙로15길,96,50,46
2018,4,A,골목상권,1000651,우마길,41,21,20
2018,4,A,골목상권,1000650,오류로8길,224,105,119
2018,4,A,골목상권,1000649,신도림로13길,828,601,227
2018,4,A,골목상권,1000648,새말로18길,443,295,148
2018,4,A,골목상권,1000647,부일로1길,779,627,152
2018,4,A,골목상권,1000646,부일로15길,181,153,28
2018,4,A,골목상권,1000645,부일로11길,25,6,19
2018,4,A,골목상권,1000644,디지털로32길,1053,556,497
2018,4,A,골목상권,1000643,디지털로32가길,7192,4949,2243
2018,4,A,골목상권,1000642,디지털로27길,389,250,139
2018,4,A,골목상권,1000641,도림로6길,131,59,72
2018,4,A,골목상권,1000640,도림로12길,108,43,65
2018,4,A,골목상권,1000639,남부순환로97길,285,90,195
2018,4,A,골목상권,1000638,구로중앙로8길,199,73,126
2018,4,A,골목상권,1000637,구로중앙로7길,197,73,124
2018,4,A,골목상권,1000636,구로중앙로42길,803,593,210
2018,4,A,골목상권,1000635,구로중앙로34길,602,335,267
2018,4,A,골목상권,1000634,구로중앙로28길,3213,1572,1641
2018,4,A,골목상권,1000633,구로중앙로19길,10,7,3
2018,4,A,골목상권,1000632,구로동로8길,152,43,109
2018,4,A,골목상권,1000631,구로동로7길,171,67,104
2018,4,A,골목상권,1000630,구로동로42길,26,17,9
2018,4,A,골목상권,1000629,구로동로41길,433,292,141
2018,4,A,골목상권,1000628,구로동로38길,36,14,22
2018,4,A,골목상권,1000627,구로동로28길,169,68,101
2018,4,A,골목상권,1000626,구로동로15길,31,9,22
2018,4,A,골목상권,1000625,공원로6가길,288,197,91
2018,4,A,골목상권,1000624,고척로52길,218,69,149
2018,4,A,골목상권,1000623,고척로27다길,206,81,125
2018,4,A,골목상권,1000622,고척로27길,243,113,130
2018,4,A,골목상권,1000621,고척로21나길,217,63,154
2018,4,A,골목상권,1000620,경인로47길,919,504,415
2018,4,A,골목상권,1000619,경인로35길,289,112,177
2018,4,A,골목상권,1000618,경인로31길,58,22,36
2018,4,A,골목상권,1000617,경인로15길,143,61,82
2018,4,A,골목상권,1000616,개봉로3길,225,141,84
2018,4,A,골목상권,1000615,개봉로2길,480,129,351
2018,4,A,골목상권,1000614,개봉로23가길,868,501,367
2018,4,A,골목상권,1000613,개봉로20길,119,68,51
2018,4,A,골목상권,1000612,개봉로1길,52,27,25
2018,4,A,골목상권,1000611,개봉로17다길,194,94,100
2018,4,A,골목상권,1000610,개봉로17길,862,353,509
2018,4,A,골목상권,1000609,개봉로11길,61,11,50
2018,4,A,골목상권,1000608,화곡로64길,1601,953,648
2018,4,A,골목상권,1000607,화곡로59길,480,200,280
2018,4,A,골목상권,1000606,화곡로44나길,757,621,136
2018,4,A,골목상권,1000605,화곡로31길,1208,453,755
2018,4,A,골목상권,1000604,화곡로20길,535,333,202
2018,4,A,골목상권,1000603,화곡로13길,258,97,161
2018,4,A,골목상권,1000602,초원로16길,761,297,464
2018,4,A,골목상권,1000601,초록마을로8길,184,35,149
2018,4,A,골목상권,1000600,초록마을로3길,42,21,21
2018,4,A,골목상권,1000599,월정로20길,4,2,2
2018,4,A,골목상권,1000598,우장산로6길,311,172,139
2018,4,A,골목상권,1000597,양천로73가길,1260,809,451
2018,4,A,골목상권,1000596,양천로71길,216,121,95
2018,4,A,골목상권,1000595,양천로49길,760,595,165
2018,4,A,골목상권,1000594,양천로26길,174,81,93
2018,4,A,골목상권,1000593,양천로24길,385,157,228
2018,4,A,골목상권,1000592,양천로24가길,766,372,394
2018,4,A,골목상권,1000591,양천로14길,241,161,80
2018,4,A,골목상권,1000590,방화대로6라길,806,491,315
2018,4,A,골목상권,1000589,방화대로21길,854,483,371
2018,4,A,골목상권,1000588,등촌로5길,13,5,8
2018,4,A,골목상권,1000587,등촌로55길,540,360,180
2018,4,A,골목상권,1000586,등촌로51길,17,11,6
2018,4,A,골목상권,1000585,등촌로39길,70,27,43
2018,4,A,골목상권,1000584,등촌로13길,188,96,92
2018,4,A,골목상권,1000583,남부순환로11길,378,258,120
2018,4,A,골목상권,1000582,까치산로4길,152,57,95
2018,4,A,골목상권,1000581,국회대로7길,412,237,175
2018,4,A,골목상권,1000580,공항대로8길,226,90,136
2018,4,A,골목상권,1000579,공항대로61길,185,129,56
2018,4,A,골목상권,1000578,공항대로59다길,885,632,253
2018,4,A,골목상권,1000577,공항대로59길,1087,695,392
2018,4,A,골목상권,1000576,공항대로55길,1095,702,393
2018,4,A,골목상권,1000575,공항대로42길,9,5,4
2018,4,A,골목상권,1000574,공항대로38길,273,138,135
2018,4,A,골목상권,1000573,곰달래로60길,587,312,275
2018,4,A,골목상권,1000572,곰달래로53길,53,18,35
2018,4,A,골목상권,1000571,곰달래로47길,38,17,21
2018,4,A,골목상권,1000570,곰달래로31길,11,7,4
2018,4,A,골목상권,1000569,곰달래로25길,796,295,501
2018,4,A,골목상권,1000568,개화동로25길,658,442,216
2018,4,A,골목상권,1000567,개화동로23길,115,75,40
2018,4,A,골목상권,1000566,강서로8길,159,85,74
2018,4,A,골목상권,1000565,강서로5라길,314,185,129
2018,4,A,골목상권,1000564,강서로5나길,95,50,45
2018,4,A,골목상권,1000563,강서로5가길,51,26,25
2018,4,A,골목상권,1000562,강서로47라길,122,60,62
2018,4,A,골목상권,1000561,강서로47길,370,192,178
2018,4,A,골목상권,1000560,강서로45다길,554,351,203
2018,4,A,골목상권,1000559,강서로45길,153,66,87
2018,4,A,골목상권,1000558,강서로35길,164,94,70
2018,4,A,골목상권,1000557,강서로29길,410,183,227
2018,4,A,골목상권,1000556,강서로18길,30,12,18
2018,4,A,골목상권,1000555,강서로17가길,132,57,75
2018,4,A,골목상권,1000554,강서로15길,305,155,150
2018,4,A,골목상권,1000553,가로공원로80길,60,28,32
2018,4,A,골목상권,1000552,가로공원로76가길,28,11,17
2018,4,A,골목상권,1000551,화곡로4길,212,81,131
2018,4,A,골목상권,1000550,화곡로3길,160,51,109
2018,4,A,골목상권,1000549,지양로7길,234,79,155
2018,4,A,골목상권,1000548,중앙로55길,349,179,170
2018,4,A,골목상권,1000547,중앙로51길,128,73,55
2018,4,A,골목상권,1000546,중앙로47길,118,26,92
2018,4,A,골목상권,1000545,중앙로45길,166,59,107
2018,4,A,골목상권,1000544,중앙로36길,2,2,0
2018,4,A,골목상권,1000543,중앙로32길,594,302,292
2018,4,A,골목상권,1000542,중앙로25길,244,70,174
2018,4,A,골목상권,1000541,은행정로7길,521,175,346
2018,4,A,골목상권,1000539,오목로5길,334,183,151
2018,4,A,골목상권,1000538,오목로3길,430,400,30
2018,4,A,골목상권,1000537,오목로30길,145,73,72
2018,4,A,골목상권,1000536,오목로23길,820,483,337
2018,4,A,골목상권,1000535,신월로20길,212,81,131
2018,4,A,골목상권,1000534,신월로15길,771,364,407
2018,4,A,골목상권,1000533,신목로6길,252,140,112
2018,4,A,골목상권,1000532,신목로5길,925,354,571
2018,4,A,골목상권,1000531,신목로2길,94,47,47
2018,4,A,골목상권,1000530,목동중앙서로8가길,178,110,68
2018,4,A,골목상권,1000529,목동중앙서로7길,264,86,178
2018,4,A,골목상권,1000528,목동중앙북로8길,355,110,245
2018,4,A,골목상권,1000527,목동중앙북로16길,257,80,177
2018,4,A,골목상권,1000526,목동중앙본로7길,117,51,66
2018,4,A,골목상권,1000525,목동중앙로3길,111,60,51
2018,4,A,골목상권,1000524,목동중앙로13나길,293,208,85
2018,4,A,골목상권,1000523,목동중앙남로3가길,546,364,182
2018,4,A,골목상권,1000522,목동로9길,2360,1508,852
2018,4,A,골목상권,1000521,목동로19길,1014,363,651
2018,4,A,골목상권,1000519,목동동로12길,385,140,245
2018,4,A,골목상권,1000518,목동남로4길,13,6,7
2018,4,A,골목상권,1000517,남부순환로88길,272,128,144
2018,4,A,골목상권,1000516,남부순환로79길,339,249,90
2018,4,A,골목상권,1000515,남부순환로70길,519,317,202
2018,4,A,골목상권,1000514,남부순환로58길,198,117,81
2018,4,A,골목상권,1000513,남부순환로40길,18,5,13
2018,4,A,골목상권,1000512,남부순환로33길,1247,1018,229
2018,4,A,골목상권,1000511,곰달래로5길,76,46,30
2018,4,A,골목상권,1000510,곰달래로3길,403,213,190
2018,4,A,골목상권,1000509,곰달래로2길,297,157,140
2018,4,A,골목상권,1000508,곰달래로10길,339,235,104
2018,4,A,골목상권,1000507,가로공원로58길,76,15,61
2018,4,A,골목상권,1000506,효창원로93길,86,44,42
2018,4,A,골목상권,1000505,토정로37길,118,54,64
2018,4,A,골목상권,1000504,월드컵로8길,1704,905,799
2018,4,A,골목상권,1000503,월드컵로7길,4,2,2
2018,4,A,골목상권,1000502,월드컵로36길,151,68,83
2018,4,A,골목상권,1000501,월드컵로25길,285,165,120
2018,4,A,골목상권,1000500,월드컵로19길,544,276,268
2018,4,A,골목상권,1000499,월드컵로16길,3917,2018,1899
2018,4,A,골목상권,1000498,월드컵로11길,253,91,162
2018,4,A,골목상권,1000497,월드컵로10길,1552,812,740
2018,4,A,골목상권,1000496,와우산로3길,180,101,79
2018,4,A,골목상권,1000495,와우산로29길,171,87,84
2018,4,A,골목상권,1000494,와우산로29가길,28,16,12
2018,4,A,골목상권,1000493,양화진길,439,309,130
2018,4,A,골목상권,1000492,양화로1길,4169,1985,2184
2018,4,A,골목상권,1000491,양화로11길,395,269,126
2018,4,A,골목상권,1000490,신촌로30길,26,16,10
2018,4,A,골목상권,1000489,신촌로28가길,105,40,65
2018,4,A,골목상권,1000488,신촌로12길,1598,696,902
2018,4,A,골목상권,1000487,숭문길,5291,4015,1276
2018,4,A,골목상권,1000486,숭문8길,110,63,47
2018,4,A,골목상권,1000485,성지3길,479,242,237
2018,4,A,골목상권,1000484,성산로4길,1732,1032,700
2018,4,A,골목상권,1000483,성미산로32길,522,259,263
2018,4,A,골목상권,1000482,성미산로1길,635,489,146
2018,4,A,골목상권,1000481,성미산로11길,1103,767,336
2018,4,A,골목상권,1000480,백범로16길,709,363,346
2018,4,A,골목상권,1000479,방울내로9안길,354,215,139
2018,4,A,골목상권,1000478,모래내로7길,253,117,136
2018,4,A,골목상권,1000477,매봉산로2길,4355,2792,1563
2018,4,A,골목상권,1000476,망원로2길,200,123,77
2018,4,A,골목상권,1000475,망원로11길,1076,531,545
2018,4,A,골목상권,1000474,만리재옛길,1471,632,839
2018,4,A,골목상권,1000473,마포대로4길,181,100,81
2018,4,A,골목상권,1000472,마포대로20길,1015,551,464
2018,4,A,골목상권,1000471,마포대로12길,68,36,32
2018,4,A,골목상권,1000470,동교로38길,193,121,72
2018,4,A,골목상권,1000469,동교로27길,3631,1645,1986
2018,4,A,골목상권,1000468,동교로25길,562,284,278
2018,4,A,골목상권,1000467,동교로19길,4045,2692,1353
2018,4,A,골목상권,1000466,동교로17길,690,359,331
2018,4,A,골목상권,1000465,독막로8길,359,163,196
2018,4,A,골목상권,1000464,독막로32길,494,208,286
2018,4,A,골목상권,1000463,독막로22길,97,51,46
2018,4,A,골목상권,1000462,도화길,992,476,516
2018,4,A,골목상권,1000461,도화4길,405,132,273
2018,4,A,골목상권,1000460,대흥로28길,49,42,7
2018,4,A,골목상권,1000459,대흥로21길,438,83,355
2018,4,A,골목상권,1000458,광성로6길,179,112,67
2018,4,A,골목상권,1000457,홍제내길,103,58,45
2018,4,A,골목상권,1000456,홍연길,82,45,37
2018,4,A,골목상권,1000455,통일로39길,5,5,0
2018,4,A,골목상권,1000454,통일로37길,355,135,220
2018,4,A,골목상권,1000453,통일로11길,9,7,2
2018,4,A,골목상권,1000452,충정로6길,13115,8020,5095
2018,4,A,골목상권,1000451,충정로4길,3082,2015,1067
2018,4,A,골목상권,1000450,증가로6길,209,105,104
2018,4,A,골목상권,1000449,증가로23나길,477,253,224
2018,4,A,골목상권,1000448,증가로20가길,258,94,164
2018,4,A,골목상권,1000447,증가로10길,165,83,82
2018,4,A,골목상권,1000446,응암로1길,389,279,110
2018,4,A,골목상권,1000445,연희로10길,162,109,53
2018,4,A,골목상권,1000444,신촌로37길,104,50,54
2018,4,A,골목상권,1000443,수색로8길,2241,2135,106
2018,4,A,골목상권,1000442,세무서길,336,109,227
2018,4,A,골목상권,1000440,세검정로1길,276,100,176
2018,4,A,골목상권,1000439,북아현로4길,432,91,341
2018,4,A,골목상권,1000438,모래내로15길,126,40,86
2018,4,A,골목상권,1000437,명지대길,401,292,109
2018,4,A,골목상권,1000436,독립문로8길,781,307,474
2018,4,A,골목상권,1000435,가재울로6길,26,18,8
2018,4,A,골목상권,1000434,통일로92길,93,42,51
2018,4,A,골목상권,1000433,통일로87길,224,100,124
2018,4,A,골목상권,1000432,통일로78길,212,59,153
2018,4,A,골목상권,1000430,진흥로1길,556,172,384
2018,4,A,골목상권,1000429,진흥로12길,509,214,295
2018,4,A,골목상권,1000428,증산서길,401,277,124
2018,4,A,골목상권,1000427,증산로9길,84,27,57
2018,4,A,골목상권,1000426,증산로5길,747,388,359
2018,4,A,골목상권,1000425,증산로21길,236,140,96
2018,4,A,골목상권,1000424,증산로17길,683,298,385
2018,4,A,골목상권,1000423,증산로15길,230,87,143
2018,4,A,골목상권,1000422,증산로13길,71,36,35
2018,4,A,골목상권,1000421,응암로34길,60,38,22
2018,4,A,골목상권,1000420,응암로22길,187,67,120
2018,4,A,골목상권,1000419,응암로14길,456,169,287
2018,4,A,골목상권,1000418,응암로13길,301,129,172
2018,4,A,골목상권,1000417,응암로12길,198,115,83
2018,4,A,골목상권,1000416,은평로8길,247,115,132
2018,4,A,골목상권,1000415,은평로3길,301,104,197
2018,4,A,골목상권,1000414,은평로20길,6,2,4
2018,4,A,골목상권,1000413,은평로13길,364,220,144
2018,4,A,골목상권,1000412,은평로10길,287,144,143
2018,4,A,골목상권,1000411,연서로5길,41,15,26
2018,4,A,골목상권,1000410,연서로41길,242,75,167
2018,4,A,골목상권,1000409,연서로3길,113,46,67
2018,4,A,골목상권,1000408,연서로34길,150,57,93
2018,4,A,골목상권,1000407,연서로33길,33,13,20
2018,4,A,골목상권,1000406,연서로29길,300,93,207
2018,4,A,골목상권,1000405,연서로28길,732,356,376
2018,4,A,골목상권,1000404,연서로27길,82,23,59
2018,4,A,골목상권,1000403,연서로21길,290,156,134
2018,4,A,골목상권,1000402,연서로17길,1155,339,816
2018,4,A,골목상권,1000401,연서로16길,263,103,160
2018,4,A,골목상권,1000400,연서로13길,693,206,487
2018,4,A,골목상권,1000399,연서로11길,239,111,128
2018,4,A,골목상권,1000398,역말로9길,20,14,6
2018,4,A,골목상권,1000397,수색로18길,37,22,15
2018,4,A,골목상권,1000396,서오릉로8길,14,2,12
2018,4,A,골목상권,1000395,서오릉로21길,411,99,312
2018,4,A,골목상권,1000394,불광천길,200,99,101
2018,4,A,골목상권,1000393,갈현로7길,913,265,648
2018,4,A,골목상권,1000392,갈현로41길,123,50,73
2018,4,A,골목상권,1000391,갈현로33길,37,8,29
2018,4,A,골목상권,1000390,갈현로1길,203,88,115
2018,4,A,골목상권,1000389,가좌로7길,57,25,32
2018,4,A,골목상권,1000388,한글비석로44길,397,211,186
2018,4,A,골목상권,1000387,한글비석로24길,409,160,249
2018,4,A,골목상권,1000386,한글비석로22길,782,353,429
2018,4,A,골목상권,1000385,석계로1길,110,58,52
2018,4,A,골목상권,1000384,상계로9가길,305,104,201
2018,4,A,골목상권,1000382,상계로12길,19,12,7
2018,4,A,골목상권,1000381,동일로242길,244,161,83
2018,4,A,골목상권,1000380,동일로192길,458,202,256
2018,4,A,골목상권,1000379,동일로173가길,2867,1654,1213
2018,4,A,골목상권,1000378,공릉로58길,148,51,97
2018,4,A,골목상권,1000377,해등로16길,75,59,16
2018,4,A,골목상권,1000376,우이천로4다길,191,115,76
2018,4,A,골목상권,1000375,우이천로32길,91,56,35
2018,4,A,골목상권,1000374,시루봉로23길,49,22,27
2018,4,A,골목상권,1000373,삼양로144길,73,55,18
2018,4,A,골목상권,1000372,방학로6가길,202,109,93
2018,4,A,골목상권,1000371,방학로5길,137,70,67
2018,4,A,골목상권,1000370,방학로15길,304,193,111
2018,4,A,골목상권,1000369,방학로10길,215,104,111
2018,4,A,골목상권,1000367,도봉산4길,320,277,43
2018,4,A,골목상권,1000366,도봉로181길,185,82,103
2018,4,A,골목상권,1000365,도봉로169나길,272,104,168
2018,4,A,골목상권,1000364,도봉로156길,282,144,138
2018,4,A,골목상권,1000363,도봉로152가길,423,345,78
2018,4,A,골목상권,1000362,도봉로147길,557,320,237
2018,4,A,골목상권,1000360,도봉로114길,567,199,368
2018,4,A,골목상권,1000359,도봉로109길,30,9,21
2018,4,A,골목상권,1000358,도당로29길,870,509,361
2018,4,A,골목상권,1000357,도당로19길,190,99,91
2018,4,A,골목상권,1000356,도당로13바길,205,77,128
2018,4,A,골목상권,1000355,도당로13가길,155,66,89
2018,4,A,골목상권,1000354,덕릉로60길,90,54,36
2018,4,A,골목상권,1000353,노해로63다길,649,261,388
2018,4,A,골목상권,1000352,노해로60길,325,140,185
2018,4,A,골목상권,1000351,한천로140길,111,51,60
2018,4,A,골목상권,1000350,한천로139가길,50,29,21
2018,4,A,골목상권,1000349,한천로132길,332,132,200
2018,4,A,골목상권,1000348,한천로130길,279,120,159
2018,4,A,골목상권,1000347,한천로124나길,111,65,46
2018,4,A,골목상권,1000346,한천로109길,608,267,341
2018,4,A,골목상권,1000345,인수봉로79길,158,41,117
2018,4,A,골목상권,1000344,인수봉로72길,82,37,45
2018,4,A,골목상권,1000342,오패산로67길,583,286,297
2018,4,A,골목상권,1000341,오패산로52길,102,36,66
2018,4,A,골목상권,1000340,오패산로30길,10,6,4
2018,4,A,골목상권,1000339,수유로12길,236,153,83
2018,4,A,골목상권,1000338,솔샘로65길,472,202,270
2018,4,A,골목상권,1000337,솔매로50길,704,274,430
2018,4,A,골목상권,1000336,솔매로45길,196,90,106
2018,4,A,골목상권,1000335,솔매로41길,86,21,65
2018,4,A,골목상권,1000334,삼양로93길,17,4,13
2018,4,A,골목상권,1000333,삼양로77길,419,147,272
2018,4,A,골목상권,1000332,삼양로54길,8,4,4
2018,4,A,골목상권,1000331,삼양로41길,306,141,165
2018,4,A,골목상권,1000329,삼양로24길,101,51,50
2018,4,A,골목상권,1000328,삼양로20길,137,48,89
2018,4,A,골목상권,1000327,삼각산로28길,833,401,432
2018,4,A,골목상권,1000326,도봉로99길,217,103,114
2018,4,A,골목상권,1000325,도봉로8길,258,196,62
2018,4,A,골목상권,1000324,도봉로76길,389,212,177
2018,4,A,골목상권,1000323,도봉로67길,6,3,3
2018,4,A,골목상권,1000322,도봉로45길,113,67,46
2018,4,A,골목상권,1000321,도봉로18길,382,178,204
2018,4,A,골목상권,1000320,도봉로13길,26,9,17
2018,4,A,골목상권,1000319,덕릉로41길,794,628,166
2018,4,A,골목상권,1000318,덕릉로40길,919,715,204
2018,4,A,골목상권,1000317,노해로33길,32,11,21
2018,4,A,골목상권,1000315,노해로17길,252,75,177
2018,4,A,골목상권,1000314,화랑로40길,185,103,82
2018,4,A,골목상권,1000313,화랑로32길,466,349,117
2018,4,A,골목상권,1000312,화랑로1길,161,85,76
2018,4,A,골목상권,1000311,화랑로19길,561,316,245
2018,4,A,골목상권,1000310,화랑로14길,33,15,18
2018,4,A,골목상권,1000309,화랑로13길,83,40,43
2018,4,A,골목상권,1000308,한천로76길,135,77,58
2018,4,A,골목상권,1000307,한천로101가길,46,28,18
2018,4,A,골목상권,1000306,창경궁로43길,29,21,8
2018,4,A,골목상권,1000305,지봉로20길,118,67,51
2018,4,A,골목상권,1000304,종암로5길,132,88,44
2018,4,A,골목상권,1000303,종암로24가길,294,137,157
2018,4,A,골목상권,1000302,종암로21길,250,44,206
2018,4,A,골목상권,1000301,종암로19길,408,132,276
2018,4,A,골목상권,1000300,종암로16길,89,38,51
2018,4,A,골목상권,1000299,정릉로8길,196,116,80
2018,4,A,골목상권,1000298,정릉로27길,212,95,117
2018,4,A,골목상권,1000296,장위로50길,685,411,274
2018,4,A,골목상권,1000295,장월로1길,341,173,168
2018,4,A,골목상권,1000294,인촌로6길,3273,1916,1357
2018,4,A,골목상권,1000293,인촌로5길,26,2,24
2018,4,A,골목상권,1000292,인촌로24길,236,154,82
2018,4,A,골목상권,1000291,개운사길,3713,2231,1482
2018,4,A,골목상권,1000290,인촌로1길,150,102,48
2018,4,A,골목상권,1000289,인촌로17가길,3323,1184,2139
2018,4,A,골목상권,1000288,오패산로4길,624,194,430
2018,4,A,골목상권,1000287,오패산로3길,1178,659,519
2018,4,A,골목상권,1000286,오패산로19길,41,18,23
2018,4,A,골목상권,1000285,안암로5길,612,379,233
2018,4,A,골목상권,1000284,아리랑로4길,558,217,341
2018,4,A,골목상권,1000283,솔샘로6길,154,70,84
2018,4,A,골목상권,1000282,성북로8길,56,25,31
2018,4,A,골목상권,1000281,삼양로8길,65,41,24
2018,4,A,골목상권,1000280,삼선교로16가길,735,419,316
2018,4,A,골목상권,1000279,삼선교로10다길,94,52,42
2018,4,A,골목상권,1000278,삼선교로10길,295,123,172
2018,4,A,골목상권,1000277,보문로32길,1017,413,604
2018,4,A,골목상권,1000276,보문로31길,702,285,417
2018,4,A,골목상권,1000274,보문로13길,931,600,331
2018,4,A,골목상권,1000273,보국문로16길,389,251,138
2018,4,A,골목상권,1000270,동소문로26가길,230,109,121
2018,4,A,골목상권,1000269,동소문로15길,128,57,71
2018,4,A,골목상권,1000268,동소문로13길,435,223,212
2018,4,A,골목상권,1000267,돌곶이로8길,182,87,95
2018,4,A,골목상권,1000266,돌곶이로41길,43,20,23
2018,4,A,골목상권,1000265,돌곶이로28길,227,143,84
2018,4,A,골목상권,1000264,돌곶이로27길,71,45,26
2018,4,A,골목상권,1000263,돌곶이로22길,132,68,64
2018,4,A,골목상권,1000261,길음로7길,8,5,3
2018,4,A,골목상권,1000260,중랑천로10길,770,382,388
2018,4,A,골목상권,1000259,용마산로94길,456,279,177
2018,4,A,골목상권,1000258,용마산로118길,566,275,291
2018,4,A,골목상권,1000257,용마산로112길,356,151,205
2018,4,A,골목상권,1000256,용마산로100길,433,294,139
2018,4,A,골목상권,1000255,신내로7가길,276,67,209
2018,4,A,골목상권,1000254,사가정로54길,135,46,89
2018,4,A,골목상권,1000253,사가정로42길,84,24,60
2018,4,A,골목상권,1000252,봉화산로56길,558,151,407
2018,4,A,골목상권,1000251,봉화산로4길,412,158,254
2018,4,A,골목상권,1000250,봉화산로30길,354,217,137
2018,4,A,골목상권,1000249,봉우재로33길,114,43,71
2018,4,A,골목상권,1000248,면목로78길,254,146,108
2018,4,A,골목상권,1000247,면목로56길,205,154,51
2018,4,A,골목상권,1000246,면목로55길,364,109,255
2018,4,A,골목상권,1000245,면목로49길,545,182,363
2018,4,A,골목상권,1000244,면목로48길,122,61,61
2018,4,A,골목상권,1000243,면목로45길,67,30,37
2018,4,A,골목상권,1000242,면목로33길,405,163,242
2018,4,A,골목상권,1000241,면목로21길,32,25,7
2018,4,A,골목상권,1000240,망우로73길,8,4,4
2018,4,A,골목상권,1000239,망우로68길,83,28,55
2018,4,A,골목상권,1000238,동일로163길,90,57,33
2018,4,A,골목상권,1000237,동일로157길,223,122,101
2018,4,A,골목상권,1000236,동일로149길,1154,859,295
2018,4,A,골목상권,1000235,동일로140길,189,84,105
2018,4,A,골목상권,1000234,동일로139길,64,35,29
2018,4,A,골목상권,1000233,동일로139가길,1207,688,519
2018,4,A,골목상권,1000232,동일로130길,118,46,72
2018,4,A,골목상권,1000231,동일로123길,184,96,88
2018,4,A,골목상권,1000230,동일로112길,156,71,85
2018,4,A,골목상권,1000229,동일로101길,289,116,173
2018,4,A,골목상권,1000228,동일로100길,74,36,38
2018,4,A,골목상권,1000227,답십리로75길,106,55,51
2018,4,A,골목상권,1000226,공릉로2길,665,299,366
2018,4,A,골목상권,1000225,공릉로12가길,28,19,9
2018,4,A,골목상권,1000224,겸재로54길,107,44,63
2018,4,A,골목상권,1000223,겸재로36길,242,195,47
2018,4,A,골목상권,1000222,겸재로29길,449,182,267
2018,4,A,골목상권,1000221,휘경로3길,232,114,118
2018,4,A,골목상권,1000220,휘경로2길,9,2,7
2018,4,A,골목상권,1000219,휘경로23길,19,4,15
2018,4,A,골목상권,1000218,휘경로14길,128,46,82
2018,4,A,골목상권,1000217,한천로46길,323,95,228
2018,4,A,골목상권,1000216,한천로40길,302,150,152
2018,4,A,골목상권,1000215,한천로33길,81,40,41
2018,4,A,골목상권,1000214,한천로14길,584,344,240
2018,4,A,골목상권,1000213,천호대로97길,343,218,125
2018,4,A,골목상권,1000212,천호대로77길,2055,1049,1006
2018,4,A,골목상권,1000211,천호대로45길,122,66,56
2018,4,A,골목상권,1000210,천호대로17길,2257,1465,792
2018,4,A,골목상권,1000209,천호대로12길,806,529,277
2018,4,A,골목상권,1000208,천장산로7길,1481,901,580
2018,4,A,골목상권,1000207,제기로5길,224,95,129
2018,4,A,골목상권,1000206,제기로21길,232,153,79
2018,4,A,골목상권,1000205,전농로4길,689,425,264
2018,4,A,골목상권,1000204,전농로3길,73,36,37
2018,4,A,골목상권,1000203,전농로29길,321,141,180
2018,4,A,골목상권,1000202,장한로8길,802,474,328
2018,4,A,골목상권,1000201,장한로5길,3043,2165,878
2018,4,A,골목상권,1000200,장한로27길,140,39,101
2018,4,A,골목상권,1000199,장한로27가길,422,201,221
2018,4,A,골목상권,1000198,장한로26길,533,253,280
2018,4,A,골목상권,1000197,장한로26가길,328,151,177
2018,4,A,골목상권,1000196,장한로25길,1042,478,564
2018,4,A,골목상권,1000195,장한로14길,184,150,34
2018,4,A,골목상권,1000194,이문로42길,270,115,155
2018,4,A,골목상권,1000193,왕산로43길,897,386,511
2018,4,A,골목상권,1000192,왕산로33길,158,108,50
2018,4,A,골목상권,1000191,왕산로32길,6,5,1
2018,4,A,골목상권,1000190,약령시로17길,340,163,177
2018,4,A,골목상권,1000189,서울시립대로4길,659,356,303
2018,4,A,골목상권,1000188,서울시립대로29길,221,123,98
2018,4,A,골목상권,1000187,서울시립대로16길,136,32,104
2018,4,A,골목상권,1000186,사가정로2길,86,67,19
2018,4,A,골목상권,1000185,사가정로23가길,98,64,34
2018,4,A,골목상권,1000184,사가정로13길,278,82,196
2018,4,A,골목상권,1000183,무학로45길,345,204,141
2018,4,A,골목상권,1000182,무학로16길,1213,1110,103
2018,4,A,골목상권,1000181,망우로21길,196,103,93
2018,4,A,골목상권,1000180,망우로18길,363,121,242
2018,4,A,골목상권,1000179,망우로18가길,71,30,41
2018,4,A,골목상권,1000178,답십리로72길,4,2,2
2018,4,A,골목상권,1000177,답십리로69길,926,401,525
2018,4,A,골목상권,1000176,답십리로68길,97,60,37
2018,4,A,골목상권,1000175,답십리로64길,355,213,142
2018,4,A,골목상권,1000174,답십리로63길,81,50,31
2018,4,A,골목상권,1000173,답십리로60길,14,6,8
2018,4,A,골목상권,1000172,답십리로56길,16,13,3
2018,4,A,골목상권,1000171,답십리로23길,6,4,2
2018,4,A,골목상권,1000170,난계로30길,131,89,42
2018,4,A,골목상권,1000168,경희대로3길,289,185,104
2018,4,A,골목상권,1000167,천호대로129길,230,85,145
2018,4,A,골목상권,1000166,천호대로123길,294,114,180
2018,4,A,골목상권,1000165,천호대로109길,1212,662,550
2018,4,A,골목상권,1000164,자양번영로3길,87,37,50
2018,4,A,골목상권,1000163,자양로53길,2,1,1
2018,4,A,골목상권,1000162,자양로50길,24,9,15
2018,4,A,골목상권,1000161,자양로45길,570,294,276
2018,4,A,골목상권,1000160,자양로26길,298,112,186
2018,4,A,골목상권,1000159,자양로15길,331,227,104
2018,4,A,골목상권,1000158,자양로11길,1347,689,658
2018,4,A,골목상권,1000157,용마산로3길,1005,588,417
2018,4,A,골목상권,1000156,용마산로21길,171,84,87
2018,4,A,골목상권,1000155,아차산로78길,2678,1322,1356
2018,4,A,골목상권,1000154,아차산로65길,675,447,228
2018,4,A,골목상권,1000153,아차산로55길,398,219,179
2018,4,A,골목상권,1000152,아차산로51길,243,144,99
2018,4,A,골목상권,1000151,아차산로40길,536,306,230
2018,4,A,골목상권,1000150,면목로17길,272,174,98
2018,4,A,골목상권,1000149,뚝섬로64길,300,162,138
2018,4,A,골목상권,1000148,뚝섬로58길,189,61,128
2018,4,A,골목상권,1000147,뚝섬로54길,152,93,59
2018,4,A,골목상권,1000146,뚝섬로48길,847,387,460
2018,4,A,골목상권,1000145,뚝섬로24길,96,30,66
2018,4,A,골목상권,1000144,뚝섬로23길,110,63,47
2018,4,A,골목상권,1000143,동일로24길,16,4,12
2018,4,A,골목상권,1000142,동일로18길,200,84,116
2018,4,A,골목상권,1000141,능동로4길,236,101,135
2018,4,A,골목상권,1000140,능동로3길,204,99,105
2018,4,A,골목상권,1000139,능동로34길,911,509,402
2018,4,A,골목상권,1000138,능동로19길,324,212,112
2018,4,A,골목상권,1000137,능동로13길,332,138,194
2018,4,A,골목상권,1000136,긴고랑로9길,47,24,23
2018,4,A,골목상권,1000135,긴고랑로8길,224,178,46
2018,4,A,골목상권,1000134,긴고랑로7길,497,246,251
2018,4,A,골목상권,1000133,긴고랑로20길,587,283,304
2018,4,A,골목상권,1000132,광나루로52길,1932,882,1050
2018,4,A,골목상권,1000131,광나루로40길,137,63,74
2018,4,A,골목상권,1000130,광나루로37길,306,186,120
2018,4,A,골목상권,1000129,광나루로36길,50,30,20
2018,4,A,골목상권,1000128,광나루로24길,83,47,36
2018,4,A,골목상권,1000127,광나루로12길,1047,586,461
2018,4,A,골목상권,1000126,한림말길,65,35,30
2018,4,A,골목상권,1000124,청계천로10나길,1826,1072,754
2018,4,A,골목상권,1000123,장터길,39,15,24
2018,4,A,골목상권,1000122,용답중앙길,92,47,45
2018,4,A,골목상권,1000121,용답29길,1708,902,806
2018,4,A,골목상권,1000120,왕십리로6길,1457,808,649
2018,4,A,골목상권,1000119,왕십리로31길,81,42,39
2018,4,A,골목상권,1000118,왕십리로26길,4069,2485,1584
2018,4,A,골목상권,1000117,왕십리로21길,196,65,131
2018,4,A,골목상권,1000116,왕십리로14길,2760,1981,779
2018,4,A,골목상권,1000115,아차산로5길,2254,1475,779
2018,4,A,골목상권,1000114,아차산로15길,4423,3129,1294
2018,4,A,골목상권,1000113,아차산로11길,3763,2445,1318
2018,4,A,골목상권,1000112,송정4가길,1033,447,586
2018,4,A,골목상권,1000111,송정12라길,266,184,82
2018,4,A,골목상권,1000110,성수일로6길,2624,1639,985
2018,4,A,골목상권,1000109,성수이로7길,558,315,243
2018,4,A,골목상권,1000108,성수이로18길,2355,1649,706
2018,4,A,골목상권,1000107,성덕정길,897,521,376
2018,4,A,골목상권,1000106,성덕정17길,234,123,111
2018,4,A,골목상권,1000105,서울숲2길,1098,643,455
2018,4,A,골목상권,1000104,상원길,1553,997,556
2018,4,A,골목상권,1000103,상원12길,170,105,65
2018,4,A,골목상권,1000102,사근동길,30,18,12
2018,4,A,골목상권,1000101,무학봉길,5,3,2
2018,4,A,골목상권,1000100,무학봉28길,134,60,74
2018,4,A,골목상권,1000099,무학로6길,387,216,171
2018,4,A,골목상권,1000098,무수막길,153,74,79
2018,4,A,골목상권,1000097,매봉길,10,7,3
2018,4,A,골목상권,1000096,마조로1길,216,79,137
2018,4,A,골목상권,1000095,마조로16길,839,589,250
2018,4,A,골목상권,1000094,마장로39길,107,51,56
2018,4,A,골목상권,1000093,마장로27길,77,22,55
2018,4,A,골목상권,1000091,둘레9길,391,231,160
2018,4,A,골목상권,1000090,금호산길,436,156,280
2018,4,A,골목상권,1000089,금호산2길,36,12,24
2018,4,A,골목상권,1000088,고산자로6길,9832,3564,6268
2018,4,A,골목상권,1000087,후암로28길,209,92,117
2018,4,A,골목상권,1000086,효창원로39길,57,31,26
2018,4,A,골목상권,1000085,회나무로13길,85,46,39
2018,4,A,골목상권,1000084,한남대로20길,772,432,340
2018,4,A,골목상권,1000082,한강대로7길,491,331,160
2018,4,A,골목상권,1000081,한강대로62길,742,505,237
2018,4,A,골목상권,1000080,한강대로52길,1146,735,411
2018,4,A,골목상권,1000079,한강대로43길,5969,3751,2218
2018,4,A,골목상권,1000078,한강대로15길,1230,345,885
2018,4,A,골목상권,1000077,한강대로104길,11313,4081,7232
2018,4,A,골목상권,1000076,청파로73길,1175,614,561
2018,4,A,골목상권,1000075,청파로71길,228,112,116
2018,4,A,골목상권,1000074,청파로47나길,171,97,74
2018,4,A,골목상권,1000073,청파로47길,969,423,546
2018,4,A,골목상권,1000072,장문로45길,55,13,42
2018,4,A,골목상권,1000071,이태원로54길,2259,1093,1166
2018,4,A,골목상권,1000070,이태원로27길,629,356,273
2018,4,A,골목상권,1000069,이촌로22길,279,165,114
2018,4,A,골목상권,1000068,원효로89길,893,734,159
2018,4,A,골목상권,1000067,원효로53길,867,532,335
2018,4,A,골목상권,1000066,원효로41길,1490,1016,474
2018,4,A,골목상권,1000065,원효로19길,1038,733,305
2018,4,A,골목상권,1000064,우사단로4길,152,91,61
2018,4,A,골목상권,1000063,우사단로14길,1886,905,981
2018,4,A,골목상권,1000062,우사단로10길,87,39,48
2018,4,A,골목상권,1000061,신흥로20길,216,93,123
2018,4,A,골목상권,1000060,소월로20길,136,53,83
2018,4,A,골목상권,1000059,서빙고로71길,469,283,186
2018,4,A,골목상권,1000058,백범로90길,256,155,101
2018,4,A,골목상권,1000057,백범로79길,725,440,285
2018,4,A,골목상권,1000056,두텁바위로1길,2758,1484,1274
2018,4,A,골목상권,1000055,대사관로34길,291,142,149
2018,4,A,골목상권,1000054,녹사평대로46길,74,46,28
2018,4,A,골목상권,1000053,녹사평대로40나길,65,29,36
2018,4,A,골목상권,1000052,녹사평대로32길,389,218,171
2018,4,A,골목상권,1000051,녹사평대로26길,2081,1090,991
2018,4,A,골목상권,1000050,녹사평대로11길,267,175,92
2018,4,A,골목상권,1000049,퇴계로90길,599,220,379
2018,4,A,골목상권,1000048,퇴계로8길,2397,1293,1104
2018,4,A,골목상권,1000047,퇴계로56길,1285,1042,243
2018,4,A,골목상권,1000046,퇴계로46길,2119,1001,1118
2018,4,A,골목상권,1000045,퇴계로18길,3099,1354,1745
2018,4,A,골목상권,1000044,퇴계로12길,1154,488,666
2018,4,A,골목상권,1000043,청구로1길,250,84,166
2018,4,A,골목상권,1000042,청구로17길,1721,804,917
2018,4,A,골목상권,1000041,장충단로8길,3242,1195,2047
2018,4,A,골목상권,1000040,삼일대로4길,957,571,386
2018,4,A,골목상권,1000039,명동길,36306,17786,18520
2018,4,A,골목상권,1000037,동호로20길,854,337,517
2018,4,A,골목상권,1000036,동호로15길,4108,2168,1940
2018,4,A,골목상권,1000035,동호로11길,17,11,6
2018,4,A,골목상권,1000034,동호로10길,1587,702,885
2018,4,A,골목상권,1000033,다산로39길,1339,742,597
2018,4,A,골목상권,1000032,다산로38길,1628,724,904
2018,4,A,골목상권,1000031,다산로36길,70,42,28
2018,4,A,골목상권,1000030,다산로33길,396,202,194
2018,4,A,골목상권,1000029,난계로21길,252,160,92
2018,4,A,골목상권,1000028,난계로11길,1823,1066,757
2018,4,A,골목상권,1000027,필운대로1길,4,1,3
2018,4,A,골목상권,1000026,평창길,206,101,105
2018,4,A,골목상권,1000025,통일로12길,236,94,142
2018,4,A,골목상권,1000024,창신길,271,69,202
2018,4,A,골목상권,1000023,창신5길,8,3,5
2018,4,A,골목상권,1000022,창신2길,56,26,30
2018,4,A,골목상권,1000021,창경궁로35길,1114,326,788
2018,4,A,골목상권,1000020,지봉로8길,195,97,98
2018,4,A,골목상권,1000019,종로65길,486,250,236
2018,4,A,골목상권,1000016,자하문로7길,624,398,226
2018,4,A,골목상권,1000015,이화장길,1996,960,1036
2018,4,A,골목상권,1000014,율곡로16길,103,90,13
2018,4,A,골목상권,1000013,율곡로10길,2228,1612,616
2018,4,A,골목상권,1000012,옥인길,469,195,274
2018,4,A,골목상권,1000011,숭인동길,24,5,19
2018,4,A,골목상권,1000010,성균관로5길,133,82,51
2018,4,A,골목상권,1000009,삼청로5길,449,169,280
2018,4,A,골목상권,1000008,북촌로5나길,1693,1128,565
2018,4,A,골목상권,1000007,북촌로5길,57,24,33
2018,4,A,골목상권,1000006,북촌로11길,12,5,7
2018,4,A,골목상권,1000005,백석동길,139,73,66
2018,4,A,골목상권,1000004,명륜길,18,8,10
2018,4,A,골목상권,1000003,돈화문로11가길,1048,569,479
2018,4,A,골목상권,1000001,계동길,829,356,473
2018,3,U,관광특구,1001496,강남 마이스 관광특구,22562,12970,9592
2018,3,U,관광특구,1001495,잠실 관광특구,30675,17928,12747
2018,3,U,관광특구,1001494,종로?청계 관광특구,31692,19002,12690
2018,3,U,관광특구,1001493,동대문패션타운 관광특구,10568,5953,4615
2018,3,U,관광특구,1001492,명동 남대문 북창동 다동 무교동 관광특구,158818,77955,80863
2018,3,U,관광특구,1001491,이태원 관광특구,5857,3193,2664
2018,3,R,전통시장,1001490,길동복조리시장,471,321,150
2018,3,R,전통시장,1001489,둔촌역전통시장,169,79,90
2018,3,R,전통시장,1001488,성내골목시장,6,2,4
2018,3,R,전통시장,1001487,천호시장,9,4,5
2018,3,R,전통시장,1001483,암사종합시장,829,387,442
2018,3,R,전통시장,1001482,고덕전통시장,400,387,13
2018,3,R,전통시장,1001481,명일골목시장,531,208,323
2018,3,R,전통시장,1001480,새마을시장,385,227,158
2018,3,R,전통시장,1001479,석촌시장,165,98,67
2018,3,R,전통시장,1001478,방이시장,611,372,239
2018,3,R,전통시장,1001477,마천시장,216,77,139
2018,3,R,전통시장,1001476,풍납시장,10,2,8
2018,3,R,전통시장,1001475,강남개포시장,36,31,5
2018,3,R,전통시장,1001474,도곡시장,484,215,269
2018,3,R,전통시장,1001471,영동전통시장,3036,2192,844
2018,3,R,전통시장,1001466,미성동도깨비시장,409,167,242
2018,3,R,전통시장,1001465,신신림시장,3,2,1
2018,3,R,전통시장,1001464,삼성동시장,94,38,56
2018,3,R,전통시장,1001463,신림중앙시장,12,7,5
2018,3,R,전통시장,1001462,강남골목시장,262,139,123
2018,3,R,전통시장,1001460,관악신사시장,171,79,92
2018,3,R,전통시장,1001459,신원시장,330,124,206
2018,3,R,전통시장,1001458,인헌시장,204,95,109
2018,3,R,전통시장,1001456,봉천현대시장,10,4,6
2018,3,R,전통시장,1001454,봉천제일종합시장,62,31,31
2018,3,R,전통시장,1001453,낙성대시장,16,9,7
2018,3,R,전통시장,1001452,중부시장,185,54,131
2018,3,R,전통시장,1001450,남성역골목시장,563,254,309
2018,3,R,전통시장,1001449,남성사계시장,1983,874,1109
2018,3,R,전통시장,1001448,흑석시장,171,54,117
2018,3,R,전통시장,1001447,상도4동도깨비골목시장,327,84,243
2018,3,R,전통시장,1001445,영도시장,83,41,42
2018,3,R,전통시장,1001441,본동인정시장,134,73,61
2018,3,R,전통시장,1001439,대림중앙시장,20,9,11
2018,3,R,전통시장,1001438,우리시장,18,9,9
2018,3,R,전통시장,1001437,영진시장A동,47,41,6
2018,3,R,전통시장,1001436,사러가시장,34,12,22
2018,3,R,전통시장,1001431,영등포청과시장,218,143,75
2018,3,R,전통시장,1001430,영등포전통시장,4063,1979,2084
2018,3,R,전통시장,1001429,은행나무시장,69,14,55
2018,3,R,전통시장,1001427,현대시장,45,11,34
2018,3,R,전통시장,1001424,남문시장,271,114,157
2018,3,R,전통시장,1001423,독산동 우시장,137,58,79
2018,3,R,전통시장,1001421,개봉중앙시장,10,5,5
2018,3,R,전통시장,1001419,가리봉시장,16,13,3
2018,3,R,전통시장,1001418,남구로시장,13,3,10
2018,3,R,전통시장,1001417,구로시장,60,19,41
2018,3,R,전통시장,1001415,방신전통시장,47,26,21
2018,3,R,전통시장,1001414,송화골목시장,563,187,376
2018,3,R,전통시장,1001413,까치산시장,46,27,19
2018,3,R,전통시장,1001411,남부골목시장,217,92,125
2018,3,R,전통시장,1001409,화곡중앙골목시장,2,2,0
2018,3,R,전통시장,1001407,등마루시장,799,452,347
2018,3,R,전통시장,1001406,신정3동골목시장,181,94,87
2018,3,R,전통시장,1001405,신정2동골목시장,6,6,0
2018,3,R,전통시장,1001402,신월6동골목시장,229,123,106
2018,3,R,전통시장,1001401,신곡종합시장,13,9,4
2018,3,R,전통시장,1001400,신월3동골목시장,68,24,44
2018,3,R,전통시장,1001399,경창시장,208,85,123
2018,3,R,전통시장,1001398,월정로시장,123,71,52
2018,3,R,전통시장,1001397,신영시장,56,20,36
2018,3,R,전통시장,1001396,목4동시장,211,70,141
2018,3,R,전통시장,1001395,목3동시장,768,376,392
2018,3,R,전통시장,1001394,목2동시장,228,108,120
2018,3,R,전통시장,1001393,마포농수산물시장,461,295,166
2018,3,R,전통시장,1001391,망원월드컵시장,16,11,5
2018,3,R,전통시장,1001390,망원시장,60,30,30
2018,3,R,전통시장,1001386,신수시장,121,83,38
2018,3,R,전통시장,1001385,아현시장,25,5,20
2018,3,R,전통시장,1001374,대림골목시장,411,134,277
2018,3,R,전통시장,1001367,상계중앙시장,42,20,22
2018,3,R,전통시장,1001364,방학동도깨비시장,160,66,94
2018,3,R,전통시장,1001363,쌍문역골목시장,71,35,36
2018,3,R,전통시장,1001361,신도봉시장,28,15,13
2018,3,R,전통시장,1001359,창동신창시장,141,60,81
2018,3,R,전통시장,1001358,수유북부시장,12,2,10
2018,3,R,전통시장,1001357,장미원골목시장,67,41,26
2018,3,R,전통시장,1001356,수유중앙시장,127,67,60
2018,3,R,전통시장,1001355,강북종합시장,65,28,37
2018,3,R,전통시장,1001354,우이시장,157,52,105
2018,3,R,전통시장,1001353,수유전통시장,411,152,259
2018,3,R,전통시장,1001352,번동북부골목시장,84,44,40
2018,3,R,전통시장,1001351,솔샘시장,109,45,64
2018,3,R,전통시장,1001349,방천골목시장,77,28,49
2018,3,R,전통시장,1001347,석관황금시장,78,26,52
2018,3,R,전통시장,1001343,장위전통시장,190,76,114
2018,3,R,전통시장,1001340,정릉시장,37,13,24
2018,3,R,전통시장,1001339,정릉아리랑시장,2,1,1
2018,3,R,전통시장,1001338,돈암제일시장,52,19,33
2018,3,R,전통시장,1001336,우림골목시장,218,108,110
2018,3,R,전통시장,1001335,묵1동도깨비시장,290,125,165
2018,3,R,전통시장,1001334,태능시장,3,1,2
2018,3,R,전통시장,1001333,중화제일시장,22,1,21
2018,3,R,전통시장,1001332,사가정시장,245,172,73
2018,3,R,전통시장,1001330,동원시장,72,35,37
2018,3,R,전통시장,1001329,동부골목시장,105,37,68
2018,3,R,전통시장,1001326,회기시장,114,52,62
2018,3,R,전통시장,1001323,답십리시장,31,10,21
2018,3,R,전통시장,1001321,답십리현대시장,98,79,19
2018,3,R,전통시장,1001319,청량리종합시장,10,6,4
2018,3,R,전통시장,1001317,청량리농수산물시장,21,16,5
2018,3,R,전통시장,1001316,서울약령시장,1319,793,526
2018,3,R,전통시장,1001313,청량리수산시장,227,115,112
2018,3,R,전통시장,1001310,구의시장,132,80,52
2018,3,R,전통시장,1001309,조양시장,91,48,43
2018,3,R,전통시장,1001308,영동교골목시장,18,12,6
2018,3,R,전통시장,1001307,능동로골목시장,275,240,35
2018,3,R,전통시장,1001304,자양골목시장,97,51,46
2018,3,R,전통시장,1001301,중곡제일시장,130,65,65
2018,3,R,전통시장,1001299,한아름시장,174,93,81
2018,3,R,전통시장,1001298,성동용답상가시장,312,155,157
2018,3,R,전통시장,1001297,뚝도시장,35,14,21
2018,3,R,전통시장,1001296,금남시장,29,13,16
2018,3,R,전통시장,1001295,행당시장,257,122,135
2018,3,R,전통시장,1001294,마장축산물시장,1516,1018,498
2018,3,R,전통시장,1001289,용문전통시장,41,20,21
2018,3,R,전통시장,1001286,후암시장,48,19,29
2018,3,R,전통시장,1001285,합동(새벽)시장,2365,1366,999
2018,3,R,전통시장,1001284,서울중앙시장,278,184,94
2018,3,R,전통시장,1001283,백학시장,463,238,225
2018,3,R,전통시장,1001282,약수시장,1786,703,1083
2018,3,R,전통시장,1001281,청평화시장,3360,2011,1349
2018,3,R,전통시장,1001280,제일평화시장,570,325,245
2018,3,R,전통시장,1001278,남평화시장,200,123,77
2018,3,R,전통시장,1001277,방산종합시장,1879,1180,699
2018,3,R,전통시장,1001275,인현시장,1084,665,419
2018,3,R,전통시장,1001274,신중부시장,2437,1607,830
2018,3,R,전통시장,1001273,남대문시장,7146,3645,3501
2018,3,R,전통시장,1001271,동묘시장,903,568,335
2018,3,R,전통시장,1001270,창신골목시장,223,116,107
2018,3,R,전통시장,1001268,충신시장,297,182,115
2018,3,R,전통시장,1001267,종로신진시장,39,19,20
2018,3,R,전통시장,1001266,동대문종합시장,320,185,135
2018,3,R,전통시장,1001265,광장시장,204,152,52
2018,3,D,발달상권,1001263,서울 노원구 노원역_3,775,329,446
2018,3,D,발달상권,1001261,서울 노원구 노원역_1,1068,309,759
2018,3,D,발달상권,1001260,창동역,2477,1573,904
2018,3,D,발달상권,1001259,서울 강북구 수유역_3,64,32,32
2018,3,D,발달상권,1001257,서울 강북구 수유역_2,4370,2230,2140
2018,3,D,발달상권,1001256,서울 강북구 수유역_1,43,30,13
2018,3,D,발달상권,1001255,서울 은평구 연신내역_3,676,207,469
2018,3,D,발달상권,1001254,서울 은평구 연신내역_2,451,195,256
2018,3,D,발달상권,1001253,서울 은평구 연신내역_1,74,30,44
2018,3,D,발달상권,1001252,서울 성북구 미아삼거리역_2,507,206,301
2018,3,D,발달상권,1001251,서울 강북구 미아삼거리역_1,542,200,342
2018,3,D,발달상권,1001250,서울 은평구 불광역_3,54,19,35
2018,3,D,발달상권,1001249,서울 은평구 불광역_2,69,26,43
2018,3,D,발달상권,1001248,서울 은평구 불광역_1,284,113,171
2018,3,D,발달상권,1001247,미아사거리_2,121,41,80
2018,3,D,발달상권,1001246,미아사거리_1,621,283,338
2018,3,D,발달상권,1001245,서울 성북구 성신여대입구역,5286,3156,2130
2018,3,D,발달상권,1001244,경희대학교,370,178,192
2018,3,D,발달상권,1001243,서울 성북구 안암역,112,69,43
2018,3,D,발달상권,1001242,혜화역 대학로_3,1727,826,901
2018,3,D,발달상권,1001241,혜화역 대학로_2,1513,820,693
2018,3,D,발달상권,1001240,혜화역 대학로_1,1225,637,588
2018,3,D,발달상권,1001239,디지털미디어시티,17010,11036,5974
2018,3,D,발달상권,1001238,서울 동대문구 청량리역,3509,2402,1107
2018,3,D,발달상권,1001236,서울 종로구 안국역_2,706,276,430
2018,3,D,발달상권,1001235,서울 종로구 안국역_1,11483,9242,2241
2018,3,D,발달상권,1001234,서울 종로구 경복궁역_1,207,80,127
2018,3,D,발달상권,1001233,서울 종로구 종로3가역_3,3411,1821,1590
2018,3,D,발달상권,1001232,서울 종로구 종로3가역_2,1922,1023,899
2018,3,D,발달상권,1001231,서울 동대문구 신설동역_2,4377,2078,2299
2018,3,D,발달상권,1001230,인사동,21052,13045,8007
2018,3,D,발달상권,1001229,서울 종로구 종로5가역_4,635,349,286
2018,3,D,발달상권,1001228,서울 종로구 종로5가역_3,4960,3352,1608
2018,3,D,발달상권,1001227,종로구청,18495,10125,8370
2018,3,D,발달상권,1001226,서울 종로구 종로5가역_2,17391,11598,5793
2018,3,D,발달상권,1001225,신설동역,738,421,317
2018,3,D,발달상권,1001224,서울 동대문구 신설동역_1,2,2,0
2018,3,D,발달상권,1001223,서울 종로구 광화문역_2,54371,32642,21729
2018,3,D,발달상권,1001222,동묘앞역,68,40,28
2018,3,D,발달상권,1001221,장안동사거리,503,249,254
2018,3,D,발달상권,1001220,서울 종로구 동대문역_2,1106,550,556
2018,3,D,발달상권,1001218,동대문시장_2,500,300,200
2018,3,D,발달상권,1001217,서울 종로구 종로5가역_1,50,38,12
2018,3,D,발달상권,1001216,서울 종로구 종로3가역_1,4034,1757,2277
2018,3,D,발달상권,1001215,서울 종로구 광화문역_1,2103,1344,759
2018,3,D,발달상권,1001214,종각역,20751,13526,7225
2018,3,D,발달상권,1001213,종각역 젊음의 거리,2712,1114,1598
2018,3,D,발달상권,1001212,서대문구 서대문역_1,348,250,98
2018,3,D,발달상권,1001211,동대문시장_1,437,223,214
2018,3,D,발달상권,1001210,시청역_2,21859,13798,8061
2018,3,D,발달상권,1001209,서울시청,23497,11478,12019
2018,3,D,발달상권,1001208,서울 중구 을지로3가역_2,7863,5061,2802
2018,3,D,발달상권,1001207,서울 중구 신당역_2,1354,683,671
2018,3,D,발달상권,1001206,서대문구 서대문역_2,1449,871,578
2018,3,D,발달상권,1001205,동대문역사문화공원역,2248,1277,971
2018,3,D,발달상권,1001204,서울 중구 을지로3가역_1,18018,11428,6590
2018,3,D,발달상권,1001203,명동거리,9026,4728,4298
2018,3,D,발달상권,1001202,롯데백화점,40463,21491,18972
2018,3,D,발달상권,1001201,서울 중구 신당역_1,1057,702,355
2018,3,D,발달상권,1001200,북창동,10548,5655,4893
2018,3,D,발달상권,1001199,서울 중구 충무로역_2,14898,6701,8197
2018,3,D,발달상권,1001198,서울 강서구 송정역,616,407,209
2018,3,D,발달상권,1001197,장한평역_2,5325,3255,2070
2018,3,D,발달상권,1001196,시청역_1,54859,33251,21608
2018,3,D,발달상권,1001195,왕십리역_2,668,280,388
2018,3,D,발달상권,1001194,서울 강서구 발산역,874,492,382
2018,3,D,발달상권,1001193,장한평역_1,2508,1570,938
2018,3,D,발달상권,1001192,서울 중구 충무로역_1,3239,2248,991
2018,3,D,발달상권,1001190,장한평역,2303,1580,723
2018,3,D,발달상권,1001189,서울 중구 명동역,3988,2012,1976
2018,3,D,발달상권,1001188,장충동 족발거리,187,89,98
2018,3,D,발달상권,1001187,한양시장,266,156,110
2018,3,D,발달상권,1001186,서울 서대문구 이대역,1395,638,757
2018,3,D,발달상권,1001185,서울 서대문구 신촌역,3278,1418,1860
2018,3,D,발달상권,1001184,서울 마포구 홍대입구역_3,342,155,187
2018,3,D,발달상권,1001183,서울 마포구 홍대입구역_2,3328,1284,2044
2018,3,D,발달상권,1001182,홍익대학교 주변,16818,8154,8664
2018,3,D,발달상권,1001181,서울 광진구 군자역,227,131,96
2018,3,D,발달상권,1001180,신촌역,221,106,115
2018,3,D,발달상권,1001179,강서구청,3558,2312,1246
2018,3,D,발달상권,1001178,서울 마포구 홍대입구역_1,871,475,396
2018,3,D,발달상권,1001175,서울 강동구 고덕역,450,255,195
2018,3,D,발달상권,1001173,서울 강동구 명일역,869,359,510
2018,3,D,발달상권,1001172,어린이대공원역,88,47,41
2018,3,D,발달상권,1001171,서울 마포구 공덕역_2,4328,2508,1820
2018,3,D,발달상권,1001170,공덕역,7954,4594,3360
2018,3,D,발달상권,1001169,서울 용산구 숙대입구역,2707,1969,738
2018,3,D,발달상권,1001168,남영역,12311,5453,6858
2018,3,D,발달상권,1001167,서울 마포구 공덕역_1,4905,2395,2510
2018,3,D,발달상권,1001166,서울 마포구 마포역_2,1002,557,445
2018,3,D,발달상권,1001165,서울 광진구 건대입구역_2,2990,1023,1967
2018,3,D,발달상권,1001164,서울 마포구 마포역_1,13134,7794,5340
2018,3,D,발달상권,1001163,서울 강동구 천호역_2,4128,1923,2205
2018,3,D,발달상권,1001162,서울 광진구 건대입구역_1,916,434,482
2018,3,D,발달상권,1001161,건대입구역,735,394,341
2018,3,D,발달상권,1001160,서울 광진구 구의역,906,569,337
2018,3,D,발달상권,1001159,서울 강동구 천호역,997,451,546
2018,3,D,발달상권,1001158,당산역_2,4707,2881,1826
2018,3,D,발달상권,1001156,서울 강동구 길동역,1286,691,595
2018,3,D,발달상권,1001155,용산 전자상가_5,2575,1881,694
2018,3,D,발달상권,1001153,당산역_1,1148,704,444
2018,3,D,발달상권,1001152,서울 광진구 강변역,1799,1410,389
2018,3,D,발달상권,1001151,용산 전자상가_3,2469,1782,687
2018,3,D,발달상권,1001150,서울 용산구 이태원역,661,400,261
2018,3,D,발달상권,1001149,한남오거리,574,297,277
2018,3,D,발달상권,1001147,용산 전자상가_2,479,380,99
2018,3,D,발달상권,1001146,용산구청,33,15,18
2018,3,D,발달상권,1001145,용산 전자상가_1,13047,8246,4801
2018,3,D,발달상권,1001144,국회의사당역_2,38083,21992,16091
2018,3,D,발달상권,1001143,서울 용산구 신용산역,505,240,265
2018,3,D,발달상권,1001142,국회의사당역_1,5707,4396,1311
2018,3,D,발달상권,1001141,압구정 로데오거리_2,16443,6701,9742
2018,3,D,발달상권,1001140,서울 강남구 압구정역,10265,4575,5690
2018,3,D,발달상권,1001139,서울 영등포구 영등포구청역,3733,1138,2595
2018,3,D,발달상권,1001138,압구정 로데오거리_1,9087,2833,6254
2018,3,D,발달상권,1001137,서울 강동구 둔촌동역,71,24,47
2018,3,D,발달상권,1001136,오목교역,198,85,113
2018,3,D,발달상권,1001135,신사동 가로수길,22466,10481,11985
2018,3,D,발달상권,1001134,서울 영등포구 여의도역_2,49729,33012,16717
2018,3,D,발달상권,1001133,청담사거리_3,1143,414,729
2018,3,D,발달상권,1001132,영등포유통상가,2109,1252,857
2018,3,D,발달상권,1001131,청담역_2,1317,899,418
2018,3,D,발달상권,1001130,청담역_1,194,154,40
2018,3,D,발달상권,1001129,청담사거리_2,1189,873,316
2018,3,D,발달상권,1001127,서울 영등포구 여의도역_1,51327,30887,20440
2018,3,D,발달상권,1001125,학동사거리_2,2997,1699,1298
2018,3,D,발달상권,1001124,서울 영등포구 영등포시장역,334,253,81
2018,3,D,발달상권,1001123,학동사거리_1,4479,2220,2259
2018,3,D,발달상권,1001122,여의도 시범아파트앞,2395,1580,815
2018,3,D,발달상권,1001121,영등포역_3,906,535,371
2018,3,D,발달상권,1001120,도산공원사거리_1,10355,6090,4265
2018,3,D,발달상권,1001119,영등포역_2,1259,661,598
2018,3,D,발달상권,1001118,문래동 주민센터,74,59,15
2018,3,D,발달상권,1001117,강남구 신사역_2,7930,4769,3161
2018,3,D,발달상권,1001115,서울 강남구 강남구청역_2,4663,2890,1773
2018,3,D,발달상권,1001114,강남구 신사역_1,2430,1008,1422
2018,3,D,발달상권,1001113,서울 동작구 노량진1동_1,19,6,13
2018,3,D,발달상권,1001112,서울 강남구 학동역_3,9665,5539,4126
2018,3,D,발달상권,1001111,서울 강남구 강남구청역_1,3642,2126,1516
2018,3,D,발달상권,1001110,잠실역,5868,4338,1530
2018,3,D,발달상권,1001109,강남구 논현역_4,6478,3331,3147
2018,3,D,발달상권,1001108,학동역,1572,574,998
2018,3,D,발달상권,1001107,방이동 먹자골목,5157,3223,1934
2018,3,D,발달상권,1001106,서울 강남구 학동역_2,6033,3234,2799
2018,3,D,발달상권,1001105,서울 동작구 노량진역,3829,2175,1654
2018,3,D,발달상권,1001104,삼성역_3,10170,5919,4251
2018,3,D,발달상권,1001103,코엑스,22562,12970,9592
2018,3,D,발달상권,1001102,서울 강남구 학동역_1,5305,3348,1957
2018,3,D,발달상권,1001101,선정릉역_2,6911,4247,2664
2018,3,D,발달상권,1001100,강남구 논현역_3,1533,932,601
2018,3,D,발달상권,1001099,포스코사거리_2,7881,5022,2859
2018,3,D,발달상권,1001098,포스코사거리_1,43841,29255,14586
2018,3,D,발달상권,1001097,잠실역 롯데월드,3871,1933,1938
2018,3,D,발달상권,1001096,신도림역,3373,1768,1605
2018,3,D,발달상권,1001095,강남구 논현역_2,10089,4811,5278
2018,3,D,발달상권,1001094,선정릉역_1,1924,1381,543
2018,3,D,발달상권,1001093,신천역,5931,3190,2741
2018,3,D,발달상권,1001092,강남구 논현역_1,3585,2076,1509
2018,3,D,발달상권,1001091,삼성역_2,18975,11521,7454
2018,3,D,발달상권,1001090,삼정역_2,2478,1346,1132
2018,3,D,발달상권,1001089,삼정역_1,3329,1696,1633
2018,3,D,발달상권,1001088,삼성역_1,35413,22502,12911
2018,3,D,발달상권,1001087,서울 강남구 선릉역_2,7288,4707,2581
2018,3,D,발달상권,1001086,고속터미널역,16485,4781,11704
2018,3,D,발달상권,1001085,서울 서초구 강남역,33758,18836,14922
2018,3,D,발달상권,1001084,서울 강남구 선릉역_1,19964,8319,11645
2018,3,D,발달상권,1001082,선릉역_2,20789,10769,10020
2018,3,D,발달상권,1001081,서울 강남구 역삼역_2,27706,21651,6055
2018,3,D,발달상권,1001080,서울 송파구 석촌역_1,37,21,16
2018,3,D,발달상권,1001078,서울 강남구 강남역_2,5638,3260,2378
2018,3,D,발달상권,1001077,선릉역_1,55373,30034,25339
2018,3,D,발달상권,1001076,구로역,153,85,68
2018,3,D,발달상권,1001075,역삼역_2,4513,2557,1956
2018,3,D,발달상권,1001074,대림역_2,7571,5787,1784
2018,3,D,발달상권,1001073,서울 강남구 역삼역_1,24525,15502,9023
2018,3,D,발달상권,1001072,신대방삼거리역,241,109,132
2018,3,D,발달상권,1001071,서울 강남구 한티역,1139,451,688
2018,3,D,발달상권,1001070,은마아파트입구사거리_4,105,53,52
2018,3,D,발달상권,1001067,오류동역,1589,803,786
2018,3,D,발달상권,1001066,서울 강남구 강남역,41280,19424,21856
2018,3,D,발달상권,1001063,교대역_4,5151,2877,2274
2018,3,D,발달상권,1001062,서울 강남구 강남역_1,135689,99243,36446
2018,3,D,발달상권,1001061,방배동카페골목,108,41,67
2018,3,D,발달상권,1001060,가락시장,17284,10739,6545
2018,3,D,발달상권,1001059,교대역_3,4422,2687,1735
2018,3,D,발달상권,1001058,역삼역_1,1540,911,629
2018,3,D,발달상권,1001057,교대역_2,3363,2149,1214
2018,3,D,발달상권,1001056,서울 송파구 가락시장역,5029,3136,1893
2018,3,D,발달상권,1001055,서울 서초구 서초역,11841,4670,7171
2018,3,D,발달상권,1001054,서울 강남구 대치역_2,1508,910,598
2018,3,D,발달상권,1001052,뱅뱅사거리_2,29870,20424,9446
2018,3,D,발달상권,1001051,보라매공원,14421,8102,6319
2018,3,D,발달상권,1001050,교대역_1,13316,7616,5700
2018,3,D,발달상권,1001049,개봉동 현대아파트 인근,145,60,85
2018,3,D,발달상권,1001048,뱅뱅사거리,7961,5087,2874
2018,3,D,발달상권,1001047,뱅뱅사거리_1,11051,7880,3171
2018,3,D,발달상권,1001046,서울 관악구 신림역_4,1027,467,560
2018,3,D,발달상권,1001045,동작구 총신대입구역_1,262,123,139
2018,3,D,발달상권,1001044,양재역_3,3614,2354,1260
2018,3,D,발달상권,1001043,동작구 총신대입구역_2,752,321,431
2018,3,D,발달상권,1001042,서울 서초구 남부터미널역_3,1491,797,694
2018,3,D,발달상권,1001041,서울 강남구 수서역,16052,11440,4612
2018,3,D,발달상권,1001039,서울 서초구 남부터미널역_2,10724,5529,5195
2018,3,D,발달상권,1001038,구로디지탈1단지,66367,42004,24363
2018,3,D,발달상권,1001037,양재역,133,61,72
2018,3,D,발달상권,1001035,매봉역,612,229,383
2018,3,D,발달상권,1001034,서울 서초구 방배역,3380,1969,1411
2018,3,D,발달상권,1001033,서울 서초구 남부터미널역_1,540,396,144
2018,3,D,발달상권,1001032,서울 관악구 신림역_2,34,17,17
2018,3,D,발달상권,1001031,서울 관악구 신림역_1,1979,936,1043
2018,3,D,발달상권,1001030,양재역_2,11338,6172,5166
2018,3,D,발달상권,1001029,양재역_1,923,654,269
2018,3,D,발달상권,1001028,서울 관악구 서울대입구역_2,41,3,38
2018,3,D,발달상권,1001027,가산디지털단지역_3,45037,29362,15675
2018,3,D,발달상권,1001026,구로디지털단지역,2524,1636,888
2018,3,D,발달상권,1001025,서울 관악구 서울대입구역_1,1936,848,1088
2018,3,D,발달상권,1001024,관악구 사당역_1,3503,1459,2044
2018,3,D,발달상권,1001023,가산디지털단지역_2,59807,36563,23244
2018,3,D,발달상권,1001022,관악구 사당역_2,494,285,209
2018,3,D,발달상권,1001021,가산디지털단지역_1,28461,19196,9265
2018,3,D,발달상권,1001020,장지역,4695,2900,1795
2018,3,D,발달상권,1001019,포이사거리_1,5851,3303,2548
2018,3,D,발달상권,1001018,포이사거리_2,8599,5946,2653
2018,3,D,발달상권,1001016,서울 관악구 대학동_1,112,67,45
2018,3,D,발달상권,1001015,서울 금천구 독산1동_1,3020,1946,1074
2018,3,D,발달상권,1001013,양재 화물트럭터미널앞_2,148,70,78
2018,3,D,발달상권,1001012,양재 화물트럭터미널앞_1,4525,3730,795
2018,3,D,발달상권,1001011,서울 금천구 시흥1동_4,957,409,548
2018,3,A,골목상권,1001010,풍성로37가길,40,20,20
2018,3,A,골목상권,1001009,천호옛길,476,320,156
2018,3,A,골목상권,1001008,천호옛14길,703,384,319
2018,3,A,골목상권,1001007,천호대로219길,1366,617,749
2018,3,A,골목상권,1001006,천호대로197길,22,8,14
2018,3,A,골목상권,1001005,천호대로187길,890,509,381
2018,3,A,골목상권,1001004,천호대로170길,257,149,108
2018,3,A,골목상권,1001003,천호대로162길,1306,831,475
2018,3,A,골목상권,1001002,천중로51길,425,222,203
2018,3,A,골목상권,1001001,천중로39길,564,213,351
2018,3,A,골목상권,1001000,진황도로47길,1602,638,964
2018,3,A,골목상권,1000999,진황도로27길,579,300,279
2018,3,A,골목상권,1000998,올림픽로98길,41,17,24
2018,3,A,골목상권,1000995,올림픽로77길,21,11,10
2018,3,A,골목상권,1000994,올림픽로71길,353,258,95
2018,3,A,골목상권,1000993,올림픽로48길,6417,3785,2632
2018,3,A,골목상권,1000992,양재대로96길,1304,791,513
2018,3,A,골목상권,1000991,양재대로95길,604,312,292
2018,3,A,골목상권,1000990,양재대로91길,1119,618,501
2018,3,A,골목상권,1000989,양재대로133길,358,133,225
2018,3,A,골목상권,1000988,양재대로124길,581,330,251
2018,3,A,골목상권,1000987,양재대로116길,213,88,125
2018,3,A,골목상권,1000986,양재대로101길,1389,809,580
2018,3,A,골목상권,1000985,암사길,395,174,221
2018,3,A,골목상권,1000984,성안로3길,1338,764,574
2018,3,A,골목상권,1000983,성내로5길,1078,551,527
2018,3,A,골목상권,1000982,상일로5길,41,23,18
2018,3,A,골목상권,1000981,상암로5길,566,238,328
2018,3,A,골목상권,1000980,상암로51길,788,343,445
2018,3,A,골목상권,1000979,상암로4길,204,131,73
2018,3,A,골목상권,1000978,상암로14길,407,217,190
2018,3,A,골목상권,1000977,명일로13길,104,47,57
2018,3,A,골목상권,1000976,동남로85길,116,66,50
2018,3,A,골목상권,1000975,동남로82길,10,4,6
2018,3,A,골목상권,1000974,동남로65길,81,25,56
2018,3,A,골목상권,1000973,구천면로42길,347,193,154
2018,3,A,골목상권,1000972,구천면로41길,583,246,337
2018,3,A,골목상권,1000971,구천면로36길,40,23,17
2018,3,A,골목상권,1000969,고덕로25길,14,8,6
2018,3,A,골목상권,1000968,고덕로10길,181,84,97
2018,3,A,골목상권,1000967,강동대로53길,887,492,395
2018,3,A,골목상권,1000966,풍성로25길,787,283,504
2018,3,A,골목상권,1000965,오금로46길,1431,710,721
2018,3,A,골목상권,1000964,오금로36길,1297,935,362
2018,3,A,골목상권,1000963,오금로11길,2163,1389,774
2018,3,A,골목상권,1000962,양재대로72길,621,301,320
2018,3,A,골목상권,1000961,양재대로71길,1434,887,547
2018,3,A,골목상권,1000960,양재대로64길,1458,635,823
2018,3,A,골목상권,1000959,양재대로62길,7052,4459,2593
2018,3,A,골목상권,1000958,송파대로30길,1629,990,639
2018,3,A,골목상권,1000957,송이로36길,1947,1366,581
2018,3,A,골목상권,1000956,송이로32길,732,412,320
2018,3,A,골목상권,1000955,송이로23길,1442,912,530
2018,3,A,골목상권,1000954,삼전로13길,1633,731,902
2018,3,A,골목상권,1000953,백제고분로50길,1512,922,590
2018,3,A,골목상권,1000952,백제고분로46길,1619,955,664
2018,3,A,골목상권,1000951,백제고분로45길,504,326,178
2018,3,A,골목상권,1000950,백제고분로42길,124,79,45
2018,3,A,골목상권,1000949,백제고분로39길,1696,1248,448
2018,3,A,골목상권,1000948,백제고분로34길,1516,980,536
2018,3,A,골목상권,1000947,백제고분로33길,1104,708,396
2018,3,A,골목상권,1000946,백제고분로32길,1121,500,621
2018,3,A,골목상권,1000945,백제고분로31길,347,186,161
2018,3,A,골목상권,1000944,백제고분로22길,1205,721,484
2018,3,A,골목상권,1000943,백제고분로21길,205,136,69
2018,3,A,골목상권,1000942,마천로51길,157,67,90
2018,3,A,골목상권,1000941,동남로20길,155,82,73
2018,3,A,골목상권,1000940,거마로20길,527,228,299
2018,3,A,골목상권,1000939,학동로77길,2922,1463,1459
2018,3,A,골목상권,1000938,학동로6길,1698,886,812
2018,3,A,골목상권,1000937,학동로56길,893,439,454
2018,3,A,골목상권,1000936,학동로38길,6922,4029,2893
2018,3,A,골목상권,1000935,테헤란로81길,524,204,320
2018,3,A,골목상권,1000934,일원로9길,489,274,215
2018,3,A,골목상권,1000933,일원로3길,234,125,109
2018,3,A,골목상권,1000932,영동대로65길,3214,1853,1361
2018,3,A,골목상권,1000931,영동대로112길,628,391,237
2018,3,A,골목상권,1000930,언주로81길,9998,4857,5141
2018,3,A,골목상권,1000929,압구정로2길,2822,1499,1323
2018,3,A,골목상권,1000928,선릉로18길,348,204,144
2018,3,A,골목상권,1000927,선릉로146길,1923,986,937
2018,3,A,골목상권,1000926,선릉로133길,270,147,123
2018,3,A,골목상권,1000925,선릉로132길,1089,619,470
2018,3,A,골목상권,1000924,선릉로121길,1565,874,691
2018,3,A,골목상권,1000923,삼성로75길,2635,1450,1185
2018,3,A,골목상권,1000922,삼성로69길,357,181,176
2018,3,A,골목상권,1000921,삼성로64길,522,249,273
2018,3,A,골목상권,1000920,삼성로63길,245,96,149
2018,3,A,골목상권,1000919,삼성로57길,846,267,579
2018,3,A,골목상권,1000918,삼성로147길,874,357,517
2018,3,A,골목상권,1000917,삼성로115길,256,151,105
2018,3,A,골목상권,1000916,봉은사로68길,204,91,113
2018,3,A,골목상권,1000915,봉은사로57길,1141,708,433
2018,3,A,골목상권,1000914,봉은사로43길,1058,705,353
2018,3,A,골목상권,1000913,봉은사로29길,138,95,43
2018,3,A,골목상권,1000912,봉은사로109길,329,175,154
2018,3,A,골목상권,1000911,도산대로89길,2258,953,1305
2018,3,A,골목상권,1000910,도산대로81길,4192,1529,2663
2018,3,A,골목상권,1000909,도산대로50길,2731,1870,861
2018,3,A,골목상권,1000908,도산대로38길,163,91,72
2018,3,A,골목상권,1000907,도산대로30길,3304,1620,1684
2018,3,A,골목상권,1000906,도산대로23길,1448,886,562
2018,3,A,골목상권,1000905,도산대로15길,1632,760,872
2018,3,A,골목상권,1000904,도곡로37길,4197,2203,1994
2018,3,A,골목상권,1000903,논현로8길,783,440,343
2018,3,A,골목상권,1000902,논현로63길,3203,2261,942
2018,3,A,골목상권,1000901,논현로28길,10510,7244,3266
2018,3,A,골목상권,1000900,논현로26길,7670,5050,2620
2018,3,A,골목상권,1000898,논현로139길,2712,1278,1434
2018,3,A,골목상권,1000897,논현로123길,100,59,41
2018,3,A,골목상권,1000896,논현로115길,2806,1441,1365
2018,3,A,골목상권,1000895,논현로10길,2570,1650,920
2018,3,A,골목상권,1000894,논현로106길,2765,1572,1193
2018,3,A,골목상권,1000893,남부순환로365길,171,122,49
2018,3,A,골목상권,1000891,개포로28길,296,193,103
2018,3,A,골목상권,1000890,개포로20길,4215,2408,1807
2018,3,A,골목상권,1000889,개포로17길,2622,1698,924
2018,3,A,골목상권,1000888,강남대로140길,4005,2014,1991
2018,3,A,골목상권,1000887,강남대로136길,1294,759,535
2018,3,A,골목상권,1000886,강남대로118길,588,330,258
2018,3,A,골목상권,1000885,서초중앙로8길,7653,5747,1906
2018,3,A,골목상권,1000884,방배중앙로21길,1297,640,657
2018,3,A,골목상권,1000883,효령로72길,204,124,80
2018,3,A,골목상권,1000882,효령로34길,37,31,6
2018,3,A,골목상권,1000881,효령로31길,1329,705,624
2018,3,A,골목상권,1000880,효령로23길,732,433,299
2018,3,A,골목상권,1000879,청두곶길,2220,1352,868
2018,3,A,골목상권,1000878,주흥길,333,224,109
2018,3,A,골목상권,1000877,주흥15길,1480,947,533
2018,3,A,골목상권,1000876,언남길,1642,1109,533
2018,3,A,골목상권,1000875,신반포로45길,451,275,176
2018,3,A,골목상권,1000874,서초대로8길,248,125,123
2018,3,A,골목상권,1000873,서초대로64길,623,435,188
2018,3,A,골목상권,1000872,서초대로4길,652,473,179
2018,3,A,골목상권,1000871,서초대로25길,3904,2399,1505
2018,3,A,골목상권,1000870,서초대로23길,556,339,217
2018,3,A,골목상권,1000869,서초대로15길,1535,711,824
2018,3,A,골목상권,1000868,사평대로57길,177,66,111
2018,3,A,골목상권,1000867,사평대로26길,13,9,4
2018,3,A,골목상권,1000866,사평대로22길,1484,903,581
2018,3,A,골목상권,1000865,사임당로17길,1851,1124,727
2018,3,A,골목상권,1000864,방배로42길,126,58,68
2018,3,A,골목상권,1000863,방배로35길,2371,1505,866
2018,3,A,골목상권,1000862,방배로18길,77,45,32
2018,3,A,골목상권,1000861,반포대로9길,658,422,236
2018,3,A,골목상권,1000860,바우뫼로39길,2652,1560,1092
2018,3,A,골목상권,1000859,마방로2길,3850,2366,1484
2018,3,A,골목상권,1000858,방배천로4안길,1298,851,447
2018,3,A,골목상권,1000857,동산로19길,1298,847,451
2018,3,A,골목상권,1000856,동산로10길,2806,1517,1289
2018,3,A,골목상권,1000855,동광로39길,54,27,27
2018,3,A,골목상권,1000854,동광로1길,966,534,432
2018,3,A,골목상권,1000853,동광로12길,794,508,286
2018,3,A,골목상권,1000852,논현로27길,3588,2542,1046
2018,3,A,골목상권,1000851,논현로1길,550,355,195
2018,3,A,골목상권,1000850,남부순환로339길,13336,5891,7445
2018,3,A,골목상권,1000849,남부순환로325길,8261,3970,4291
2018,3,A,골목상권,1000848,남부순환로317길,1663,1135,528
2018,3,A,골목상권,1000847,고무래로8길,6501,3376,3125
2018,3,A,골목상권,1000846,강남대로8길,2603,1629,974
2018,3,A,골목상권,1000845,강남대로34길,1069,705,364
2018,3,A,골목상권,1000844,강남대로23길,7309,5154,2155
2018,3,A,골목상권,1000843,소담길,34,11,23
2018,3,A,골목상권,1000842,원신길,297,116,181
2018,3,A,골목상권,1000840,양산길,356,242,114
2018,3,A,골목상권,1000839,호암로24길,788,262,526
2018,3,A,골목상권,1000838,호암로20길,55,29,26
2018,3,A,골목상권,1000837,행운길,21,5,16
2018,3,A,골목상권,1000836,행운1길,105,71,34
2018,3,A,골목상권,1000835,청림3길,74,37,37
2018,3,A,골목상권,1000834,청룡길,89,48,41
2018,3,A,골목상권,1000833,청룡8길,10,5,5
2018,3,A,골목상권,1000832,중앙길,260,94,166
2018,3,A,골목상권,1000831,조원중앙로2길,1189,848,341
2018,3,A,골목상권,1000830,조원로18길,1045,551,494
2018,3,A,골목상권,1000829,조원로10길,275,121,154
2018,3,A,골목상권,1000828,장군봉2길,400,277,123
2018,3,A,골목상권,1000827,장군봉1길,83,16,67
2018,3,A,골목상권,1000826,인헌길,82,52,30
2018,3,A,골목상권,1000825,은천로25길,284,92,192
2018,3,A,골목상권,1000824,양녕로6길,822,465,357
2018,3,A,골목상권,1000823,신원로3길,25,14,11
2018,3,A,골목상권,1000822,신사로20길,44,14,30
2018,3,A,골목상권,1000820,신림로64길,242,118,124
2018,3,A,골목상권,1000819,신림로48길,69,33,36
2018,3,A,골목상권,1000818,신림로38길,60,33,27
2018,3,A,골목상권,1000817,신림로28길,328,227,101
2018,3,A,골목상권,1000816,신림로11길,470,420,50
2018,3,A,골목상권,1000815,신림동길,354,198,156
2018,3,A,골목상권,1000814,승방길,571,365,206
2018,3,A,골목상권,1000813,서림7길,289,116,173
2018,3,A,골목상권,1000812,봉천로33길,308,199,109
2018,3,A,골목상권,1000811,봉천로13길,318,88,230
2018,3,A,골목상권,1000810,복은길,155,55,100
2018,3,A,골목상권,1000809,법원단지길,2,2,0
2018,3,A,골목상권,1000808,법원단지9길,87,39,48
2018,3,A,골목상권,1000807,미성5길,77,44,33
2018,3,A,골목상권,1000806,대학길,75,39,36
2018,3,A,골목상권,1000805,대학14길,13,4,9
2018,3,A,골목상권,1000804,당곡길,386,205,181
2018,3,A,골목상권,1000803,남현길,224,76,148
2018,3,A,골목상권,1000802,남현3길,270,140,130
2018,3,A,골목상권,1000800,남부순환로248길,251,112,139
2018,3,A,골목상권,1000799,남부순환로234길,173,116,57
2018,3,A,골목상권,1000798,남부순환로172길,1264,685,579
2018,3,A,골목상권,1000797,남부순환로161길,31,12,19
2018,3,A,골목상권,1000796,남부순환로151길,200,144,56
2018,3,A,골목상권,1000795,남부순환로142길,93,49,44
2018,3,A,골목상권,1000794,난향길,177,42,135
2018,3,A,골목상권,1000793,난우길,426,159,267
2018,3,A,골목상권,1000792,난곡로74길,117,53,64
2018,3,A,골목상권,1000791,난곡로34길,25,7,18
2018,3,A,골목상권,1000790,난곡로26길,141,50,91
2018,3,A,골목상권,1000789,난곡로24길,26,16,10
2018,3,A,골목상권,1000788,낙성대역길,698,446,252
2018,3,A,골목상권,1000787,국회단지길,572,272,300
2018,3,A,골목상권,1000786,구암길,88,34,54
2018,3,A,골목상권,1000785,관천로22길,19,6,13
2018,3,A,골목상권,1000784,관천로15길,150,82,68
2018,3,A,골목상권,1000783,관악로30길,187,62,125
2018,3,A,골목상권,1000782,관악로28길,151,71,80
2018,3,A,골목상권,1000781,관악로14길,464,257,207
2018,3,A,골목상권,1000780,관악로10길,223,156,67
2018,3,A,골목상권,1000779,흑석로9길,171,71,100
2018,3,A,골목상권,1000778,흑석로13길,149,11,138
2018,3,A,골목상권,1000777,장승배기로27길,46,21,25
2018,3,A,골목상권,1000776,장승배기로19길,8,4,4
2018,3,A,골목상권,1000774,여의대방로46길,465,161,304
2018,3,A,골목상권,1000773,여의대방로24길,18249,9804,8445
2018,3,A,골목상권,1000772,여의대방로22카길,306,125,181
2018,3,A,골목상권,1000771,여의대방로22나길,129,52,77
2018,3,A,골목상권,1000770,여의대방로22길,248,147,101
2018,3,A,골목상권,1000769,양녕로26길,135,67,68
2018,3,A,골목상권,1000768,신대방길,99,63,36
2018,3,A,골목상권,1000767,성대로29길,3,2,1
2018,3,A,골목상권,1000766,성대로1길,343,143,200
2018,3,A,골목상권,1000765,서달로8가길,247,99,148
2018,3,A,골목상권,1000763,서달로14길,42,18,24
2018,3,A,골목상권,1000762,서달로10길,66,32,34
2018,3,A,골목상권,1000761,상도로62길,185,56,129
2018,3,A,골목상권,1000760,상도로61길,46,21,25
2018,3,A,골목상권,1000759,상도로47길,46,33,13
2018,3,A,골목상권,1000758,상도로37길,1920,932,988
2018,3,A,골목상권,1000757,상도로15길,359,155,204
2018,3,A,골목상권,1000756,사당로8길,121,66,55
2018,3,A,골목상권,1000755,사당로30길,298,204,94
2018,3,A,골목상권,1000754,사당로2차길,113,76,37
2018,3,A,골목상권,1000753,사당로29길,26,22,4
2018,3,A,골목상권,1000752,사당로26길,260,148,112
2018,3,A,골목상권,1000751,사당로23나길,141,45,96
2018,3,A,골목상권,1000750,사당로23길,16,12,4
2018,3,A,골목상권,1000749,사당로20길,194,146,48
2018,3,A,골목상권,1000748,사당로16길,135,40,95
2018,3,A,골목상권,1000747,사당로16가길,772,471,301
2018,3,A,골목상권,1000746,만양로8길,95,46,49
2018,3,A,골목상권,1000745,만양로14길,347,154,193
2018,3,A,골목상권,1000744,등용로14길,670,456,214
2018,3,A,골목상권,1000743,동작대로7길,1829,746,1083
2018,3,A,골목상권,1000742,동작대로35길,945,116,829
2018,3,A,골목상권,1000741,동작대로33길,106,56,50
2018,3,A,골목상권,1000740,동작대로29길,38,21,17
2018,3,A,골목상권,1000739,동작대로17길,1402,710,692
2018,3,A,골목상권,1000738,대방동2길,462,215,247
2018,3,A,골목상권,1000737,대방동27길,125,78,47
2018,3,A,골목상권,1000736,노량진로6길,100,28,72
2018,3,A,골목상권,1000735,국사봉길,48,9,39
2018,3,A,골목상권,1000734,국사봉2길,50,18,32
2018,3,A,골목상권,1000733,국사봉1길,9,3,6
2018,3,A,골목상권,1000732,영신로9길,344,178,166
2018,3,A,골목상권,1000731,영등포로84길,378,96,282
2018,3,A,골목상권,1000730,영등포로80길,55,30,25
2018,3,A,골목상권,1000729,영등포로62길,7,4,3
2018,3,A,골목상권,1000728,영등포로35길,89,54,35
2018,3,A,골목상권,1000727,영등포로27길,301,171,130
2018,3,A,골목상권,1000724,여의대방로43나길,957,683,274
2018,3,A,골목상권,1000723,여의대방로39길,7,3,4
2018,3,A,골목상권,1000722,여의대방로35길,876,459,417
2018,3,A,골목상권,1000721,양평로28길,624,496,128
2018,3,A,골목상권,1000720,양평로22라길,29,15,14
2018,3,A,골목상권,1000719,양평로19길,4563,3515,1048
2018,3,A,골목상권,1000718,신길로60길,497,187,310
2018,3,A,골목상권,1000717,신길로42길,376,182,194
2018,3,A,골목상권,1000716,신길로42가길,99,33,66
2018,3,A,골목상권,1000715,신길로39길,129,52,77
2018,3,A,골목상권,1000714,신길로17길,52,35,17
2018,3,A,골목상권,1000713,선유서로28길,389,214,175
2018,3,A,골목상권,1000712,선유서로25길,2563,1872,691
2018,3,A,골목상권,1000711,선유서로24길,365,209,156
2018,3,A,골목상권,1000710,선유로55길,2479,1517,962
2018,3,A,골목상권,1000709,디지털로74길,46,30,16
2018,3,A,골목상권,1000708,디지털로57길,10,4,6
2018,3,A,골목상권,1000707,디지털로37길,215,99,116
2018,3,A,골목상권,1000706,도신로62길,189,58,131
2018,3,A,골목상권,1000705,도신로60길,64,12,52
2018,3,A,골목상권,1000704,도신로29길,81,35,46
2018,3,A,골목상권,1000703,도신로15길,85,43,42
2018,3,A,골목상권,1000702,도림천로21길,88,36,52
2018,3,A,골목상권,1000701,도림로63길,30,21,9
2018,3,A,골목상권,1000700,도림로147길,1783,1289,494
2018,3,A,골목상권,1000699,도림로112길,27,16,11
2018,3,A,골목상권,1000698,대림로8길,1910,568,1342
2018,3,A,골목상권,1000697,대림로7길,10,6,4
2018,3,A,골목상권,1000696,대림로44길,29,16,13
2018,3,A,골목상권,1000695,대림로34길,192,81,111
2018,3,A,골목상권,1000694,대림로31길,1055,545,510
2018,3,A,골목상권,1000693,대림로29길,1809,920,889
2018,3,A,골목상권,1000692,대림로22길,377,215,162
2018,3,A,골목상권,1000691,당산로46길,4383,2745,1638
2018,3,A,골목상권,1000690,당산로38길,164,113,51
2018,3,A,골목상권,1000689,당산로37길,4244,2743,1501
2018,3,A,골목상권,1000688,당산로31길,4394,2379,2015
2018,3,A,골목상권,1000687,국회대로56길,1741,1124,617
2018,3,A,골목상권,1000686,경인로90길,314,177,137
2018,3,A,골목상권,1000685,경인로80길,1576,1129,447
2018,3,A,골목상권,1000684,경인로77길,709,447,262
2018,3,A,골목상권,1000683,가마산로61길,204,70,134
2018,3,A,골목상권,1000682,시흥대로94길,689,350,339
2018,3,A,골목상권,1000681,시흥대로84길,185,85,100
2018,3,A,골목상권,1000680,시흥대로68길,960,251,709
2018,3,A,골목상권,1000679,시흥대로63길,2949,1450,1499
2018,3,A,골목상권,1000678,시흥대로62가길,443,108,335
2018,3,A,골목상권,1000677,시흥대로36길,409,232,177
2018,3,A,골목상권,1000676,시흥대로22길,511,362,149
2018,3,A,골목상권,1000675,시흥대로153길,640,368,272
2018,3,A,골목상권,1000674,시흥대로150길,537,248,289
2018,3,A,골목상권,1000673,시흥대로141길,653,381,272
2018,3,A,골목상권,1000672,시흥대로138길,18,9,9
2018,3,A,골목상권,1000671,시흥대로120길,470,311,159
2018,3,A,골목상권,1000670,벚꽃로56길,1863,1268,595
2018,3,A,골목상권,1000669,범안로17길,136,82,54
2018,3,A,골목상권,1000668,범안로11길,1073,839,234
2018,3,A,골목상권,1000667,문성로5길,166,58,108
2018,3,A,골목상권,1000666,독산로85길,99,25,74
2018,3,A,골목상권,1000665,독산로78다길,223,97,126
2018,3,A,골목상권,1000664,독산로70길,2,2,0
2018,3,A,골목상권,1000663,독산로64길,115,31,84
2018,3,A,골목상권,1000662,독산로50길,91,34,57
2018,3,A,골목상권,1000661,독산로40길,54,16,38
2018,3,A,골목상권,1000660,독산로108길,731,343,388
2018,3,A,골목상권,1000659,남부순환로112길,14,6,8
2018,3,A,골목상권,1000658,금하로24길,206,70,136
2018,3,A,골목상권,1000657,금하로1길,73,33,40
2018,3,A,골목상권,1000656,금하로14길,26,11,15
2018,3,A,골목상권,1000655,가산로5길,583,456,127
2018,3,A,골목상권,1000654,가산로3길,2320,1764,556
2018,3,A,골목상권,1000653,중앙로1길,1572,1085,487
2018,3,A,골목상권,1000652,중앙로15길,96,50,46
2018,3,A,골목상권,1000651,우마길,41,21,20
2018,3,A,골목상권,1000650,오류로8길,224,105,119
2018,3,A,골목상권,1000649,신도림로13길,828,601,227
2018,3,A,골목상권,1000648,새말로18길,443,295,148
2018,3,A,골목상권,1000647,부일로1길,779,627,152
2018,3,A,골목상권,1000646,부일로15길,181,153,28
2018,3,A,골목상권,1000645,부일로11길,25,6,19
2018,3,A,골목상권,1000644,디지털로32길,1053,556,497
2018,3,A,골목상권,1000643,디지털로32가길,7192,4949,2243
2018,3,A,골목상권,1000642,디지털로27길,389,250,139
2018,3,A,골목상권,1000641,도림로6길,131,59,72
2018,3,A,골목상권,1000640,도림로12길,108,43,65
2018,3,A,골목상권,1000639,남부순환로97길,285,90,195
2018,3,A,골목상권,1000638,구로중앙로8길,199,73,126
2018,3,A,골목상권,1000637,구로중앙로7길,197,73,124
2018,3,A,골목상권,1000636,구로중앙로42길,803,593,210
2018,3,A,골목상권,1000635,구로중앙로34길,602,335,267
2018,3,A,골목상권,1000634,구로중앙로28길,3213,1572,1641
2018,3,A,골목상권,1000633,구로중앙로19길,10,7,3
2018,3,A,골목상권,1000632,구로동로8길,152,43,109
2018,3,A,골목상권,1000631,구로동로7길,171,67,104
2018,3,A,골목상권,1000630,구로동로42길,26,17,9
2018,3,A,골목상권,1000629,구로동로41길,433,292,141
2018,3,A,골목상권,1000628,구로동로38길,36,14,22
2018,3,A,골목상권,1000627,구로동로28길,169,68,101
2018,3,A,골목상권,1000626,구로동로15길,31,9,22
2018,3,A,골목상권,1000625,공원로6가길,288,197,91
2018,3,A,골목상권,1000624,고척로52길,218,69,149
2018,3,A,골목상권,1000623,고척로27다길,206,81,125
2018,3,A,골목상권,1000622,고척로27길,243,113,130
2018,3,A,골목상권,1000621,고척로21나길,217,63,154
2018,3,A,골목상권,1000620,경인로47길,919,504,415
2018,3,A,골목상권,1000619,경인로35길,289,112,177
2018,3,A,골목상권,1000618,경인로31길,58,22,36
2018,3,A,골목상권,1000617,경인로15길,143,61,82
2018,3,A,골목상권,1000616,개봉로3길,225,141,84
2018,3,A,골목상권,1000615,개봉로2길,480,129,351
2018,3,A,골목상권,1000614,개봉로23가길,868,501,367
2018,3,A,골목상권,1000613,개봉로20길,119,68,51
2018,3,A,골목상권,1000612,개봉로1길,52,27,25
2018,3,A,골목상권,1000611,개봉로17다길,194,94,100
2018,3,A,골목상권,1000610,개봉로17길,862,353,509
2018,3,A,골목상권,1000609,개봉로11길,61,11,50
2018,3,A,골목상권,1000608,화곡로64길,1601,953,648
2018,3,A,골목상권,1000607,화곡로59길,480,200,280
2018,3,A,골목상권,1000606,화곡로44나길,757,621,136
2018,3,A,골목상권,1000605,화곡로31길,1208,453,755
2018,3,A,골목상권,1000604,화곡로20길,535,333,202
2018,3,A,골목상권,1000603,화곡로13길,258,97,161
2018,3,A,골목상권,1000602,초원로16길,761,297,464
2018,3,A,골목상권,1000601,초록마을로8길,184,35,149
2018,3,A,골목상권,1000600,초록마을로3길,42,21,21
2018,3,A,골목상권,1000599,월정로20길,4,2,2
2018,3,A,골목상권,1000598,우장산로6길,311,172,139
2018,3,A,골목상권,1000597,양천로73가길,1260,809,451
2018,3,A,골목상권,1000596,양천로71길,216,121,95
2018,3,A,골목상권,1000595,양천로49길,760,595,165
2018,3,A,골목상권,1000594,양천로26길,174,81,93
2018,3,A,골목상권,1000593,양천로24길,385,157,228
2018,3,A,골목상권,1000592,양천로24가길,766,372,394
2018,3,A,골목상권,1000591,양천로14길,241,161,80
2018,3,A,골목상권,1000590,방화대로6라길,806,491,315
2018,3,A,골목상권,1000589,방화대로21길,854,483,371
2018,3,A,골목상권,1000588,등촌로5길,13,5,8
2018,3,A,골목상권,1000587,등촌로55길,540,360,180
2018,3,A,골목상권,1000586,등촌로51길,17,11,6
2018,3,A,골목상권,1000585,등촌로39길,70,27,43
2018,3,A,골목상권,1000584,등촌로13길,188,96,92
2018,3,A,골목상권,1000583,남부순환로11길,378,258,120
2018,3,A,골목상권,1000582,까치산로4길,152,57,95
2018,3,A,골목상권,1000581,국회대로7길,412,237,175
2018,3,A,골목상권,1000580,공항대로8길,226,90,136
2018,3,A,골목상권,1000579,공항대로61길,185,129,56
2018,3,A,골목상권,1000578,공항대로59다길,885,632,253
2018,3,A,골목상권,1000577,공항대로59길,1087,695,392
2018,3,A,골목상권,1000576,공항대로55길,1095,702,393
2018,3,A,골목상권,1000575,공항대로42길,9,5,4
2018,3,A,골목상권,1000574,공항대로38길,273,138,135
2018,3,A,골목상권,1000573,곰달래로60길,587,312,275
2018,3,A,골목상권,1000572,곰달래로53길,53,18,35
2018,3,A,골목상권,1000571,곰달래로47길,38,17,21
2018,3,A,골목상권,1000570,곰달래로31길,11,7,4
2018,3,A,골목상권,1000569,곰달래로25길,796,295,501
2018,3,A,골목상권,1000568,개화동로25길,658,442,216
2018,3,A,골목상권,1000567,개화동로23길,115,75,40
2018,3,A,골목상권,1000566,강서로8길,159,85,74
2018,3,A,골목상권,1000565,강서로5라길,314,185,129
2018,3,A,골목상권,1000564,강서로5나길,95,50,45
2018,3,A,골목상권,1000563,강서로5가길,51,26,25
2018,3,A,골목상권,1000562,강서로47라길,122,60,62
2018,3,A,골목상권,1000561,강서로47길,370,192,178
2018,3,A,골목상권,1000560,강서로45다길,554,351,203
2018,3,A,골목상권,1000559,강서로45길,153,66,87
2018,3,A,골목상권,1000558,강서로35길,164,94,70
2018,3,A,골목상권,1000557,강서로29길,410,183,227
2018,3,A,골목상권,1000556,강서로18길,30,12,18
2018,3,A,골목상권,1000555,강서로17가길,132,57,75
2018,3,A,골목상권,1000554,강서로15길,305,155,150
2018,3,A,골목상권,1000553,가로공원로80길,60,28,32
2018,3,A,골목상권,1000552,가로공원로76가길,28,11,17
2018,3,A,골목상권,1000551,화곡로4길,212,81,131
2018,3,A,골목상권,1000550,화곡로3길,160,51,109
2018,3,A,골목상권,1000549,지양로7길,234,79,155
2018,3,A,골목상권,1000548,중앙로55길,349,179,170
2018,3,A,골목상권,1000547,중앙로51길,128,73,55
2018,3,A,골목상권,1000546,중앙로47길,118,26,92
2018,3,A,골목상권,1000545,중앙로45길,166,59,107
2018,3,A,골목상권,1000544,중앙로36길,2,2,0
2018,3,A,골목상권,1000543,중앙로32길,594,302,292
2018,3,A,골목상권,1000542,중앙로25길,244,70,174
2018,3,A,골목상권,1000541,은행정로7길,521,175,346
2018,3,A,골목상권,1000539,오목로5길,334,183,151
2018,3,A,골목상권,1000538,오목로3길,430,400,30
2018,3,A,골목상권,1000537,오목로30길,145,73,72
2018,3,A,골목상권,1000536,오목로23길,820,483,337
2018,3,A,골목상권,1000535,신월로20길,212,81,131
2018,3,A,골목상권,1000534,신월로15길,771,364,407
2018,3,A,골목상권,1000533,신목로6길,252,140,112
2018,3,A,골목상권,1000532,신목로5길,925,354,571
2018,3,A,골목상권,1000531,신목로2길,94,47,47
2018,3,A,골목상권,1000530,목동중앙서로8가길,178,110,68
2018,3,A,골목상권,1000529,목동중앙서로7길,264,86,178
2018,3,A,골목상권,1000528,목동중앙북로8길,355,110,245
2018,3,A,골목상권,1000527,목동중앙북로16길,257,80,177
2018,3,A,골목상권,1000526,목동중앙본로7길,117,51,66
2018,3,A,골목상권,1000525,목동중앙로3길,111,60,51
2018,3,A,골목상권,1000524,목동중앙로13나길,293,208,85
2018,3,A,골목상권,1000523,목동중앙남로3가길,546,364,182
2018,3,A,골목상권,1000522,목동로9길,2360,1508,852
2018,3,A,골목상권,1000521,목동로19길,1014,363,651
2018,3,A,골목상권,1000519,목동동로12길,385,140,245
2018,3,A,골목상권,1000518,목동남로4길,13,6,7
2018,3,A,골목상권,1000517,남부순환로88길,272,128,144
2018,3,A,골목상권,1000516,남부순환로79길,339,249,90
2018,3,A,골목상권,1000515,남부순환로70길,519,317,202
2018,3,A,골목상권,1000514,남부순환로58길,198,117,81
2018,3,A,골목상권,1000513,남부순환로40길,18,5,13
2018,3,A,골목상권,1000512,남부순환로33길,1247,1018,229
2018,3,A,골목상권,1000511,곰달래로5길,76,46,30
2018,3,A,골목상권,1000510,곰달래로3길,403,213,190
2018,3,A,골목상권,1000509,곰달래로2길,297,157,140
2018,3,A,골목상권,1000508,곰달래로10길,339,235,104
2018,3,A,골목상권,1000507,가로공원로58길,76,15,61
2018,3,A,골목상권,1000506,효창원로93길,86,44,42
2018,3,A,골목상권,1000505,토정로37길,118,54,64
2018,3,A,골목상권,1000504,월드컵로8길,1704,905,799
2018,3,A,골목상권,1000503,월드컵로7길,4,2,2
2018,3,A,골목상권,1000502,월드컵로36길,151,68,83
2018,3,A,골목상권,1000501,월드컵로25길,285,165,120
2018,3,A,골목상권,1000500,월드컵로19길,544,276,268
2018,3,A,골목상권,1000499,월드컵로16길,3917,2018,1899
2018,3,A,골목상권,1000498,월드컵로11길,253,91,162
2018,3,A,골목상권,1000497,월드컵로10길,1552,812,740
2018,3,A,골목상권,1000496,와우산로3길,180,101,79
2018,3,A,골목상권,1000495,와우산로29길,171,87,84
2018,3,A,골목상권,1000494,와우산로29가길,28,16,12
2018,3,A,골목상권,1000493,양화진길,439,309,130
2018,3,A,골목상권,1000492,양화로1길,4169,1985,2184
2018,3,A,골목상권,1000491,양화로11길,395,269,126
2018,3,A,골목상권,1000490,신촌로30길,26,16,10
2018,3,A,골목상권,1000489,신촌로28가길,105,40,65
2018,3,A,골목상권,1000488,신촌로12길,1598,696,902
2018,3,A,골목상권,1000487,숭문길,5291,4015,1276
2018,3,A,골목상권,1000486,숭문8길,110,63,47
2018,3,A,골목상권,1000485,성지3길,479,242,237
2018,3,A,골목상권,1000484,성산로4길,1732,1032,700
2018,3,A,골목상권,1000483,성미산로32길,522,259,263
2018,3,A,골목상권,1000482,성미산로1길,635,489,146
2018,3,A,골목상권,1000481,성미산로11길,1103,767,336
2018,3,A,골목상권,1000480,백범로16길,709,363,346
2018,3,A,골목상권,1000479,방울내로9안길,354,215,139
2018,3,A,골목상권,1000478,모래내로7길,253,117,136
2018,3,A,골목상권,1000477,매봉산로2길,4355,2792,1563
2018,3,A,골목상권,1000476,망원로2길,200,123,77
2018,3,A,골목상권,1000475,망원로11길,1076,531,545
2018,3,A,골목상권,1000474,만리재옛길,1471,632,839
2018,3,A,골목상권,1000473,마포대로4길,181,100,81
2018,3,A,골목상권,1000472,마포대로20길,1015,551,464
2018,3,A,골목상권,1000471,마포대로12길,68,36,32
2018,3,A,골목상권,1000470,동교로38길,193,121,72
2018,3,A,골목상권,1000469,동교로27길,3631,1645,1986
2018,3,A,골목상권,1000468,동교로25길,562,284,278
2018,3,A,골목상권,1000467,동교로19길,4045,2692,1353
2018,3,A,골목상권,1000466,동교로17길,690,359,331
2018,3,A,골목상권,1000465,독막로8길,359,163,196
2018,3,A,골목상권,1000464,독막로32길,494,208,286
2018,3,A,골목상권,1000463,독막로22길,97,51,46
2018,3,A,골목상권,1000462,도화길,992,476,516
2018,3,A,골목상권,1000461,도화4길,405,132,273
2018,3,A,골목상권,1000460,대흥로28길,49,42,7
2018,3,A,골목상권,1000459,대흥로21길,438,83,355
2018,3,A,골목상권,1000458,광성로6길,179,112,67
2018,3,A,골목상권,1000457,홍제내길,103,58,45
2018,3,A,골목상권,1000456,홍연길,82,45,37
2018,3,A,골목상권,1000455,통일로39길,5,5,0
2018,3,A,골목상권,1000454,통일로37길,355,135,220
2018,3,A,골목상권,1000453,통일로11길,9,7,2
2018,3,A,골목상권,1000452,충정로6길,13115,8020,5095
2018,3,A,골목상권,1000451,충정로4길,3082,2015,1067
2018,3,A,골목상권,1000450,증가로6길,209,105,104
2018,3,A,골목상권,1000449,증가로23나길,477,253,224
2018,3,A,골목상권,1000448,증가로20가길,258,94,164
2018,3,A,골목상권,1000447,증가로10길,165,83,82
2018,3,A,골목상권,1000446,응암로1길,389,279,110
2018,3,A,골목상권,1000445,연희로10길,162,109,53
2018,3,A,골목상권,1000444,신촌로37길,104,50,54
2018,3,A,골목상권,1000443,수색로8길,2241,2135,106
2018,3,A,골목상권,1000442,세무서길,336,109,227
2018,3,A,골목상권,1000440,세검정로1길,276,100,176
2018,3,A,골목상권,1000439,북아현로4길,432,91,341
2018,3,A,골목상권,1000438,모래내로15길,126,40,86
2018,3,A,골목상권,1000437,명지대길,401,292,109
2018,3,A,골목상권,1000436,독립문로8길,781,307,474
2018,3,A,골목상권,1000435,가재울로6길,26,18,8
2018,3,A,골목상권,1000434,통일로92길,93,42,51
2018,3,A,골목상권,1000433,통일로87길,224,100,124
2018,3,A,골목상권,1000432,통일로78길,212,59,153
2018,3,A,골목상권,1000430,진흥로1길,556,172,384
2018,3,A,골목상권,1000429,진흥로12길,509,214,295
2018,3,A,골목상권,1000428,증산서길,401,277,124
2018,3,A,골목상권,1000427,증산로9길,84,27,57
2018,3,A,골목상권,1000426,증산로5길,747,388,359
2018,3,A,골목상권,1000425,증산로21길,236,140,96
2018,3,A,골목상권,1000424,증산로17길,683,298,385
2018,3,A,골목상권,1000423,증산로15길,230,87,143
2018,3,A,골목상권,1000422,증산로13길,71,36,35
2018,3,A,골목상권,1000421,응암로34길,60,38,22
2018,3,A,골목상권,1000420,응암로22길,187,67,120
2018,3,A,골목상권,1000419,응암로14길,456,169,287
2018,3,A,골목상권,1000418,응암로13길,301,129,172
2018,3,A,골목상권,1000417,응암로12길,198,115,83
2018,3,A,골목상권,1000416,은평로8길,247,115,132
2018,3,A,골목상권,1000415,은평로3길,301,104,197
2018,3,A,골목상권,1000414,은평로20길,6,2,4
2018,3,A,골목상권,1000413,은평로13길,364,220,144
2018,3,A,골목상권,1000412,은평로10길,287,144,143
2018,3,A,골목상권,1000411,연서로5길,41,15,26
2018,3,A,골목상권,1000410,연서로41길,242,75,167
2018,3,A,골목상권,1000409,연서로3길,113,46,67
2018,3,A,골목상권,1000408,연서로34길,150,57,93
2018,3,A,골목상권,1000407,연서로33길,33,13,20
2018,3,A,골목상권,1000406,연서로29길,300,93,207
2018,3,A,골목상권,1000405,연서로28길,732,356,376
2018,3,A,골목상권,1000404,연서로27길,82,23,59
2018,3,A,골목상권,1000403,연서로21길,290,156,134
2018,3,A,골목상권,1000402,연서로17길,1155,339,816
2018,3,A,골목상권,1000401,연서로16길,263,103,160
2018,3,A,골목상권,1000400,연서로13길,693,206,487
2018,3,A,골목상권,1000399,연서로11길,239,111,128
2018,3,A,골목상권,1000398,역말로9길,20,14,6
2018,3,A,골목상권,1000397,수색로18길,37,22,15
2018,3,A,골목상권,1000396,서오릉로8길,14,2,12
2018,3,A,골목상권,1000395,서오릉로21길,411,99,312
2018,3,A,골목상권,1000394,불광천길,200,99,101
2018,3,A,골목상권,1000393,갈현로7길,913,265,648
2018,3,A,골목상권,1000392,갈현로41길,123,50,73
2018,3,A,골목상권,1000391,갈현로33길,37,8,29
2018,3,A,골목상권,1000390,갈현로1길,203,88,115
2018,3,A,골목상권,1000389,가좌로7길,57,25,32
2018,3,A,골목상권,1000388,한글비석로44길,397,211,186
2018,3,A,골목상권,1000387,한글비석로24길,409,160,249
2018,3,A,골목상권,1000386,한글비석로22길,782,353,429
2018,3,A,골목상권,1000385,석계로1길,110,58,52
2018,3,A,골목상권,1000384,상계로9가길,305,104,201
2018,3,A,골목상권,1000382,상계로12길,19,12,7
2018,3,A,골목상권,1000381,동일로242길,244,161,83
2018,3,A,골목상권,1000380,동일로192길,458,202,256
2018,3,A,골목상권,1000379,동일로173가길,2867,1654,1213
2018,3,A,골목상권,1000378,공릉로58길,148,51,97
2018,3,A,골목상권,1000377,해등로16길,75,59,16
2018,3,A,골목상권,1000376,우이천로4다길,191,115,76
2018,3,A,골목상권,1000375,우이천로32길,91,56,35
2018,3,A,골목상권,1000374,시루봉로23길,49,22,27
2018,3,A,골목상권,1000373,삼양로144길,73,55,18
2018,3,A,골목상권,1000372,방학로6가길,202,109,93
2018,3,A,골목상권,1000371,방학로5길,137,70,67
2018,3,A,골목상권,1000370,방학로15길,304,193,111
2018,3,A,골목상권,1000369,방학로10길,215,104,111
2018,3,A,골목상권,1000367,도봉산4길,320,277,43
2018,3,A,골목상권,1000366,도봉로181길,185,82,103
2018,3,A,골목상권,1000365,도봉로169나길,272,104,168
2018,3,A,골목상권,1000364,도봉로156길,282,144,138
2018,3,A,골목상권,1000363,도봉로152가길,423,345,78
2018,3,A,골목상권,1000362,도봉로147길,557,320,237
2018,3,A,골목상권,1000360,도봉로114길,567,199,368
2018,3,A,골목상권,1000359,도봉로109길,30,9,21
2018,3,A,골목상권,1000358,도당로29길,870,509,361
2018,3,A,골목상권,1000357,도당로19길,190,99,91
2018,3,A,골목상권,1000356,도당로13바길,205,77,128
2018,3,A,골목상권,1000355,도당로13가길,155,66,89
2018,3,A,골목상권,1000354,덕릉로60길,90,54,36
2018,3,A,골목상권,1000353,노해로63다길,649,261,388
2018,3,A,골목상권,1000352,노해로60길,325,140,185
2018,3,A,골목상권,1000351,한천로140길,111,51,60
2018,3,A,골목상권,1000350,한천로139가길,50,29,21
2018,3,A,골목상권,1000349,한천로132길,332,132,200
2018,3,A,골목상권,1000348,한천로130길,279,120,159
2018,3,A,골목상권,1000347,한천로124나길,111,65,46
2018,3,A,골목상권,1000346,한천로109길,608,267,341
2018,3,A,골목상권,1000345,인수봉로79길,158,41,117
2018,3,A,골목상권,1000344,인수봉로72길,82,37,45
2018,3,A,골목상권,1000342,오패산로67길,583,286,297
2018,3,A,골목상권,1000341,오패산로52길,102,36,66
2018,3,A,골목상권,1000340,오패산로30길,10,6,4
2018,3,A,골목상권,1000339,수유로12길,236,153,83
2018,3,A,골목상권,1000338,솔샘로65길,472,202,270
2018,3,A,골목상권,1000337,솔매로50길,704,274,430
2018,3,A,골목상권,1000336,솔매로45길,196,90,106
2018,3,A,골목상권,1000335,솔매로41길,86,21,65
2018,3,A,골목상권,1000334,삼양로93길,17,4,13
2018,3,A,골목상권,1000333,삼양로77길,419,147,272
2018,3,A,골목상권,1000332,삼양로54길,8,4,4
2018,3,A,골목상권,1000331,삼양로41길,306,141,165
2018,3,A,골목상권,1000329,삼양로24길,101,51,50
2018,3,A,골목상권,1000328,삼양로20길,137,48,89
2018,3,A,골목상권,1000327,삼각산로28길,833,401,432
2018,3,A,골목상권,1000326,도봉로99길,217,103,114
2018,3,A,골목상권,1000325,도봉로8길,258,196,62
2018,3,A,골목상권,1000324,도봉로76길,389,212,177
2018,3,A,골목상권,1000323,도봉로67길,6,3,3
2018,3,A,골목상권,1000322,도봉로45길,113,67,46
2018,3,A,골목상권,1000321,도봉로18길,382,178,204
2018,3,A,골목상권,1000320,도봉로13길,26,9,17
2018,3,A,골목상권,1000319,덕릉로41길,794,628,166
2018,3,A,골목상권,1000318,덕릉로40길,919,715,204
2018,3,A,골목상권,1000317,노해로33길,32,11,21
2018,3,A,골목상권,1000315,노해로17길,252,75,177
2018,3,A,골목상권,1000314,화랑로40길,185,103,82
2018,3,A,골목상권,1000313,화랑로32길,466,349,117
2018,3,A,골목상권,1000312,화랑로1길,161,85,76
2018,3,A,골목상권,1000311,화랑로19길,561,316,245
2018,3,A,골목상권,1000310,화랑로14길,33,15,18
2018,3,A,골목상권,1000309,화랑로13길,83,40,43
2018,3,A,골목상권,1000308,한천로76길,135,77,58
2018,3,A,골목상권,1000307,한천로101가길,46,28,18
2018,3,A,골목상권,1000306,창경궁로43길,29,21,8
2018,3,A,골목상권,1000305,지봉로20길,118,67,51
2018,3,A,골목상권,1000304,종암로5길,132,88,44
2018,3,A,골목상권,1000303,종암로24가길,294,137,157
2018,3,A,골목상권,1000302,종암로21길,250,44,206
2018,3,A,골목상권,1000301,종암로19길,408,132,276
2018,3,A,골목상권,1000300,종암로16길,89,38,51
2018,3,A,골목상권,1000299,정릉로8길,196,116,80
2018,3,A,골목상권,1000298,정릉로27길,212,95,117
2018,3,A,골목상권,1000296,장위로50길,685,411,274
2018,3,A,골목상권,1000295,장월로1길,341,173,168
2018,3,A,골목상권,1000294,인촌로6길,3273,1916,1357
2018,3,A,골목상권,1000293,인촌로5길,26,2,24
2018,3,A,골목상권,1000292,인촌로24길,236,154,82
2018,3,A,골목상권,1000291,개운사길,3713,2231,1482
2018,3,A,골목상권,1000290,인촌로1길,150,102,48
2018,3,A,골목상권,1000289,인촌로17가길,3323,1184,2139
2018,3,A,골목상권,1000288,오패산로4길,624,194,430
2018,3,A,골목상권,1000287,오패산로3길,1178,659,519
2018,3,A,골목상권,1000286,오패산로19길,41,18,23
2018,3,A,골목상권,1000285,안암로5길,612,379,233
2018,3,A,골목상권,1000284,아리랑로4길,558,217,341
2018,3,A,골목상권,1000283,솔샘로6길,154,70,84
2018,3,A,골목상권,1000282,성북로8길,56,25,31
2018,3,A,골목상권,1000281,삼양로8길,65,41,24
2018,3,A,골목상권,1000280,삼선교로16가길,735,419,316
2018,3,A,골목상권,1000279,삼선교로10다길,94,52,42
2018,3,A,골목상권,1000278,삼선교로10길,295,123,172
2018,3,A,골목상권,1000277,보문로32길,1017,413,604
2018,3,A,골목상권,1000276,보문로31길,702,285,417
2018,3,A,골목상권,1000274,보문로13길,931,600,331
2018,3,A,골목상권,1000273,보국문로16길,389,251,138
2018,3,A,골목상권,1000270,동소문로26가길,230,109,121
2018,3,A,골목상권,1000269,동소문로15길,128,57,71
2018,3,A,골목상권,1000268,동소문로13길,435,223,212
2018,3,A,골목상권,1000267,돌곶이로8길,182,87,95
2018,3,A,골목상권,1000266,돌곶이로41길,43,20,23
2018,3,A,골목상권,1000265,돌곶이로28길,227,143,84
2018,3,A,골목상권,1000264,돌곶이로27길,71,45,26
2018,3,A,골목상권,1000263,돌곶이로22길,132,68,64
2018,3,A,골목상권,1000261,길음로7길,8,5,3
2018,3,A,골목상권,1000260,중랑천로10길,770,382,388
2018,3,A,골목상권,1000259,용마산로94길,456,279,177
2018,3,A,골목상권,1000258,용마산로118길,566,275,291
2018,3,A,골목상권,1000257,용마산로112길,356,151,205
2018,3,A,골목상권,1000256,용마산로100길,433,294,139
2018,3,A,골목상권,1000255,신내로7가길,276,67,209
2018,3,A,골목상권,1000254,사가정로54길,135,46,89
2018,3,A,골목상권,1000253,사가정로42길,84,24,60
2018,3,A,골목상권,1000252,봉화산로56길,558,151,407
2018,3,A,골목상권,1000251,봉화산로4길,412,158,254
2018,3,A,골목상권,1000250,봉화산로30길,354,217,137
2018,3,A,골목상권,1000249,봉우재로33길,114,43,71
2018,3,A,골목상권,1000248,면목로78길,254,146,108
2018,3,A,골목상권,1000247,면목로56길,205,154,51
2018,3,A,골목상권,1000246,면목로55길,364,109,255
2018,3,A,골목상권,1000245,면목로49길,545,182,363
2018,3,A,골목상권,1000244,면목로48길,122,61,61
2018,3,A,골목상권,1000243,면목로45길,67,30,37
2018,3,A,골목상권,1000242,면목로33길,405,163,242
2018,3,A,골목상권,1000241,면목로21길,32,25,7
2018,3,A,골목상권,1000240,망우로73길,8,4,4
2018,3,A,골목상권,1000239,망우로68길,83,28,55
2018,3,A,골목상권,1000238,동일로163길,90,57,33
2018,3,A,골목상권,1000237,동일로157길,223,122,101
2018,3,A,골목상권,1000236,동일로149길,1154,859,295
2018,3,A,골목상권,1000235,동일로140길,189,84,105
2018,3,A,골목상권,1000234,동일로139길,64,35,29
2018,3,A,골목상권,1000233,동일로139가길,1207,688,519
2018,3,A,골목상권,1000232,동일로130길,118,46,72
2018,3,A,골목상권,1000231,동일로123길,184,96,88
2018,3,A,골목상권,1000230,동일로112길,156,71,85
2018,3,A,골목상권,1000229,동일로101길,289,116,173
2018,3,A,골목상권,1000228,동일로100길,74,36,38
2018,3,A,골목상권,1000227,답십리로75길,106,55,51
2018,3,A,골목상권,1000226,공릉로2길,665,299,366
2018,3,A,골목상권,1000225,공릉로12가길,28,19,9
2018,3,A,골목상권,1000224,겸재로54길,107,44,63
2018,3,A,골목상권,1000223,겸재로36길,242,195,47
2018,3,A,골목상권,1000222,겸재로29길,449,182,267
2018,3,A,골목상권,1000221,휘경로3길,232,114,118
2018,3,A,골목상권,1000220,휘경로2길,9,2,7
2018,3,A,골목상권,1000219,휘경로23길,19,4,15
2018,3,A,골목상권,1000218,휘경로14길,128,46,82
2018,3,A,골목상권,1000217,한천로46길,323,95,228
2018,3,A,골목상권,1000216,한천로40길,302,150,152
2018,3,A,골목상권,1000215,한천로33길,81,40,41
2018,3,A,골목상권,1000214,한천로14길,584,344,240
2018,3,A,골목상권,1000213,천호대로97길,343,218,125
2018,3,A,골목상권,1000212,천호대로77길,2055,1049,1006
2018,3,A,골목상권,1000211,천호대로45길,122,66,56
2018,3,A,골목상권,1000210,천호대로17길,2257,1465,792
2018,3,A,골목상권,1000209,천호대로12길,806,529,277
2018,3,A,골목상권,1000208,천장산로7길,1481,901,580
2018,3,A,골목상권,1000207,제기로5길,224,95,129
2018,3,A,골목상권,1000206,제기로21길,232,153,79
2018,3,A,골목상권,1000205,전농로4길,689,425,264
2018,3,A,골목상권,1000204,전농로3길,73,36,37
2018,3,A,골목상권,1000203,전농로29길,321,141,180
2018,3,A,골목상권,1000202,장한로8길,802,474,328
2018,3,A,골목상권,1000201,장한로5길,3043,2165,878
2018,3,A,골목상권,1000200,장한로27길,140,39,101
2018,3,A,골목상권,1000199,장한로27가길,422,201,221
2018,3,A,골목상권,1000198,장한로26길,533,253,280
2018,3,A,골목상권,1000197,장한로26가길,328,151,177
2018,3,A,골목상권,1000196,장한로25길,1042,478,564
2018,3,A,골목상권,1000195,장한로14길,184,150,34
2018,3,A,골목상권,1000194,이문로42길,270,115,155
2018,3,A,골목상권,1000193,왕산로43길,897,386,511
2018,3,A,골목상권,1000192,왕산로33길,158,108,50
2018,3,A,골목상권,1000191,왕산로32길,6,5,1
2018,3,A,골목상권,1000190,약령시로17길,340,163,177
2018,3,A,골목상권,1000189,서울시립대로4길,659,356,303
2018,3,A,골목상권,1000188,서울시립대로29길,221,123,98
2018,3,A,골목상권,1000187,서울시립대로16길,136,32,104
2018,3,A,골목상권,1000186,사가정로2길,86,67,19
2018,3,A,골목상권,1000185,사가정로23가길,98,64,34
2018,3,A,골목상권,1000184,사가정로13길,278,82,196
2018,3,A,골목상권,1000183,무학로45길,345,204,141
2018,3,A,골목상권,1000182,무학로16길,1213,1110,103
2018,3,A,골목상권,1000181,망우로21길,196,103,93
2018,3,A,골목상권,1000180,망우로18길,363,121,242
2018,3,A,골목상권,1000179,망우로18가길,71,30,41
2018,3,A,골목상권,1000178,답십리로72길,4,2,2
2018,3,A,골목상권,1000177,답십리로69길,926,401,525
2018,3,A,골목상권,1000176,답십리로68길,97,60,37
2018,3,A,골목상권,1000175,답십리로64길,355,213,142
2018,3,A,골목상권,1000174,답십리로63길,81,50,31
2018,3,A,골목상권,1000173,답십리로60길,14,6,8
2018,3,A,골목상권,1000172,답십리로56길,16,13,3
2018,3,A,골목상권,1000171,답십리로23길,6,4,2
2018,3,A,골목상권,1000170,난계로30길,131,89,42
2018,3,A,골목상권,1000168,경희대로3길,289,185,104
2018,3,A,골목상권,1000167,천호대로129길,230,85,145
2018,3,A,골목상권,1000166,천호대로123길,294,114,180
2018,3,A,골목상권,1000165,천호대로109길,1212,662,550
2018,3,A,골목상권,1000164,자양번영로3길,87,37,50
2018,3,A,골목상권,1000163,자양로53길,2,1,1
2018,3,A,골목상권,1000162,자양로50길,24,9,15
2018,3,A,골목상권,1000161,자양로45길,570,294,276
2018,3,A,골목상권,1000160,자양로26길,298,112,186
2018,3,A,골목상권,1000159,자양로15길,331,227,104
2018,3,A,골목상권,1000158,자양로11길,1347,689,658
2018,3,A,골목상권,1000157,용마산로3길,1005,588,417
2018,3,A,골목상권,1000156,용마산로21길,171,84,87
2018,3,A,골목상권,1000155,아차산로78길,2678,1322,1356
2018,3,A,골목상권,1000154,아차산로65길,675,447,228
2018,3,A,골목상권,1000153,아차산로55길,398,219,179
2018,3,A,골목상권,1000152,아차산로51길,243,144,99
2018,3,A,골목상권,1000151,아차산로40길,536,306,230
2018,3,A,골목상권,1000150,면목로17길,272,174,98
2018,3,A,골목상권,1000149,뚝섬로64길,300,162,138
2018,3,A,골목상권,1000148,뚝섬로58길,189,61,128
2018,3,A,골목상권,1000147,뚝섬로54길,152,93,59
2018,3,A,골목상권,1000146,뚝섬로48길,847,387,460
2018,3,A,골목상권,1000145,뚝섬로24길,96,30,66
2018,3,A,골목상권,1000144,뚝섬로23길,110,63,47
2018,3,A,골목상권,1000143,동일로24길,16,4,12
2018,3,A,골목상권,1000142,동일로18길,200,84,116
2018,3,A,골목상권,1000141,능동로4길,236,101,135
2018,3,A,골목상권,1000140,능동로3길,204,99,105
2018,3,A,골목상권,1000139,능동로34길,911,509,402
2018,3,A,골목상권,1000138,능동로19길,324,212,112
2018,3,A,골목상권,1000137,능동로13길,332,138,194
2018,3,A,골목상권,1000136,긴고랑로9길,47,24,23
2018,3,A,골목상권,1000135,긴고랑로8길,224,178,46
2018,3,A,골목상권,1000134,긴고랑로7길,497,246,251
2018,3,A,골목상권,1000133,긴고랑로20길,587,283,304
2018,3,A,골목상권,1000132,광나루로52길,1932,882,1050
2018,3,A,골목상권,1000131,광나루로40길,137,63,74
2018,3,A,골목상권,1000130,광나루로37길,306,186,120
2018,3,A,골목상권,1000129,광나루로36길,50,30,20
2018,3,A,골목상권,1000128,광나루로24길,83,47,36
2018,3,A,골목상권,1000127,광나루로12길,1047,586,461
2018,3,A,골목상권,1000126,한림말길,65,35,30
2018,3,A,골목상권,1000124,청계천로10나길,1826,1072,754
2018,3,A,골목상권,1000123,장터길,39,15,24
2018,3,A,골목상권,1000122,용답중앙길,92,47,45
2018,3,A,골목상권,1000121,용답29길,1708,902,806
2018,3,A,골목상권,1000120,왕십리로6길,1457,808,649
2018,3,A,골목상권,1000119,왕십리로31길,81,42,39
2018,3,A,골목상권,1000118,왕십리로26길,4069,2485,1584
2018,3,A,골목상권,1000117,왕십리로21길,196,65,131
2018,3,A,골목상권,1000116,왕십리로14길,2760,1981,779
2018,3,A,골목상권,1000115,아차산로5길,2254,1475,779
2018,3,A,골목상권,1000114,아차산로15길,4423,3129,1294
2018,3,A,골목상권,1000113,아차산로11길,3763,2445,1318
2018,3,A,골목상권,1000112,송정4가길,1033,447,586
2018,3,A,골목상권,1000111,송정12라길,266,184,82
2018,3,A,골목상권,1000110,성수일로6길,2624,1639,985
2018,3,A,골목상권,1000109,성수이로7길,558,315,243
2018,3,A,골목상권,1000108,성수이로18길,2355,1649,706
2018,3,A,골목상권,1000107,성덕정길,897,521,376
2018,3,A,골목상권,1000106,성덕정17길,234,123,111
2018,3,A,골목상권,1000105,서울숲2길,1098,643,455
2018,3,A,골목상권,1000104,상원길,1553,997,556
2018,3,A,골목상권,1000103,상원12길,170,105,65
2018,3,A,골목상권,1000102,사근동길,30,18,12
2018,3,A,골목상권,1000101,무학봉길,5,3,2
2018,3,A,골목상권,1000100,무학봉28길,134,60,74
2018,3,A,골목상권,1000099,무학로6길,387,216,171
2018,3,A,골목상권,1000098,무수막길,153,74,79
2018,3,A,골목상권,1000097,매봉길,10,7,3
2018,3,A,골목상권,1000096,마조로1길,216,79,137
2018,3,A,골목상권,1000095,마조로16길,839,589,250
2018,3,A,골목상권,1000094,마장로39길,107,51,56
2018,3,A,골목상권,1000093,마장로27길,77,22,55
2018,3,A,골목상권,1000091,둘레9길,391,231,160
2018,3,A,골목상권,1000090,금호산길,436,156,280
2018,3,A,골목상권,1000089,금호산2길,36,12,24
2018,3,A,골목상권,1000088,고산자로6길,9832,3564,6268
2018,3,A,골목상권,1000087,후암로28길,209,92,117
2018,3,A,골목상권,1000086,효창원로39길,57,31,26
2018,3,A,골목상권,1000085,회나무로13길,85,46,39
2018,3,A,골목상권,1000084,한남대로20길,772,432,340
2018,3,A,골목상권,1000082,한강대로7길,491,331,160
2018,3,A,골목상권,1000081,한강대로62길,742,505,237
2018,3,A,골목상권,1000080,한강대로52길,1146,735,411
2018,3,A,골목상권,1000079,한강대로43길,5969,3751,2218
2018,3,A,골목상권,1000078,한강대로15길,1230,345,885
2018,3,A,골목상권,1000077,한강대로104길,11313,4081,7232
2018,3,A,골목상권,1000076,청파로73길,1175,614,561
2018,3,A,골목상권,1000075,청파로71길,228,112,116
2018,3,A,골목상권,1000074,청파로47나길,171,97,74
2018,3,A,골목상권,1000073,청파로47길,969,423,546
2018,3,A,골목상권,1000072,장문로45길,55,13,42
2018,3,A,골목상권,1000071,이태원로54길,2259,1093,1166
2018,3,A,골목상권,1000070,이태원로27길,629,356,273
2018,3,A,골목상권,1000069,이촌로22길,279,165,114
2018,3,A,골목상권,1000068,원효로89길,893,734,159
2018,3,A,골목상권,1000067,원효로53길,867,532,335
2018,3,A,골목상권,1000066,원효로41길,1490,1016,474
2018,3,A,골목상권,1000065,원효로19길,1038,733,305
2018,3,A,골목상권,1000064,우사단로4길,152,91,61
2018,3,A,골목상권,1000063,우사단로14길,1886,905,981
2018,3,A,골목상권,1000062,우사단로10길,87,39,48
2018,3,A,골목상권,1000061,신흥로20길,216,93,123
2018,3,A,골목상권,1000060,소월로20길,136,53,83
2018,3,A,골목상권,1000059,서빙고로71길,469,283,186
2018,3,A,골목상권,1000058,백범로90길,256,155,101
2018,3,A,골목상권,1000057,백범로79길,725,440,285
2018,3,A,골목상권,1000056,두텁바위로1길,2758,1484,1274
2018,3,A,골목상권,1000055,대사관로34길,291,142,149
2018,3,A,골목상권,1000054,녹사평대로46길,74,46,28
2018,3,A,골목상권,1000053,녹사평대로40나길,65,29,36
2018,3,A,골목상권,1000052,녹사평대로32길,389,218,171
2018,3,A,골목상권,1000051,녹사평대로26길,2081,1090,991
2018,3,A,골목상권,1000050,녹사평대로11길,267,175,92
2018,3,A,골목상권,1000049,퇴계로90길,599,220,379
2018,3,A,골목상권,1000048,퇴계로8길,2397,1293,1104
2018,3,A,골목상권,1000047,퇴계로56길,1285,1042,243
2018,3,A,골목상권,1000046,퇴계로46길,2119,1001,1118
2018,3,A,골목상권,1000045,퇴계로18길,3099,1354,1745
2018,3,A,골목상권,1000044,퇴계로12길,1154,488,666
2018,3,A,골목상권,1000043,청구로1길,250,84,166
2018,3,A,골목상권,1000042,청구로17길,1721,804,917
2018,3,A,골목상권,1000041,장충단로8길,3242,1195,2047
2018,3,A,골목상권,1000040,삼일대로4길,957,571,386
2018,3,A,골목상권,1000039,명동길,36306,17786,18520
2018,3,A,골목상권,1000037,동호로20길,854,337,517
2018,3,A,골목상권,1000036,동호로15길,4108,2168,1940
2018,3,A,골목상권,1000035,동호로11길,17,11,6
2018,3,A,골목상권,1000034,동호로10길,1587,702,885
2018,3,A,골목상권,1000033,다산로39길,1339,742,597
2018,3,A,골목상권,1000032,다산로38길,1628,724,904
2018,3,A,골목상권,1000031,다산로36길,70,42,28
2018,3,A,골목상권,1000030,다산로33길,396,202,194
2018,3,A,골목상권,1000029,난계로21길,252,160,92
2018,3,A,골목상권,1000028,난계로11길,1823,1066,757
2018,3,A,골목상권,1000027,필운대로1길,4,1,3
2018,3,A,골목상권,1000026,평창길,206,101,105
2018,3,A,골목상권,1000025,통일로12길,236,94,142
2018,3,A,골목상권,1000024,창신길,271,69,202
2018,3,A,골목상권,1000023,창신5길,8,3,5
2018,3,A,골목상권,1000022,창신2길,56,26,30
2018,3,A,골목상권,1000021,창경궁로35길,1114,326,788
2018,3,A,골목상권,1000020,지봉로8길,195,97,98
2018,3,A,골목상권,1000019,종로65길,486,250,236
2018,3,A,골목상권,1000016,자하문로7길,624,398,226
2018,3,A,골목상권,1000015,이화장길,1996,960,1036
2018,3,A,골목상권,1000014,율곡로16길,103,90,13
2018,3,A,골목상권,1000013,율곡로10길,2228,1612,616
2018,3,A,골목상권,1000012,옥인길,469,195,274
2018,3,A,골목상권,1000011,숭인동길,24,5,19
2018,3,A,골목상권,1000010,성균관로5길,133,82,51
2018,3,A,골목상권,1000009,삼청로5길,449,169,280
2018,3,A,골목상권,1000008,북촌로5나길,1693,1128,565
2018,3,A,골목상권,1000007,북촌로5길,57,24,33
2018,3,A,골목상권,1000006,북촌로11길,12,5,7
2018,3,A,골목상권,1000005,백석동길,139,73,66
2018,3,A,골목상권,1000004,명륜길,18,8,10
2018,3,A,골목상권,1000003,돈화문로11가길,1048,569,479
2018,3,A,골목상권,1000001,계동길,829,356,473
2018,2,U,관광특구,1001496,강남 마이스 관광특구,22562,12970,9592
2018,2,U,관광특구,1001495,잠실 관광특구,30675,17928,12747
2018,2,U,관광특구,1001494,종로?청계 관광특구,31692,19002,12690
2018,2,U,관광특구,1001493,동대문패션타운 관광특구,10568,5953,4615
2018,2,U,관광특구,1001492,명동 남대문 북창동 다동 무교동 관광특구,158818,77955,80863
2018,2,U,관광특구,1001491,이태원 관광특구,5857,3193,2664
2018,2,R,전통시장,1001490,길동복조리시장,471,321,150
2018,2,R,전통시장,1001489,둔촌역전통시장,169,79,90
2018,2,R,전통시장,1001488,성내골목시장,6,2,4
2018,2,R,전통시장,1001487,천호시장,9,4,5
2018,2,R,전통시장,1001483,암사종합시장,829,387,442
2018,2,R,전통시장,1001482,고덕전통시장,400,387,13
2018,2,R,전통시장,1001481,명일골목시장,531,208,323
2018,2,R,전통시장,1001480,새마을시장,385,227,158
2018,2,R,전통시장,1001479,석촌시장,165,98,67
2018,2,R,전통시장,1001478,방이시장,611,372,239
2018,2,R,전통시장,1001477,마천시장,216,77,139
2018,2,R,전통시장,1001476,풍납시장,10,2,8
2018,2,R,전통시장,1001475,강남개포시장,36,31,5
2018,2,R,전통시장,1001474,도곡시장,484,215,269
2018,2,R,전통시장,1001471,영동전통시장,3036,2192,844
2018,2,R,전통시장,1001466,미성동도깨비시장,409,167,242
2018,2,R,전통시장,1001465,신신림시장,3,2,1
2018,2,R,전통시장,1001464,삼성동시장,94,38,56
2018,2,R,전통시장,1001463,신림중앙시장,12,7,5
2018,2,R,전통시장,1001462,강남골목시장,262,139,123
2018,2,R,전통시장,1001460,관악신사시장,171,79,92
2018,2,R,전통시장,1001459,신원시장,330,124,206
2018,2,R,전통시장,1001458,인헌시장,204,95,109
2018,2,R,전통시장,1001456,봉천현대시장,10,4,6
2018,2,R,전통시장,1001454,봉천제일종합시장,62,31,31
2018,2,R,전통시장,1001453,낙성대시장,16,9,7
2018,2,R,전통시장,1001452,중부시장,185,54,131
2018,2,R,전통시장,1001450,남성역골목시장,563,254,309
2018,2,R,전통시장,1001449,남성사계시장,1983,874,1109
2018,2,R,전통시장,1001448,흑석시장,171,54,117
2018,2,R,전통시장,1001447,상도4동도깨비골목시장,327,84,243
2018,2,R,전통시장,1001445,영도시장,83,41,42
2018,2,R,전통시장,1001441,본동인정시장,134,73,61
2018,2,R,전통시장,1001439,대림중앙시장,20,9,11
2018,2,R,전통시장,1001438,우리시장,18,9,9
2018,2,R,전통시장,1001437,영진시장A동,47,41,6
2018,2,R,전통시장,1001436,사러가시장,34,12,22
2018,2,R,전통시장,1001431,영등포청과시장,218,143,75
2018,2,R,전통시장,1001430,영등포전통시장,4063,1979,2084
2018,2,R,전통시장,1001429,은행나무시장,69,14,55
2018,2,R,전통시장,1001427,현대시장,45,11,34
2018,2,R,전통시장,1001424,남문시장,271,114,157
2018,2,R,전통시장,1001423,독산동 우시장,137,58,79
2018,2,R,전통시장,1001421,개봉중앙시장,10,5,5
2018,2,R,전통시장,1001419,가리봉시장,16,13,3
2018,2,R,전통시장,1001418,남구로시장,13,3,10
2018,2,R,전통시장,1001417,구로시장,60,19,41
2018,2,R,전통시장,1001415,방신전통시장,47,26,21
2018,2,R,전통시장,1001414,송화골목시장,563,187,376
2018,2,R,전통시장,1001413,까치산시장,46,27,19
2018,2,R,전통시장,1001411,남부골목시장,217,92,125
2018,2,R,전통시장,1001409,화곡중앙골목시장,2,2,0
2018,2,R,전통시장,1001407,등마루시장,799,452,347
2018,2,R,전통시장,1001406,신정3동골목시장,181,94,87
2018,2,R,전통시장,1001405,신정2동골목시장,6,6,0
2018,2,R,전통시장,1001402,신월6동골목시장,229,123,106
2018,2,R,전통시장,1001401,신곡종합시장,13,9,4
2018,2,R,전통시장,1001400,신월3동골목시장,68,24,44
2018,2,R,전통시장,1001399,경창시장,208,85,123
2018,2,R,전통시장,1001398,월정로시장,123,71,52
2018,2,R,전통시장,1001397,신영시장,56,20,36
2018,2,R,전통시장,1001396,목4동시장,211,70,141
2018,2,R,전통시장,1001395,목3동시장,768,376,392
2018,2,R,전통시장,1001394,목2동시장,228,108,120
2018,2,R,전통시장,1001393,마포농수산물시장,461,295,166
2018,2,R,전통시장,1001391,망원월드컵시장,16,11,5
2018,2,R,전통시장,1001390,망원시장,60,30,30
2018,2,R,전통시장,1001386,신수시장,121,83,38
2018,2,R,전통시장,1001385,아현시장,25,5,20
2018,2,R,전통시장,1001374,대림골목시장,411,134,277
2018,2,R,전통시장,1001367,상계중앙시장,42,20,22
2018,2,R,전통시장,1001364,방학동도깨비시장,160,66,94
2018,2,R,전통시장,1001363,쌍문역골목시장,71,35,36
2018,2,R,전통시장,1001361,신도봉시장,28,15,13
2018,2,R,전통시장,1001359,창동신창시장,141,60,81
2018,2,R,전통시장,1001358,수유북부시장,12,2,10
2018,2,R,전통시장,1001357,장미원골목시장,67,41,26
2018,2,R,전통시장,1001356,수유중앙시장,127,67,60
2018,2,R,전통시장,1001355,강북종합시장,65,28,37
2018,2,R,전통시장,1001354,우이시장,157,52,105
2018,2,R,전통시장,1001353,수유전통시장,411,152,259
2018,2,R,전통시장,1001352,번동북부골목시장,84,44,40
2018,2,R,전통시장,1001351,솔샘시장,109,45,64
2018,2,R,전통시장,1001349,방천골목시장,77,28,49
2018,2,R,전통시장,1001347,석관황금시장,78,26,52
2018,2,R,전통시장,1001343,장위전통시장,190,76,114
2018,2,R,전통시장,1001340,정릉시장,37,13,24
2018,2,R,전통시장,1001339,정릉아리랑시장,2,1,1
2018,2,R,전통시장,1001338,돈암제일시장,52,19,33
2018,2,R,전통시장,1001336,우림골목시장,218,108,110
2018,2,R,전통시장,1001335,묵1동도깨비시장,290,125,165
2018,2,R,전통시장,1001334,태능시장,3,1,2
2018,2,R,전통시장,1001333,중화제일시장,22,1,21
2018,2,R,전통시장,1001332,사가정시장,245,172,73
2018,2,R,전통시장,1001330,동원시장,72,35,37
2018,2,R,전통시장,1001329,동부골목시장,105,37,68
2018,2,R,전통시장,1001326,회기시장,114,52,62
2018,2,R,전통시장,1001323,답십리시장,31,10,21
2018,2,R,전통시장,1001321,답십리현대시장,98,79,19
2018,2,R,전통시장,1001319,청량리종합시장,10,6,4
2018,2,R,전통시장,1001317,청량리농수산물시장,21,16,5
2018,2,R,전통시장,1001316,서울약령시장,1319,793,526
2018,2,R,전통시장,1001313,청량리수산시장,227,115,112
2018,2,R,전통시장,1001310,구의시장,132,80,52
2018,2,R,전통시장,1001309,조양시장,91,48,43
2018,2,R,전통시장,1001308,영동교골목시장,18,12,6
2018,2,R,전통시장,1001307,능동로골목시장,275,240,35
2018,2,R,전통시장,1001304,자양골목시장,97,51,46
2018,2,R,전통시장,1001301,중곡제일시장,130,65,65
2018,2,R,전통시장,1001299,한아름시장,174,93,81
2018,2,R,전통시장,1001298,성동용답상가시장,312,155,157
2018,2,R,전통시장,1001297,뚝도시장,35,14,21
2018,2,R,전통시장,1001296,금남시장,29,13,16
2018,2,R,전통시장,1001295,행당시장,257,122,135
2018,2,R,전통시장,1001294,마장축산물시장,1516,1018,498
2018,2,R,전통시장,1001289,용문전통시장,41,20,21
2018,2,R,전통시장,1001286,후암시장,48,19,29
2018,2,R,전통시장,1001285,합동(새벽)시장,2365,1366,999
2018,2,R,전통시장,1001284,서울중앙시장,278,184,94
2018,2,R,전통시장,1001283,백학시장,463,238,225
2018,2,R,전통시장,1001282,약수시장,1786,703,1083
2018,2,R,전통시장,1001281,청평화시장,3360,2011,1349
2018,2,R,전통시장,1001280,제일평화시장,570,325,245
2018,2,R,전통시장,1001278,남평화시장,200,123,77
2018,2,R,전통시장,1001277,방산종합시장,1879,1180,699
2018,2,R,전통시장,1001275,인현시장,1084,665,419
2018,2,R,전통시장,1001274,신중부시장,2437,1607,830
2018,2,R,전통시장,1001273,남대문시장,7146,3645,3501
2018,2,R,전통시장,1001271,동묘시장,903,568,335
2018,2,R,전통시장,1001270,창신골목시장,223,116,107
2018,2,R,전통시장,1001268,충신시장,297,182,115
2018,2,R,전통시장,1001267,종로신진시장,39,19,20
2018,2,R,전통시장,1001266,동대문종합시장,320,185,135
2018,2,R,전통시장,1001265,광장시장,204,152,52
2018,2,D,발달상권,1001263,서울 노원구 노원역_3,775,329,446
2018,2,D,발달상권,1001261,서울 노원구 노원역_1,1068,309,759
2018,2,D,발달상권,1001260,창동역,2477,1573,904
2018,2,D,발달상권,1001259,서울 강북구 수유역_3,64,32,32
2018,2,D,발달상권,1001257,서울 강북구 수유역_2,4370,2230,2140
2018,2,D,발달상권,1001256,서울 강북구 수유역_1,43,30,13
2018,2,D,발달상권,1001255,서울 은평구 연신내역_3,676,207,469
2018,2,D,발달상권,1001254,서울 은평구 연신내역_2,451,195,256
2018,2,D,발달상권,1001253,서울 은평구 연신내역_1,74,30,44
2018,2,D,발달상권,1001252,서울 성북구 미아삼거리역_2,507,206,301
2018,2,D,발달상권,1001251,서울 강북구 미아삼거리역_1,542,200,342
2018,2,D,발달상권,1001250,서울 은평구 불광역_3,54,19,35
2018,2,D,발달상권,1001249,서울 은평구 불광역_2,69,26,43
2018,2,D,발달상권,1001248,서울 은평구 불광역_1,284,113,171
2018,2,D,발달상권,1001247,미아사거리_2,121,41,80
2018,2,D,발달상권,1001246,미아사거리_1,621,283,338
2018,2,D,발달상권,1001245,서울 성북구 성신여대입구역,5286,3156,2130
2018,2,D,발달상권,1001244,경희대학교,370,178,192
2018,2,D,발달상권,1001243,서울 성북구 안암역,112,69,43
2018,2,D,발달상권,1001242,혜화역 대학로_3,1727,826,901
2018,2,D,발달상권,1001241,혜화역 대학로_2,1513,820,693
2018,2,D,발달상권,1001240,혜화역 대학로_1,1225,637,588
2018,2,D,발달상권,1001239,디지털미디어시티,17010,11036,5974
2018,2,D,발달상권,1001238,서울 동대문구 청량리역,3509,2402,1107
2018,2,D,발달상권,1001236,서울 종로구 안국역_2,706,276,430
2018,2,D,발달상권,1001235,서울 종로구 안국역_1,11483,9242,2241
2018,2,D,발달상권,1001234,서울 종로구 경복궁역_1,207,80,127
2018,2,D,발달상권,1001233,서울 종로구 종로3가역_3,3411,1821,1590
2018,2,D,발달상권,1001232,서울 종로구 종로3가역_2,1922,1023,899
2018,2,D,발달상권,1001231,서울 동대문구 신설동역_2,4377,2078,2299
2018,2,D,발달상권,1001230,인사동,21052,13045,8007
2018,2,D,발달상권,1001229,서울 종로구 종로5가역_4,635,349,286
2018,2,D,발달상권,1001228,서울 종로구 종로5가역_3,4960,3352,1608
2018,2,D,발달상권,1001227,종로구청,18495,10125,8370
2018,2,D,발달상권,1001226,서울 종로구 종로5가역_2,17391,11598,5793
2018,2,D,발달상권,1001225,신설동역,738,421,317
2018,2,D,발달상권,1001224,서울 동대문구 신설동역_1,2,2,0
2018,2,D,발달상권,1001223,서울 종로구 광화문역_2,54371,32642,21729
2018,2,D,발달상권,1001222,동묘앞역,68,40,28
2018,2,D,발달상권,1001221,장안동사거리,503,249,254
2018,2,D,발달상권,1001220,서울 종로구 동대문역_2,1106,550,556
2018,2,D,발달상권,1001218,동대문시장_2,500,300,200
2018,2,D,발달상권,1001217,서울 종로구 종로5가역_1,50,38,12
2018,2,D,발달상권,1001216,서울 종로구 종로3가역_1,4034,1757,2277
2018,2,D,발달상권,1001215,서울 종로구 광화문역_1,2103,1344,759
2018,2,D,발달상권,1001214,종각역,20751,13526,7225
2018,2,D,발달상권,1001213,종각역 젊음의 거리,2712,1114,1598
2018,2,D,발달상권,1001212,서대문구 서대문역_1,348,250,98
2018,2,D,발달상권,1001211,동대문시장_1,437,223,214
2018,2,D,발달상권,1001210,시청역_2,21859,13798,8061
2018,2,D,발달상권,1001209,서울시청,23497,11478,12019
2018,2,D,발달상권,1001208,서울 중구 을지로3가역_2,7863,5061,2802
2018,2,D,발달상권,1001207,서울 중구 신당역_2,1354,683,671
2018,2,D,발달상권,1001206,서대문구 서대문역_2,1449,871,578
2018,2,D,발달상권,1001205,동대문역사문화공원역,2248,1277,971
2018,2,D,발달상권,1001204,서울 중구 을지로3가역_1,18018,11428,6590
2018,2,D,발달상권,1001203,명동거리,9026,4728,4298
2018,2,D,발달상권,1001202,롯데백화점,40463,21491,18972
2018,2,D,발달상권,1001201,서울 중구 신당역_1,1057,702,355
2018,2,D,발달상권,1001200,북창동,10548,5655,4893
2018,2,D,발달상권,1001199,서울 중구 충무로역_2,14898,6701,8197
2018,2,D,발달상권,1001198,서울 강서구 송정역,616,407,209
2018,2,D,발달상권,1001197,장한평역_2,5325,3255,2070
2018,2,D,발달상권,1001196,시청역_1,54859,33251,21608
2018,2,D,발달상권,1001195,왕십리역_2,668,280,388
2018,2,D,발달상권,1001194,서울 강서구 발산역,874,492,382
2018,2,D,발달상권,1001193,장한평역_1,2508,1570,938
2018,2,D,발달상권,1001192,서울 중구 충무로역_1,3239,2248,991
2018,2,D,발달상권,1001190,장한평역,2303,1580,723
2018,2,D,발달상권,1001189,서울 중구 명동역,3988,2012,1976
2018,2,D,발달상권,1001188,장충동 족발거리,187,89,98
2018,2,D,발달상권,1001187,한양시장,266,156,110
2018,2,D,발달상권,1001186,서울 서대문구 이대역,1395,638,757
2018,2,D,발달상권,1001185,서울 서대문구 신촌역,3278,1418,1860
2018,2,D,발달상권,1001184,서울 마포구 홍대입구역_3,342,155,187
2018,2,D,발달상권,1001183,서울 마포구 홍대입구역_2,3328,1284,2044
2018,2,D,발달상권,1001182,홍익대학교 주변,16818,8154,8664
2018,2,D,발달상권,1001181,서울 광진구 군자역,227,131,96
2018,2,D,발달상권,1001180,신촌역,221,106,115
2018,2,D,발달상권,1001179,강서구청,3558,2312,1246
2018,2,D,발달상권,1001178,서울 마포구 홍대입구역_1,871,475,396
2018,2,D,발달상권,1001175,서울 강동구 고덕역,450,255,195
2018,2,D,발달상권,1001173,서울 강동구 명일역,869,359,510
2018,2,D,발달상권,1001172,어린이대공원역,88,47,41
2018,2,D,발달상권,1001171,서울 마포구 공덕역_2,4328,2508,1820
2018,2,D,발달상권,1001170,공덕역,7954,4594,3360
2018,2,D,발달상권,1001169,서울 용산구 숙대입구역,2707,1969,738
2018,2,D,발달상권,1001168,남영역,12311,5453,6858
2018,2,D,발달상권,1001167,서울 마포구 공덕역_1,4905,2395,2510
2018,2,D,발달상권,1001166,서울 마포구 마포역_2,1002,557,445
2018,2,D,발달상권,1001165,서울 광진구 건대입구역_2,2990,1023,1967
2018,2,D,발달상권,1001164,서울 마포구 마포역_1,13134,7794,5340
2018,2,D,발달상권,1001163,서울 강동구 천호역_2,4128,1923,2205
2018,2,D,발달상권,1001162,서울 광진구 건대입구역_1,916,434,482
2018,2,D,발달상권,1001161,건대입구역,735,394,341
2018,2,D,발달상권,1001160,서울 광진구 구의역,906,569,337
2018,2,D,발달상권,1001159,서울 강동구 천호역,997,451,546
2018,2,D,발달상권,1001158,당산역_2,4707,2881,1826
2018,2,D,발달상권,1001156,서울 강동구 길동역,1286,691,595
2018,2,D,발달상권,1001155,용산 전자상가_5,2575,1881,694
2018,2,D,발달상권,1001153,당산역_1,1148,704,444
2018,2,D,발달상권,1001152,서울 광진구 강변역,1799,1410,389
2018,2,D,발달상권,1001151,용산 전자상가_3,2469,1782,687
2018,2,D,발달상권,1001150,서울 용산구 이태원역,661,400,261
2018,2,D,발달상권,1001149,한남오거리,574,297,277
2018,2,D,발달상권,1001147,용산 전자상가_2,479,380,99
2018,2,D,발달상권,1001146,용산구청,33,15,18
2018,2,D,발달상권,1001145,용산 전자상가_1,13047,8246,4801
2018,2,D,발달상권,1001144,국회의사당역_2,38083,21992,16091
2018,2,D,발달상권,1001143,서울 용산구 신용산역,505,240,265
2018,2,D,발달상권,1001142,국회의사당역_1,5707,4396,1311
2018,2,D,발달상권,1001141,압구정 로데오거리_2,16443,6701,9742
2018,2,D,발달상권,1001140,서울 강남구 압구정역,10265,4575,5690
2018,2,D,발달상권,1001139,서울 영등포구 영등포구청역,3733,1138,2595
2018,2,D,발달상권,1001138,압구정 로데오거리_1,9087,2833,6254
2018,2,D,발달상권,1001137,서울 강동구 둔촌동역,71,24,47
2018,2,D,발달상권,1001136,오목교역,198,85,113
2018,2,D,발달상권,1001135,신사동 가로수길,22466,10481,11985
2018,2,D,발달상권,1001134,서울 영등포구 여의도역_2,49729,33012,16717
2018,2,D,발달상권,1001133,청담사거리_3,1143,414,729
2018,2,D,발달상권,1001132,영등포유통상가,2109,1252,857
2018,2,D,발달상권,1001131,청담역_2,1317,899,418
2018,2,D,발달상권,1001130,청담역_1,194,154,40
2018,2,D,발달상권,1001129,청담사거리_2,1189,873,316
2018,2,D,발달상권,1001127,서울 영등포구 여의도역_1,51327,30887,20440
2018,2,D,발달상권,1001125,학동사거리_2,2997,1699,1298
2018,2,D,발달상권,1001124,서울 영등포구 영등포시장역,334,253,81
2018,2,D,발달상권,1001123,학동사거리_1,4479,2220,2259
2018,2,D,발달상권,1001122,여의도 시범아파트앞,2395,1580,815
2018,2,D,발달상권,1001121,영등포역_3,906,535,371
2018,2,D,발달상권,1001120,도산공원사거리_1,10355,6090,4265
2018,2,D,발달상권,1001119,영등포역_2,1259,661,598
2018,2,D,발달상권,1001118,문래동 주민센터,74,59,15
2018,2,D,발달상권,1001117,강남구 신사역_2,7930,4769,3161
2018,2,D,발달상권,1001115,서울 강남구 강남구청역_2,4663,2890,1773
2018,2,D,발달상권,1001114,강남구 신사역_1,2430,1008,1422
2018,2,D,발달상권,1001113,서울 동작구 노량진1동_1,19,6,13
2018,2,D,발달상권,1001112,서울 강남구 학동역_3,9665,5539,4126
2018,2,D,발달상권,1001111,서울 강남구 강남구청역_1,3642,2126,1516
2018,2,D,발달상권,1001110,잠실역,5868,4338,1530
2018,2,D,발달상권,1001109,강남구 논현역_4,6478,3331,3147
2018,2,D,발달상권,1001108,학동역,1572,574,998
2018,2,D,발달상권,1001107,방이동 먹자골목,5157,3223,1934
2018,2,D,발달상권,1001106,서울 강남구 학동역_2,6033,3234,2799
2018,2,D,발달상권,1001105,서울 동작구 노량진역,3829,2175,1654
2018,2,D,발달상권,1001104,삼성역_3,10170,5919,4251
2018,2,D,발달상권,1001103,코엑스,22562,12970,9592
2018,2,D,발달상권,1001102,서울 강남구 학동역_1,5305,3348,1957
2018,2,D,발달상권,1001101,선정릉역_2,6911,4247,2664
2018,2,D,발달상권,1001100,강남구 논현역_3,1533,932,601
2018,2,D,발달상권,1001099,포스코사거리_2,7881,5022,2859
2018,2,D,발달상권,1001098,포스코사거리_1,43841,29255,14586
2018,2,D,발달상권,1001097,잠실역 롯데월드,3871,1933,1938
2018,2,D,발달상권,1001096,신도림역,3373,1768,1605
2018,2,D,발달상권,1001095,강남구 논현역_2,10089,4811,5278
2018,2,D,발달상권,1001094,선정릉역_1,1924,1381,543
2018,2,D,발달상권,1001093,신천역,5931,3190,2741
2018,2,D,발달상권,1001092,강남구 논현역_1,3585,2076,1509
2018,2,D,발달상권,1001091,삼성역_2,18975,11521,7454
2018,2,D,발달상권,1001090,삼정역_2,2478,1346,1132
2018,2,D,발달상권,1001089,삼정역_1,3329,1696,1633
2018,2,D,발달상권,1001088,삼성역_1,35413,22502,12911
2018,2,D,발달상권,1001087,서울 강남구 선릉역_2,7288,4707,2581
2018,2,D,발달상권,1001086,고속터미널역,16485,4781,11704
2018,2,D,발달상권,1001085,서울 서초구 강남역,33758,18836,14922
2018,2,D,발달상권,1001084,서울 강남구 선릉역_1,19964,8319,11645
2018,2,D,발달상권,1001082,선릉역_2,20789,10769,10020
2018,2,D,발달상권,1001081,서울 강남구 역삼역_2,27706,21651,6055
2018,2,D,발달상권,1001080,서울 송파구 석촌역_1,37,21,16
2018,2,D,발달상권,1001078,서울 강남구 강남역_2,5638,3260,2378
2018,2,D,발달상권,1001077,선릉역_1,55373,30034,25339
2018,2,D,발달상권,1001076,구로역,153,85,68
2018,2,D,발달상권,1001075,역삼역_2,4513,2557,1956
2018,2,D,발달상권,1001074,대림역_2,7571,5787,1784
2018,2,D,발달상권,1001073,서울 강남구 역삼역_1,24525,15502,9023
2018,2,D,발달상권,1001072,신대방삼거리역,241,109,132
2018,2,D,발달상권,1001071,서울 강남구 한티역,1139,451,688
2018,2,D,발달상권,1001070,은마아파트입구사거리_4,105,53,52
2018,2,D,발달상권,1001067,오류동역,1589,803,786
2018,2,D,발달상권,1001066,서울 강남구 강남역,41280,19424,21856
2018,2,D,발달상권,1001063,교대역_4,5151,2877,2274
2018,2,D,발달상권,1001062,서울 강남구 강남역_1,135689,99243,36446
2018,2,D,발달상권,1001061,방배동카페골목,108,41,67
2018,2,D,발달상권,1001060,가락시장,17284,10739,6545
2018,2,D,발달상권,1001059,교대역_3,4422,2687,1735
2018,2,D,발달상권,1001058,역삼역_1,1540,911,629
2018,2,D,발달상권,1001057,교대역_2,3363,2149,1214
2018,2,D,발달상권,1001056,서울 송파구 가락시장역,5029,3136,1893
2018,2,D,발달상권,1001055,서울 서초구 서초역,11841,4670,7171
2018,2,D,발달상권,1001054,서울 강남구 대치역_2,1508,910,598
2018,2,D,발달상권,1001052,뱅뱅사거리_2,29870,20424,9446
2018,2,D,발달상권,1001051,보라매공원,14421,8102,6319
2018,2,D,발달상권,1001050,교대역_1,13316,7616,5700
2018,2,D,발달상권,1001049,개봉동 현대아파트 인근,145,60,85
2018,2,D,발달상권,1001048,뱅뱅사거리,7961,5087,2874
2018,2,D,발달상권,1001047,뱅뱅사거리_1,11051,7880,3171
2018,2,D,발달상권,1001046,서울 관악구 신림역_4,1027,467,560
2018,2,D,발달상권,1001045,동작구 총신대입구역_1,262,123,139
2018,2,D,발달상권,1001044,양재역_3,3614,2354,1260
2018,2,D,발달상권,1001043,동작구 총신대입구역_2,752,321,431
2018,2,D,발달상권,1001042,서울 서초구 남부터미널역_3,1491,797,694
2018,2,D,발달상권,1001041,서울 강남구 수서역,16052,11440,4612
2018,2,D,발달상권,1001039,서울 서초구 남부터미널역_2,10724,5529,5195
2018,2,D,발달상권,1001038,구로디지탈1단지,66367,42004,24363
2018,2,D,발달상권,1001037,양재역,133,61,72
2018,2,D,발달상권,1001035,매봉역,612,229,383
2018,2,D,발달상권,1001034,서울 서초구 방배역,3380,1969,1411
2018,2,D,발달상권,1001033,서울 서초구 남부터미널역_1,540,396,144
2018,2,D,발달상권,1001032,서울 관악구 신림역_2,34,17,17
2018,2,D,발달상권,1001031,서울 관악구 신림역_1,1979,936,1043
2018,2,D,발달상권,1001030,양재역_2,11338,6172,5166
2018,2,D,발달상권,1001029,양재역_1,923,654,269
2018,2,D,발달상권,1001028,서울 관악구 서울대입구역_2,41,3,38
2018,2,D,발달상권,1001027,가산디지털단지역_3,45037,29362,15675
2018,2,D,발달상권,1001026,구로디지털단지역,2524,1636,888
2018,2,D,발달상권,1001025,서울 관악구 서울대입구역_1,1936,848,1088
2018,2,D,발달상권,1001024,관악구 사당역_1,3503,1459,2044
2018,2,D,발달상권,1001023,가산디지털단지역_2,59807,36563,23244
2018,2,D,발달상권,1001022,관악구 사당역_2,494,285,209
2018,2,D,발달상권,1001021,가산디지털단지역_1,28461,19196,9265
2018,2,D,발달상권,1001020,장지역,4695,2900,1795
2018,2,D,발달상권,1001019,포이사거리_1,5851,3303,2548
2018,2,D,발달상권,1001018,포이사거리_2,8599,5946,2653
2018,2,D,발달상권,1001016,서울 관악구 대학동_1,112,67,45
2018,2,D,발달상권,1001015,서울 금천구 독산1동_1,3020,1946,1074
2018,2,D,발달상권,1001013,양재 화물트럭터미널앞_2,148,70,78
2018,2,D,발달상권,1001012,양재 화물트럭터미널앞_1,4525,3730,795
2018,2,D,발달상권,1001011,서울 금천구 시흥1동_4,957,409,548
2018,2,A,골목상권,1001010,풍성로37가길,40,20,20
2018,2,A,골목상권,1001009,천호옛길,476,320,156
2018,2,A,골목상권,1001008,천호옛14길,703,384,319
2018,2,A,골목상권,1001007,천호대로219길,1366,617,749
2018,2,A,골목상권,1001006,천호대로197길,22,8,14
2018,2,A,골목상권,1001005,천호대로187길,890,509,381
2018,2,A,골목상권,1001004,천호대로170길,257,149,108
2018,2,A,골목상권,1001003,천호대로162길,1306,831,475
2018,2,A,골목상권,1001002,천중로51길,425,222,203
2018,2,A,골목상권,1001001,천중로39길,564,213,351
2018,2,A,골목상권,1001000,진황도로47길,1602,638,964
2018,2,A,골목상권,1000999,진황도로27길,579,300,279
2018,2,A,골목상권,1000998,올림픽로98길,41,17,24
2018,2,A,골목상권,1000995,올림픽로77길,21,11,10
2018,2,A,골목상권,1000994,올림픽로71길,353,258,95
2018,2,A,골목상권,1000993,올림픽로48길,6417,3785,2632
2018,2,A,골목상권,1000992,양재대로96길,1304,791,513
2018,2,A,골목상권,1000991,양재대로95길,604,312,292
2018,2,A,골목상권,1000990,양재대로91길,1119,618,501
2018,2,A,골목상권,1000989,양재대로133길,358,133,225
2018,2,A,골목상권,1000988,양재대로124길,581,330,251
2018,2,A,골목상권,1000987,양재대로116길,213,88,125
2018,2,A,골목상권,1000986,양재대로101길,1389,809,580
2018,2,A,골목상권,1000985,암사길,395,174,221
2018,2,A,골목상권,1000984,성안로3길,1338,764,574
2018,2,A,골목상권,1000983,성내로5길,1078,551,527
2018,2,A,골목상권,1000982,상일로5길,41,23,18
2018,2,A,골목상권,1000981,상암로5길,566,238,328
2018,2,A,골목상권,1000980,상암로51길,788,343,445
2018,2,A,골목상권,1000979,상암로4길,204,131,73
2018,2,A,골목상권,1000978,상암로14길,407,217,190
2018,2,A,골목상권,1000977,명일로13길,104,47,57
2018,2,A,골목상권,1000976,동남로85길,116,66,50
2018,2,A,골목상권,1000975,동남로82길,10,4,6
2018,2,A,골목상권,1000974,동남로65길,81,25,56
2018,2,A,골목상권,1000973,구천면로42길,347,193,154
2018,2,A,골목상권,1000972,구천면로41길,583,246,337
2018,2,A,골목상권,1000971,구천면로36길,40,23,17
2018,2,A,골목상권,1000969,고덕로25길,14,8,6
2018,2,A,골목상권,1000968,고덕로10길,181,84,97
2018,2,A,골목상권,1000967,강동대로53길,887,492,395
2018,2,A,골목상권,1000966,풍성로25길,787,283,504
2018,2,A,골목상권,1000965,오금로46길,1431,710,721
2018,2,A,골목상권,1000964,오금로36길,1297,935,362
2018,2,A,골목상권,1000963,오금로11길,2163,1389,774
2018,2,A,골목상권,1000962,양재대로72길,621,301,320
2018,2,A,골목상권,1000961,양재대로71길,1434,887,547
2018,2,A,골목상권,1000960,양재대로64길,1458,635,823
2018,2,A,골목상권,1000959,양재대로62길,7052,4459,2593
2018,2,A,골목상권,1000958,송파대로30길,1629,990,639
2018,2,A,골목상권,1000957,송이로36길,1947,1366,581
2018,2,A,골목상권,1000956,송이로32길,732,412,320
2018,2,A,골목상권,1000955,송이로23길,1442,912,530
2018,2,A,골목상권,1000954,삼전로13길,1633,731,902
2018,2,A,골목상권,1000953,백제고분로50길,1512,922,590
2018,2,A,골목상권,1000952,백제고분로46길,1619,955,664
2018,2,A,골목상권,1000951,백제고분로45길,504,326,178
2018,2,A,골목상권,1000950,백제고분로42길,124,79,45
2018,2,A,골목상권,1000949,백제고분로39길,1696,1248,448
2018,2,A,골목상권,1000948,백제고분로34길,1516,980,536
2018,2,A,골목상권,1000947,백제고분로33길,1104,708,396
2018,2,A,골목상권,1000946,백제고분로32길,1121,500,621
2018,2,A,골목상권,1000945,백제고분로31길,347,186,161
2018,2,A,골목상권,1000944,백제고분로22길,1205,721,484
2018,2,A,골목상권,1000943,백제고분로21길,205,136,69
2018,2,A,골목상권,1000942,마천로51길,157,67,90
2018,2,A,골목상권,1000941,동남로20길,155,82,73
2018,2,A,골목상권,1000940,거마로20길,527,228,299
2018,2,A,골목상권,1000939,학동로77길,2922,1463,1459
2018,2,A,골목상권,1000938,학동로6길,1698,886,812
2018,2,A,골목상권,1000937,학동로56길,893,439,454
2018,2,A,골목상권,1000936,학동로38길,6922,4029,2893
2018,2,A,골목상권,1000935,테헤란로81길,524,204,320
2018,2,A,골목상권,1000934,일원로9길,489,274,215
2018,2,A,골목상권,1000933,일원로3길,234,125,109
2018,2,A,골목상권,1000932,영동대로65길,3214,1853,1361
2018,2,A,골목상권,1000931,영동대로112길,628,391,237
2018,2,A,골목상권,1000930,언주로81길,9998,4857,5141
2018,2,A,골목상권,1000929,압구정로2길,2822,1499,1323
2018,2,A,골목상권,1000928,선릉로18길,348,204,144
2018,2,A,골목상권,1000927,선릉로146길,1923,986,937
2018,2,A,골목상권,1000926,선릉로133길,270,147,123
2018,2,A,골목상권,1000925,선릉로132길,1089,619,470
2018,2,A,골목상권,1000924,선릉로121길,1565,874,691
2018,2,A,골목상권,1000923,삼성로75길,2635,1450,1185
2018,2,A,골목상권,1000922,삼성로69길,357,181,176
2018,2,A,골목상권,1000921,삼성로64길,522,249,273
2018,2,A,골목상권,1000920,삼성로63길,245,96,149
2018,2,A,골목상권,1000919,삼성로57길,846,267,579
2018,2,A,골목상권,1000918,삼성로147길,874,357,517
2018,2,A,골목상권,1000917,삼성로115길,256,151,105
2018,2,A,골목상권,1000916,봉은사로68길,204,91,113
2018,2,A,골목상권,1000915,봉은사로57길,1141,708,433
2018,2,A,골목상권,1000914,봉은사로43길,1058,705,353
2018,2,A,골목상권,1000913,봉은사로29길,138,95,43
2018,2,A,골목상권,1000912,봉은사로109길,329,175,154
2018,2,A,골목상권,1000911,도산대로89길,2258,953,1305
2018,2,A,골목상권,1000910,도산대로81길,4192,1529,2663
2018,2,A,골목상권,1000909,도산대로50길,2731,1870,861
2018,2,A,골목상권,1000908,도산대로38길,163,91,72
2018,2,A,골목상권,1000907,도산대로30길,3304,1620,1684
2018,2,A,골목상권,1000906,도산대로23길,1448,886,562
2018,2,A,골목상권,1000905,도산대로15길,1632,760,872
2018,2,A,골목상권,1000904,도곡로37길,4197,2203,1994
2018,2,A,골목상권,1000903,논현로8길,783,440,343
2018,2,A,골목상권,1000902,논현로63길,3203,2261,942
2018,2,A,골목상권,1000901,논현로28길,10510,7244,3266
2018,2,A,골목상권,1000900,논현로26길,7670,5050,2620
2018,2,A,골목상권,1000898,논현로139길,2712,1278,1434
2018,2,A,골목상권,1000897,논현로123길,100,59,41
2018,2,A,골목상권,1000896,논현로115길,2806,1441,1365
2018,2,A,골목상권,1000895,논현로10길,2570,1650,920
2018,2,A,골목상권,1000894,논현로106길,2765,1572,1193
2018,2,A,골목상권,1000893,남부순환로365길,171,122,49
2018,2,A,골목상권,1000891,개포로28길,296,193,103
2018,2,A,골목상권,1000890,개포로20길,4215,2408,1807
2018,2,A,골목상권,1000889,개포로17길,2622,1698,924
2018,2,A,골목상권,1000888,강남대로140길,4005,2014,1991
2018,2,A,골목상권,1000887,강남대로136길,1294,759,535
2018,2,A,골목상권,1000886,강남대로118길,588,330,258
2018,2,A,골목상권,1000885,서초중앙로8길,7653,5747,1906
2018,2,A,골목상권,1000884,방배중앙로21길,1297,640,657
2018,2,A,골목상권,1000883,효령로72길,204,124,80
2018,2,A,골목상권,1000882,효령로34길,37,31,6
2018,2,A,골목상권,1000881,효령로31길,1329,705,624
2018,2,A,골목상권,1000880,효령로23길,732,433,299
2018,2,A,골목상권,1000879,청두곶길,2220,1352,868
2018,2,A,골목상권,1000878,주흥길,333,224,109
2018,2,A,골목상권,1000877,주흥15길,1480,947,533
2018,2,A,골목상권,1000876,언남길,1642,1109,533
2018,2,A,골목상권,1000875,신반포로45길,451,275,176
2018,2,A,골목상권,1000874,서초대로8길,248,125,123
2018,2,A,골목상권,1000873,서초대로64길,623,435,188
2018,2,A,골목상권,1000872,서초대로4길,652,473,179
2018,2,A,골목상권,1000871,서초대로25길,3904,2399,1505
2018,2,A,골목상권,1000870,서초대로23길,556,339,217
2018,2,A,골목상권,1000869,서초대로15길,1535,711,824
2018,2,A,골목상권,1000868,사평대로57길,177,66,111
2018,2,A,골목상권,1000867,사평대로26길,13,9,4
2018,2,A,골목상권,1000866,사평대로22길,1484,903,581
2018,2,A,골목상권,1000865,사임당로17길,1851,1124,727
2018,2,A,골목상권,1000864,방배로42길,126,58,68
2018,2,A,골목상권,1000863,방배로35길,2371,1505,866
2018,2,A,골목상권,1000862,방배로18길,77,45,32
2018,2,A,골목상권,1000861,반포대로9길,658,422,236
2018,2,A,골목상권,1000860,바우뫼로39길,2652,1560,1092
2018,2,A,골목상권,1000859,마방로2길,3850,2366,1484
2018,2,A,골목상권,1000858,방배천로4안길,1298,851,447
2018,2,A,골목상권,1000857,동산로19길,1298,847,451
2018,2,A,골목상권,1000856,동산로10길,2806,1517,1289
2018,2,A,골목상권,1000855,동광로39길,54,27,27
2018,2,A,골목상권,1000854,동광로1길,966,534,432
2018,2,A,골목상권,1000853,동광로12길,794,508,286
2018,2,A,골목상권,1000852,논현로27길,3588,2542,1046
2018,2,A,골목상권,1000851,논현로1길,550,355,195
2018,2,A,골목상권,1000850,남부순환로339길,13336,5891,7445
2018,2,A,골목상권,1000849,남부순환로325길,8261,3970,4291
2018,2,A,골목상권,1000848,남부순환로317길,1663,1135,528
2018,2,A,골목상권,1000847,고무래로8길,6501,3376,3125
2018,2,A,골목상권,1000846,강남대로8길,2603,1629,974
2018,2,A,골목상권,1000845,강남대로34길,1069,705,364
2018,2,A,골목상권,1000844,강남대로23길,7309,5154,2155
2018,2,A,골목상권,1000843,소담길,34,11,23
2018,2,A,골목상권,1000842,원신길,297,116,181
2018,2,A,골목상권,1000840,양산길,356,242,114
2018,2,A,골목상권,1000839,호암로24길,788,262,526
2018,2,A,골목상권,1000838,호암로20길,55,29,26
2018,2,A,골목상권,1000837,행운길,21,5,16
2018,2,A,골목상권,1000836,행운1길,105,71,34
2018,2,A,골목상권,1000835,청림3길,74,37,37
2018,2,A,골목상권,1000834,청룡길,89,48,41
2018,2,A,골목상권,1000833,청룡8길,10,5,5
2018,2,A,골목상권,1000832,중앙길,260,94,166
2018,2,A,골목상권,1000831,조원중앙로2길,1189,848,341
2018,2,A,골목상권,1000830,조원로18길,1045,551,494
2018,2,A,골목상권,1000829,조원로10길,275,121,154
2018,2,A,골목상권,1000828,장군봉2길,400,277,123
2018,2,A,골목상권,1000827,장군봉1길,83,16,67
2018,2,A,골목상권,1000826,인헌길,82,52,30
2018,2,A,골목상권,1000825,은천로25길,284,92,192
2018,2,A,골목상권,1000824,양녕로6길,822,465,357
2018,2,A,골목상권,1000823,신원로3길,25,14,11
2018,2,A,골목상권,1000822,신사로20길,44,14,30
2018,2,A,골목상권,1000820,신림로64길,242,118,124
2018,2,A,골목상권,1000819,신림로48길,69,33,36
2018,2,A,골목상권,1000818,신림로38길,60,33,27
2018,2,A,골목상권,1000817,신림로28길,328,227,101
2018,2,A,골목상권,1000816,신림로11길,470,420,50
2018,2,A,골목상권,1000815,신림동길,354,198,156
2018,2,A,골목상권,1000814,승방길,571,365,206
2018,2,A,골목상권,1000813,서림7길,289,116,173
2018,2,A,골목상권,1000812,봉천로33길,308,199,109
2018,2,A,골목상권,1000811,봉천로13길,318,88,230
2018,2,A,골목상권,1000810,복은길,155,55,100
2018,2,A,골목상권,1000809,법원단지길,2,2,0
2018,2,A,골목상권,1000808,법원단지9길,87,39,48
2018,2,A,골목상권,1000807,미성5길,77,44,33
2018,2,A,골목상권,1000806,대학길,75,39,36
2018,2,A,골목상권,1000805,대학14길,13,4,9
2018,2,A,골목상권,1000804,당곡길,386,205,181
2018,2,A,골목상권,1000803,남현길,224,76,148
2018,2,A,골목상권,1000802,남현3길,270,140,130
2018,2,A,골목상권,1000800,남부순환로248길,251,112,139
2018,2,A,골목상권,1000799,남부순환로234길,173,116,57
2018,2,A,골목상권,1000798,남부순환로172길,1264,685,579
2018,2,A,골목상권,1000797,남부순환로161길,31,12,19
2018,2,A,골목상권,1000796,남부순환로151길,200,144,56
2018,2,A,골목상권,1000795,남부순환로142길,93,49,44
2018,2,A,골목상권,1000794,난향길,177,42,135
2018,2,A,골목상권,1000793,난우길,426,159,267
2018,2,A,골목상권,1000792,난곡로74길,117,53,64
2018,2,A,골목상권,1000791,난곡로34길,25,7,18
2018,2,A,골목상권,1000790,난곡로26길,141,50,91
2018,2,A,골목상권,1000789,난곡로24길,26,16,10
2018,2,A,골목상권,1000788,낙성대역길,698,446,252
2018,2,A,골목상권,1000787,국회단지길,572,272,300
2018,2,A,골목상권,1000786,구암길,88,34,54
2018,2,A,골목상권,1000785,관천로22길,19,6,13
2018,2,A,골목상권,1000784,관천로15길,150,82,68
2018,2,A,골목상권,1000783,관악로30길,187,62,125
2018,2,A,골목상권,1000782,관악로28길,151,71,80
2018,2,A,골목상권,1000781,관악로14길,464,257,207
2018,2,A,골목상권,1000780,관악로10길,223,156,67
2018,2,A,골목상권,1000779,흑석로9길,171,71,100
2018,2,A,골목상권,1000778,흑석로13길,149,11,138
2018,2,A,골목상권,1000777,장승배기로27길,46,21,25
2018,2,A,골목상권,1000776,장승배기로19길,8,4,4
2018,2,A,골목상권,1000774,여의대방로46길,465,161,304
2018,2,A,골목상권,1000773,여의대방로24길,18249,9804,8445
2018,2,A,골목상권,1000772,여의대방로22카길,306,125,181
2018,2,A,골목상권,1000771,여의대방로22나길,129,52,77
2018,2,A,골목상권,1000770,여의대방로22길,248,147,101
2018,2,A,골목상권,1000769,양녕로26길,135,67,68
2018,2,A,골목상권,1000768,신대방길,99,63,36
2018,2,A,골목상권,1000767,성대로29길,3,2,1
2018,2,A,골목상권,1000766,성대로1길,343,143,200
2018,2,A,골목상권,1000765,서달로8가길,247,99,148
2018,2,A,골목상권,1000763,서달로14길,42,18,24
2018,2,A,골목상권,1000762,서달로10길,66,32,34
2018,2,A,골목상권,1000761,상도로62길,185,56,129
2018,2,A,골목상권,1000760,상도로61길,46,21,25
2018,2,A,골목상권,1000759,상도로47길,46,33,13
2018,2,A,골목상권,1000758,상도로37길,1920,932,988
2018,2,A,골목상권,1000757,상도로15길,359,155,204
2018,2,A,골목상권,1000756,사당로8길,121,66,55
2018,2,A,골목상권,1000755,사당로30길,298,204,94
2018,2,A,골목상권,1000754,사당로2차길,113,76,37
2018,2,A,골목상권,1000753,사당로29길,26,22,4
2018,2,A,골목상권,1000752,사당로26길,260,148,112
2018,2,A,골목상권,1000751,사당로23나길,141,45,96
2018,2,A,골목상권,1000750,사당로23길,16,12,4
2018,2,A,골목상권,1000749,사당로20길,194,146,48
2018,2,A,골목상권,1000748,사당로16길,135,40,95
2018,2,A,골목상권,1000747,사당로16가길,772,471,301
2018,2,A,골목상권,1000746,만양로8길,95,46,49
2018,2,A,골목상권,1000745,만양로14길,347,154,193
2018,2,A,골목상권,1000744,등용로14길,670,456,214
2018,2,A,골목상권,1000743,동작대로7길,1829,746,1083
2018,2,A,골목상권,1000742,동작대로35길,945,116,829
2018,2,A,골목상권,1000741,동작대로33길,106,56,50
2018,2,A,골목상권,1000740,동작대로29길,38,21,17
2018,2,A,골목상권,1000739,동작대로17길,1402,710,692
2018,2,A,골목상권,1000738,대방동2길,462,215,247
2018,2,A,골목상권,1000737,대방동27길,125,78,47
2018,2,A,골목상권,1000736,노량진로6길,100,28,72
2018,2,A,골목상권,1000735,국사봉길,48,9,39
2018,2,A,골목상권,1000734,국사봉2길,50,18,32
2018,2,A,골목상권,1000733,국사봉1길,9,3,6
2018,2,A,골목상권,1000732,영신로9길,344,178,166
2018,2,A,골목상권,1000731,영등포로84길,378,96,282
2018,2,A,골목상권,1000730,영등포로80길,55,30,25
2018,2,A,골목상권,1000729,영등포로62길,7,4,3
2018,2,A,골목상권,1000728,영등포로35길,89,54,35
2018,2,A,골목상권,1000727,영등포로27길,301,171,130
2018,2,A,골목상권,1000724,여의대방로43나길,957,683,274
2018,2,A,골목상권,1000723,여의대방로39길,7,3,4
2018,2,A,골목상권,1000722,여의대방로35길,876,459,417
2018,2,A,골목상권,1000721,양평로28길,624,496,128
2018,2,A,골목상권,1000720,양평로22라길,29,15,14
2018,2,A,골목상권,1000719,양평로19길,4563,3515,1048
2018,2,A,골목상권,1000718,신길로60길,497,187,310
2018,2,A,골목상권,1000717,신길로42길,376,182,194
2018,2,A,골목상권,1000716,신길로42가길,99,33,66
2018,2,A,골목상권,1000715,신길로39길,129,52,77
2018,2,A,골목상권,1000714,신길로17길,52,35,17
2018,2,A,골목상권,1000713,선유서로28길,389,214,175
2018,2,A,골목상권,1000712,선유서로25길,2563,1872,691
2018,2,A,골목상권,1000711,선유서로24길,365,209,156
2018,2,A,골목상권,1000710,선유로55길,2479,1517,962
2018,2,A,골목상권,1000709,디지털로74길,46,30,16
2018,2,A,골목상권,1000708,디지털로57길,10,4,6
2018,2,A,골목상권,1000707,디지털로37길,215,99,116
2018,2,A,골목상권,1000706,도신로62길,189,58,131
2018,2,A,골목상권,1000705,도신로60길,64,12,52
2018,2,A,골목상권,1000704,도신로29길,81,35,46
2018,2,A,골목상권,1000703,도신로15길,85,43,42
2018,2,A,골목상권,1000702,도림천로21길,88,36,52
2018,2,A,골목상권,1000701,도림로63길,30,21,9
2018,2,A,골목상권,1000700,도림로147길,1783,1289,494
2018,2,A,골목상권,1000699,도림로112길,27,16,11
2018,2,A,골목상권,1000698,대림로8길,1910,568,1342
2018,2,A,골목상권,1000697,대림로7길,10,6,4
2018,2,A,골목상권,1000696,대림로44길,29,16,13
2018,2,A,골목상권,1000695,대림로34길,192,81,111
2018,2,A,골목상권,1000694,대림로31길,1055,545,510
2018,2,A,골목상권,1000693,대림로29길,1809,920,889
2018,2,A,골목상권,1000692,대림로22길,377,215,162
2018,2,A,골목상권,1000691,당산로46길,4383,2745,1638
2018,2,A,골목상권,1000690,당산로38길,164,113,51
2018,2,A,골목상권,1000689,당산로37길,4244,2743,1501
2018,2,A,골목상권,1000688,당산로31길,4394,2379,2015
2018,2,A,골목상권,1000687,국회대로56길,1741,1124,617
2018,2,A,골목상권,1000686,경인로90길,314,177,137
2018,2,A,골목상권,1000685,경인로80길,1576,1129,447
2018,2,A,골목상권,1000684,경인로77길,709,447,262
2018,2,A,골목상권,1000683,가마산로61길,204,70,134
2018,2,A,골목상권,1000682,시흥대로94길,689,350,339
2018,2,A,골목상권,1000681,시흥대로84길,185,85,100
2018,2,A,골목상권,1000680,시흥대로68길,960,251,709
2018,2,A,골목상권,1000679,시흥대로63길,2949,1450,1499
2018,2,A,골목상권,1000678,시흥대로62가길,443,108,335
2018,2,A,골목상권,1000677,시흥대로36길,409,232,177
2018,2,A,골목상권,1000676,시흥대로22길,511,362,149
2018,2,A,골목상권,1000675,시흥대로153길,640,368,272
2018,2,A,골목상권,1000674,시흥대로150길,537,248,289
2018,2,A,골목상권,1000673,시흥대로141길,653,381,272
2018,2,A,골목상권,1000672,시흥대로138길,18,9,9
2018,2,A,골목상권,1000671,시흥대로120길,470,311,159
2018,2,A,골목상권,1000670,벚꽃로56길,1863,1268,595
2018,2,A,골목상권,1000669,범안로17길,136,82,54
2018,2,A,골목상권,1000668,범안로11길,1073,839,234
2018,2,A,골목상권,1000667,문성로5길,166,58,108
2018,2,A,골목상권,1000666,독산로85길,99,25,74
2018,2,A,골목상권,1000665,독산로78다길,223,97,126
2018,2,A,골목상권,1000664,독산로70길,2,2,0
2018,2,A,골목상권,1000663,독산로64길,115,31,84
2018,2,A,골목상권,1000662,독산로50길,91,34,57
2018,2,A,골목상권,1000661,독산로40길,54,16,38
2018,2,A,골목상권,1000660,독산로108길,731,343,388
2018,2,A,골목상권,1000659,남부순환로112길,14,6,8
2018,2,A,골목상권,1000658,금하로24길,206,70,136
2018,2,A,골목상권,1000657,금하로1길,73,33,40
2018,2,A,골목상권,1000656,금하로14길,26,11,15
2018,2,A,골목상권,1000655,가산로5길,583,456,127
2018,2,A,골목상권,1000654,가산로3길,2320,1764,556
2018,2,A,골목상권,1000653,중앙로1길,1572,1085,487
2018,2,A,골목상권,1000652,중앙로15길,96,50,46
2018,2,A,골목상권,1000651,우마길,41,21,20
2018,2,A,골목상권,1000650,오류로8길,224,105,119
2018,2,A,골목상권,1000649,신도림로13길,828,601,227
2018,2,A,골목상권,1000648,새말로18길,443,295,148
2018,2,A,골목상권,1000647,부일로1길,779,627,152
2018,2,A,골목상권,1000646,부일로15길,181,153,28
2018,2,A,골목상권,1000645,부일로11길,25,6,19
2018,2,A,골목상권,1000644,디지털로32길,1053,556,497
2018,2,A,골목상권,1000643,디지털로32가길,7192,4949,2243
2018,2,A,골목상권,1000642,디지털로27길,389,250,139
2018,2,A,골목상권,1000641,도림로6길,131,59,72
2018,2,A,골목상권,1000640,도림로12길,108,43,65
2018,2,A,골목상권,1000639,남부순환로97길,285,90,195
2018,2,A,골목상권,1000638,구로중앙로8길,199,73,126
2018,2,A,골목상권,1000637,구로중앙로7길,197,73,124
2018,2,A,골목상권,1000636,구로중앙로42길,803,593,210
2018,2,A,골목상권,1000635,구로중앙로34길,602,335,267
2018,2,A,골목상권,1000634,구로중앙로28길,3213,1572,1641
2018,2,A,골목상권,1000633,구로중앙로19길,10,7,3
2018,2,A,골목상권,1000632,구로동로8길,152,43,109
2018,2,A,골목상권,1000631,구로동로7길,171,67,104
2018,2,A,골목상권,1000630,구로동로42길,26,17,9
2018,2,A,골목상권,1000629,구로동로41길,433,292,141
2018,2,A,골목상권,1000628,구로동로38길,36,14,22
2018,2,A,골목상권,1000627,구로동로28길,169,68,101
2018,2,A,골목상권,1000626,구로동로15길,31,9,22
2018,2,A,골목상권,1000625,공원로6가길,288,197,91
2018,2,A,골목상권,1000624,고척로52길,218,69,149
2018,2,A,골목상권,1000623,고척로27다길,206,81,125
2018,2,A,골목상권,1000622,고척로27길,243,113,130
2018,2,A,골목상권,1000621,고척로21나길,217,63,154
2018,2,A,골목상권,1000620,경인로47길,919,504,415
2018,2,A,골목상권,1000619,경인로35길,289,112,177
2018,2,A,골목상권,1000618,경인로31길,58,22,36
2018,2,A,골목상권,1000617,경인로15길,143,61,82
2018,2,A,골목상권,1000616,개봉로3길,225,141,84
2018,2,A,골목상권,1000615,개봉로2길,480,129,351
2018,2,A,골목상권,1000614,개봉로23가길,868,501,367
2018,2,A,골목상권,1000613,개봉로20길,119,68,51
2018,2,A,골목상권,1000612,개봉로1길,52,27,25
2018,2,A,골목상권,1000611,개봉로17다길,194,94,100
2018,2,A,골목상권,1000610,개봉로17길,862,353,509
2018,2,A,골목상권,1000609,개봉로11길,61,11,50
2018,2,A,골목상권,1000608,화곡로64길,1601,953,648
2018,2,A,골목상권,1000607,화곡로59길,480,200,280
2018,2,A,골목상권,1000606,화곡로44나길,757,621,136
2018,2,A,골목상권,1000605,화곡로31길,1208,453,755
2018,2,A,골목상권,1000604,화곡로20길,535,333,202
2018,2,A,골목상권,1000603,화곡로13길,258,97,161
2018,2,A,골목상권,1000602,초원로16길,761,297,464
2018,2,A,골목상권,1000601,초록마을로8길,184,35,149
2018,2,A,골목상권,1000600,초록마을로3길,42,21,21
2018,2,A,골목상권,1000599,월정로20길,4,2,2
2018,2,A,골목상권,1000598,우장산로6길,311,172,139
2018,2,A,골목상권,1000597,양천로73가길,1260,809,451
2018,2,A,골목상권,1000596,양천로71길,216,121,95
2018,2,A,골목상권,1000595,양천로49길,760,595,165
2018,2,A,골목상권,1000594,양천로26길,174,81,93
2018,2,A,골목상권,1000593,양천로24길,385,157,228
2018,2,A,골목상권,1000592,양천로24가길,766,372,394
2018,2,A,골목상권,1000591,양천로14길,241,161,80
2018,2,A,골목상권,1000590,방화대로6라길,806,491,315
2018,2,A,골목상권,1000589,방화대로21길,854,483,371
2018,2,A,골목상권,1000588,등촌로5길,13,5,8
2018,2,A,골목상권,1000587,등촌로55길,540,360,180
2018,2,A,골목상권,1000586,등촌로51길,17,11,6
2018,2,A,골목상권,1000585,등촌로39길,70,27,43
2018,2,A,골목상권,1000584,등촌로13길,188,96,92
2018,2,A,골목상권,1000583,남부순환로11길,378,258,120
2018,2,A,골목상권,1000582,까치산로4길,152,57,95
2018,2,A,골목상권,1000581,국회대로7길,412,237,175
2018,2,A,골목상권,1000580,공항대로8길,226,90,136
2018,2,A,골목상권,1000579,공항대로61길,185,129,56
2018,2,A,골목상권,1000578,공항대로59다길,885,632,253
2018,2,A,골목상권,1000577,공항대로59길,1087,695,392
2018,2,A,골목상권,1000576,공항대로55길,1095,702,393
2018,2,A,골목상권,1000575,공항대로42길,9,5,4
2018,2,A,골목상권,1000574,공항대로38길,273,138,135
2018,2,A,골목상권,1000573,곰달래로60길,587,312,275
2018,2,A,골목상권,1000572,곰달래로53길,53,18,35
2018,2,A,골목상권,1000571,곰달래로47길,38,17,21
2018,2,A,골목상권,1000570,곰달래로31길,11,7,4
2018,2,A,골목상권,1000569,곰달래로25길,796,295,501
2018,2,A,골목상권,1000568,개화동로25길,658,442,216
2018,2,A,골목상권,1000567,개화동로23길,115,75,40
2018,2,A,골목상권,1000566,강서로8길,159,85,74
2018,2,A,골목상권,1000565,강서로5라길,314,185,129
2018,2,A,골목상권,1000564,강서로5나길,95,50,45
2018,2,A,골목상권,1000563,강서로5가길,51,26,25
2018,2,A,골목상권,1000562,강서로47라길,122,60,62
2018,2,A,골목상권,1000561,강서로47길,370,192,178
2018,2,A,골목상권,1000560,강서로45다길,554,351,203
2018,2,A,골목상권,1000559,강서로45길,153,66,87
2018,2,A,골목상권,1000558,강서로35길,164,94,70
2018,2,A,골목상권,1000557,강서로29길,410,183,227
2018,2,A,골목상권,1000556,강서로18길,30,12,18
2018,2,A,골목상권,1000555,강서로17가길,132,57,75
2018,2,A,골목상권,1000554,강서로15길,305,155,150
2018,2,A,골목상권,1000553,가로공원로80길,60,28,32
2018,2,A,골목상권,1000552,가로공원로76가길,28,11,17
2018,2,A,골목상권,1000551,화곡로4길,212,81,131
2018,2,A,골목상권,1000550,화곡로3길,160,51,109
2018,2,A,골목상권,1000549,지양로7길,234,79,155
2018,2,A,골목상권,1000548,중앙로55길,349,179,170
2018,2,A,골목상권,1000547,중앙로51길,128,73,55
2018,2,A,골목상권,1000546,중앙로47길,118,26,92
2018,2,A,골목상권,1000545,중앙로45길,166,59,107
2018,2,A,골목상권,1000544,중앙로36길,2,2,0
2018,2,A,골목상권,1000543,중앙로32길,594,302,292
2018,2,A,골목상권,1000542,중앙로25길,244,70,174
2018,2,A,골목상권,1000541,은행정로7길,521,175,346
2018,2,A,골목상권,1000539,오목로5길,334,183,151
2018,2,A,골목상권,1000538,오목로3길,430,400,30
2018,2,A,골목상권,1000537,오목로30길,145,73,72
2018,2,A,골목상권,1000536,오목로23길,820,483,337
2018,2,A,골목상권,1000535,신월로20길,212,81,131
2018,2,A,골목상권,1000534,신월로15길,771,364,407
2018,2,A,골목상권,1000533,신목로6길,252,140,112
2018,2,A,골목상권,1000532,신목로5길,925,354,571
2018,2,A,골목상권,1000531,신목로2길,94,47,47
2018,2,A,골목상권,1000530,목동중앙서로8가길,178,110,68
2018,2,A,골목상권,1000529,목동중앙서로7길,264,86,178
2018,2,A,골목상권,1000528,목동중앙북로8길,355,110,245
2018,2,A,골목상권,1000527,목동중앙북로16길,257,80,177
2018,2,A,골목상권,1000526,목동중앙본로7길,117,51,66
2018,2,A,골목상권,1000525,목동중앙로3길,111,60,51
2018,2,A,골목상권,1000524,목동중앙로13나길,293,208,85
2018,2,A,골목상권,1000523,목동중앙남로3가길,546,364,182
2018,2,A,골목상권,1000522,목동로9길,2360,1508,852
2018,2,A,골목상권,1000521,목동로19길,1014,363,651
2018,2,A,골목상권,1000519,목동동로12길,385,140,245
2018,2,A,골목상권,1000518,목동남로4길,13,6,7
2018,2,A,골목상권,1000517,남부순환로88길,272,128,144
2018,2,A,골목상권,1000516,남부순환로79길,339,249,90
2018,2,A,골목상권,1000515,남부순환로70길,519,317,202
2018,2,A,골목상권,1000514,남부순환로58길,198,117,81
2018,2,A,골목상권,1000513,남부순환로40길,18,5,13
2018,2,A,골목상권,1000512,남부순환로33길,1247,1018,229
2018,2,A,골목상권,1000511,곰달래로5길,76,46,30
2018,2,A,골목상권,1000510,곰달래로3길,403,213,190
2018,2,A,골목상권,1000509,곰달래로2길,297,157,140
2018,2,A,골목상권,1000508,곰달래로10길,339,235,104
2018,2,A,골목상권,1000507,가로공원로58길,76,15,61
2018,2,A,골목상권,1000506,효창원로93길,86,44,42
2018,2,A,골목상권,1000505,토정로37길,118,54,64
2018,2,A,골목상권,1000504,월드컵로8길,1704,905,799
2018,2,A,골목상권,1000503,월드컵로7길,4,2,2
2018,2,A,골목상권,1000502,월드컵로36길,151,68,83
2018,2,A,골목상권,1000501,월드컵로25길,285,165,120
2018,2,A,골목상권,1000500,월드컵로19길,544,276,268
2018,2,A,골목상권,1000499,월드컵로16길,3917,2018,1899
2018,2,A,골목상권,1000498,월드컵로11길,253,91,162
2018,2,A,골목상권,1000497,월드컵로10길,1552,812,740
2018,2,A,골목상권,1000496,와우산로3길,180,101,79
2018,2,A,골목상권,1000495,와우산로29길,171,87,84
2018,2,A,골목상권,1000494,와우산로29가길,28,16,12
2018,2,A,골목상권,1000493,양화진길,439,309,130
2018,2,A,골목상권,1000492,양화로1길,4169,1985,2184
2018,2,A,골목상권,1000491,양화로11길,395,269,126
2018,2,A,골목상권,1000490,신촌로30길,26,16,10
2018,2,A,골목상권,1000489,신촌로28가길,105,40,65
2018,2,A,골목상권,1000488,신촌로12길,1598,696,902
2018,2,A,골목상권,1000487,숭문길,5291,4015,1276
2018,2,A,골목상권,1000486,숭문8길,110,63,47
2018,2,A,골목상권,1000485,성지3길,479,242,237
2018,2,A,골목상권,1000484,성산로4길,1732,1032,700
2018,2,A,골목상권,1000483,성미산로32길,522,259,263
2018,2,A,골목상권,1000482,성미산로1길,635,489,146
2018,2,A,골목상권,1000481,성미산로11길,1103,767,336
2018,2,A,골목상권,1000480,백범로16길,709,363,346
2018,2,A,골목상권,1000479,방울내로9안길,354,215,139
2018,2,A,골목상권,1000478,모래내로7길,253,117,136
2018,2,A,골목상권,1000477,매봉산로2길,4355,2792,1563
2018,2,A,골목상권,1000476,망원로2길,200,123,77
2018,2,A,골목상권,1000475,망원로11길,1076,531,545
2018,2,A,골목상권,1000474,만리재옛길,1471,632,839
2018,2,A,골목상권,1000473,마포대로4길,181,100,81
2018,2,A,골목상권,1000472,마포대로20길,1015,551,464
2018,2,A,골목상권,1000471,마포대로12길,68,36,32
2018,2,A,골목상권,1000470,동교로38길,193,121,72
2018,2,A,골목상권,1000469,동교로27길,3631,1645,1986
2018,2,A,골목상권,1000468,동교로25길,562,284,278
2018,2,A,골목상권,1000467,동교로19길,4045,2692,1353
2018,2,A,골목상권,1000466,동교로17길,690,359,331
2018,2,A,골목상권,1000465,독막로8길,359,163,196
2018,2,A,골목상권,1000464,독막로32길,494,208,286
2018,2,A,골목상권,1000463,독막로22길,97,51,46
2018,2,A,골목상권,1000462,도화길,992,476,516
2018,2,A,골목상권,1000461,도화4길,405,132,273
2018,2,A,골목상권,1000460,대흥로28길,49,42,7
2018,2,A,골목상권,1000459,대흥로21길,438,83,355
2018,2,A,골목상권,1000458,광성로6길,179,112,67
2018,2,A,골목상권,1000457,홍제내길,103,58,45
2018,2,A,골목상권,1000456,홍연길,82,45,37
2018,2,A,골목상권,1000455,통일로39길,5,5,0
2018,2,A,골목상권,1000454,통일로37길,355,135,220
2018,2,A,골목상권,1000453,통일로11길,9,7,2
2018,2,A,골목상권,1000452,충정로6길,13115,8020,5095
2018,2,A,골목상권,1000451,충정로4길,3082,2015,1067
2018,2,A,골목상권,1000450,증가로6길,209,105,104
2018,2,A,골목상권,1000449,증가로23나길,477,253,224
2018,2,A,골목상권,1000448,증가로20가길,258,94,164
2018,2,A,골목상권,1000447,증가로10길,165,83,82
2018,2,A,골목상권,1000446,응암로1길,389,279,110
2018,2,A,골목상권,1000445,연희로10길,162,109,53
2018,2,A,골목상권,1000444,신촌로37길,104,50,54
2018,2,A,골목상권,1000443,수색로8길,2241,2135,106
2018,2,A,골목상권,1000442,세무서길,336,109,227
2018,2,A,골목상권,1000440,세검정로1길,276,100,176
2018,2,A,골목상권,1000439,북아현로4길,432,91,341
2018,2,A,골목상권,1000438,모래내로15길,126,40,86
2018,2,A,골목상권,1000437,명지대길,401,292,109
2018,2,A,골목상권,1000436,독립문로8길,781,307,474
2018,2,A,골목상권,1000435,가재울로6길,26,18,8
2018,2,A,골목상권,1000434,통일로92길,93,42,51
2018,2,A,골목상권,1000433,통일로87길,224,100,124
2018,2,A,골목상권,1000432,통일로78길,212,59,153
2018,2,A,골목상권,1000430,진흥로1길,556,172,384
2018,2,A,골목상권,1000429,진흥로12길,509,214,295
2018,2,A,골목상권,1000428,증산서길,401,277,124
2018,2,A,골목상권,1000427,증산로9길,84,27,57
2018,2,A,골목상권,1000426,증산로5길,747,388,359
2018,2,A,골목상권,1000425,증산로21길,236,140,96
2018,2,A,골목상권,1000424,증산로17길,683,298,385
2018,2,A,골목상권,1000423,증산로15길,230,87,143
2018,2,A,골목상권,1000422,증산로13길,71,36,35
2018,2,A,골목상권,1000421,응암로34길,60,38,22
2018,2,A,골목상권,1000420,응암로22길,187,67,120
2018,2,A,골목상권,1000419,응암로14길,456,169,287
2018,2,A,골목상권,1000418,응암로13길,301,129,172
2018,2,A,골목상권,1000417,응암로12길,198,115,83
2018,2,A,골목상권,1000416,은평로8길,247,115,132
2018,2,A,골목상권,1000415,은평로3길,301,104,197
2018,2,A,골목상권,1000414,은평로20길,6,2,4
2018,2,A,골목상권,1000413,은평로13길,364,220,144
2018,2,A,골목상권,1000412,은평로10길,287,144,143
2018,2,A,골목상권,1000411,연서로5길,41,15,26
2018,2,A,골목상권,1000410,연서로41길,242,75,167
2018,2,A,골목상권,1000409,연서로3길,113,46,67
2018,2,A,골목상권,1000408,연서로34길,150,57,93
2018,2,A,골목상권,1000407,연서로33길,33,13,20
2018,2,A,골목상권,1000406,연서로29길,300,93,207
2018,2,A,골목상권,1000405,연서로28길,732,356,376
2018,2,A,골목상권,1000404,연서로27길,82,23,59
2018,2,A,골목상권,1000403,연서로21길,290,156,134
2018,2,A,골목상권,1000402,연서로17길,1155,339,816
2018,2,A,골목상권,1000401,연서로16길,263,103,160
2018,2,A,골목상권,1000400,연서로13길,693,206,487
2018,2,A,골목상권,1000399,연서로11길,239,111,128
2018,2,A,골목상권,1000398,역말로9길,20,14,6
2018,2,A,골목상권,1000397,수색로18길,37,22,15
2018,2,A,골목상권,1000396,서오릉로8길,14,2,12
2018,2,A,골목상권,1000395,서오릉로21길,411,99,312
2018,2,A,골목상권,1000394,불광천길,200,99,101
2018,2,A,골목상권,1000393,갈현로7길,913,265,648
2018,2,A,골목상권,1000392,갈현로41길,123,50,73
2018,2,A,골목상권,1000391,갈현로33길,37,8,29
2018,2,A,골목상권,1000390,갈현로1길,203,88,115
2018,2,A,골목상권,1000389,가좌로7길,57,25,32
2018,2,A,골목상권,1000388,한글비석로44길,397,211,186
2018,2,A,골목상권,1000387,한글비석로24길,409,160,249
2018,2,A,골목상권,1000386,한글비석로22길,782,353,429
2018,2,A,골목상권,1000385,석계로1길,110,58,52
2018,2,A,골목상권,1000384,상계로9가길,305,104,201
2018,2,A,골목상권,1000382,상계로12길,19,12,7
2018,2,A,골목상권,1000381,동일로242길,244,161,83
2018,2,A,골목상권,1000380,동일로192길,458,202,256
2018,2,A,골목상권,1000379,동일로173가길,2867,1654,1213
2018,2,A,골목상권,1000378,공릉로58길,148,51,97
2018,2,A,골목상권,1000377,해등로16길,75,59,16
2018,2,A,골목상권,1000376,우이천로4다길,191,115,76
2018,2,A,골목상권,1000375,우이천로32길,91,56,35
2018,2,A,골목상권,1000374,시루봉로23길,49,22,27
2018,2,A,골목상권,1000373,삼양로144길,73,55,18
2018,2,A,골목상권,1000372,방학로6가길,202,109,93
2018,2,A,골목상권,1000371,방학로5길,137,70,67
2018,2,A,골목상권,1000370,방학로15길,304,193,111
2018,2,A,골목상권,1000369,방학로10길,215,104,111
2018,2,A,골목상권,1000367,도봉산4길,320,277,43
2018,2,A,골목상권,1000366,도봉로181길,185,82,103
2018,2,A,골목상권,1000365,도봉로169나길,272,104,168
2018,2,A,골목상권,1000364,도봉로156길,282,144,138
2018,2,A,골목상권,1000363,도봉로152가길,423,345,78
2018,2,A,골목상권,1000362,도봉로147길,557,320,237
2018,2,A,골목상권,1000360,도봉로114길,567,199,368
2018,2,A,골목상권,1000359,도봉로109길,30,9,21
2018,2,A,골목상권,1000358,도당로29길,870,509,361
2018,2,A,골목상권,1000357,도당로19길,190,99,91
2018,2,A,골목상권,1000356,도당로13바길,205,77,128
2018,2,A,골목상권,1000355,도당로13가길,155,66,89
2018,2,A,골목상권,1000354,덕릉로60길,90,54,36
2018,2,A,골목상권,1000353,노해로63다길,649,261,388
2018,2,A,골목상권,1000352,노해로60길,325,140,185
2018,2,A,골목상권,1000351,한천로140길,111,51,60
2018,2,A,골목상권,1000350,한천로139가길,50,29,21
2018,2,A,골목상권,1000349,한천로132길,332,132,200
2018,2,A,골목상권,1000348,한천로130길,279,120,159
2018,2,A,골목상권,1000347,한천로124나길,111,65,46
2018,2,A,골목상권,1000346,한천로109길,608,267,341
2018,2,A,골목상권,1000345,인수봉로79길,158,41,117
2018,2,A,골목상권,1000344,인수봉로72길,82,37,45
2018,2,A,골목상권,1000342,오패산로67길,583,286,297
2018,2,A,골목상권,1000341,오패산로52길,102,36,66
2018,2,A,골목상권,1000340,오패산로30길,10,6,4
2018,2,A,골목상권,1000339,수유로12길,236,153,83
2018,2,A,골목상권,1000338,솔샘로65길,472,202,270
2018,2,A,골목상권,1000337,솔매로50길,704,274,430
2018,2,A,골목상권,1000336,솔매로45길,196,90,106
2018,2,A,골목상권,1000335,솔매로41길,86,21,65
2018,2,A,골목상권,1000334,삼양로93길,17,4,13
2018,2,A,골목상권,1000333,삼양로77길,419,147,272
2018,2,A,골목상권,1000332,삼양로54길,8,4,4
2018,2,A,골목상권,1000331,삼양로41길,306,141,165
2018,2,A,골목상권,1000329,삼양로24길,101,51,50
2018,2,A,골목상권,1000328,삼양로20길,137,48,89
2018,2,A,골목상권,1000327,삼각산로28길,833,401,432
2018,2,A,골목상권,1000326,도봉로99길,217,103,114
2018,2,A,골목상권,1000325,도봉로8길,258,196,62
2018,2,A,골목상권,1000324,도봉로76길,389,212,177
2018,2,A,골목상권,1000323,도봉로67길,6,3,3
2018,2,A,골목상권,1000322,도봉로45길,113,67,46
2018,2,A,골목상권,1000321,도봉로18길,382,178,204
2018,2,A,골목상권,1000320,도봉로13길,26,9,17
2018,2,A,골목상권,1000319,덕릉로41길,794,628,166
2018,2,A,골목상권,1000318,덕릉로40길,919,715,204
2018,2,A,골목상권,1000317,노해로33길,32,11,21
2018,2,A,골목상권,1000315,노해로17길,252,75,177
2018,2,A,골목상권,1000314,화랑로40길,185,103,82
2018,2,A,골목상권,1000313,화랑로32길,466,349,117
2018,2,A,골목상권,1000312,화랑로1길,161,85,76
2018,2,A,골목상권,1000311,화랑로19길,561,316,245
2018,2,A,골목상권,1000310,화랑로14길,33,15,18
2018,2,A,골목상권,1000309,화랑로13길,83,40,43
2018,2,A,골목상권,1000308,한천로76길,135,77,58
2018,2,A,골목상권,1000307,한천로101가길,46,28,18
2018,2,A,골목상권,1000306,창경궁로43길,29,21,8
2018,2,A,골목상권,1000305,지봉로20길,118,67,51
2018,2,A,골목상권,1000304,종암로5길,132,88,44
2018,2,A,골목상권,1000303,종암로24가길,294,137,157
2018,2,A,골목상권,1000302,종암로21길,250,44,206
2018,2,A,골목상권,1000301,종암로19길,408,132,276
2018,2,A,골목상권,1000300,종암로16길,89,38,51
2018,2,A,골목상권,1000299,정릉로8길,196,116,80
2018,2,A,골목상권,1000298,정릉로27길,212,95,117
2018,2,A,골목상권,1000296,장위로50길,685,411,274
2018,2,A,골목상권,1000295,장월로1길,341,173,168
2018,2,A,골목상권,1000294,인촌로6길,3273,1916,1357
2018,2,A,골목상권,1000293,인촌로5길,26,2,24
2018,2,A,골목상권,1000292,인촌로24길,236,154,82
2018,2,A,골목상권,1000291,개운사길,3713,2231,1482
2018,2,A,골목상권,1000290,인촌로1길,150,102,48
2018,2,A,골목상권,1000289,인촌로17가길,3323,1184,2139
2018,2,A,골목상권,1000288,오패산로4길,624,194,430
2018,2,A,골목상권,1000287,오패산로3길,1178,659,519
2018,2,A,골목상권,1000286,오패산로19길,41,18,23
2018,2,A,골목상권,1000285,안암로5길,612,379,233
2018,2,A,골목상권,1000284,아리랑로4길,558,217,341
2018,2,A,골목상권,1000283,솔샘로6길,154,70,84
2018,2,A,골목상권,1000282,성북로8길,56,25,31
2018,2,A,골목상권,1000281,삼양로8길,65,41,24
2018,2,A,골목상권,1000280,삼선교로16가길,735,419,316
2018,2,A,골목상권,1000279,삼선교로10다길,94,52,42
2018,2,A,골목상권,1000278,삼선교로10길,295,123,172
2018,2,A,골목상권,1000277,보문로32길,1017,413,604
2018,2,A,골목상권,1000276,보문로31길,702,285,417
2018,2,A,골목상권,1000274,보문로13길,931,600,331
2018,2,A,골목상권,1000273,보국문로16길,389,251,138
2018,2,A,골목상권,1000270,동소문로26가길,230,109,121
2018,2,A,골목상권,1000269,동소문로15길,128,57,71
2018,2,A,골목상권,1000268,동소문로13길,435,223,212
2018,2,A,골목상권,1000267,돌곶이로8길,182,87,95
2018,2,A,골목상권,1000266,돌곶이로41길,43,20,23
2018,2,A,골목상권,1000265,돌곶이로28길,227,143,84
2018,2,A,골목상권,1000264,돌곶이로27길,71,45,26
2018,2,A,골목상권,1000263,돌곶이로22길,132,68,64
2018,2,A,골목상권,1000261,길음로7길,8,5,3
2018,2,A,골목상권,1000260,중랑천로10길,770,382,388
2018,2,A,골목상권,1000259,용마산로94길,456,279,177
2018,2,A,골목상권,1000258,용마산로118길,566,275,291
2018,2,A,골목상권,1000257,용마산로112길,356,151,205
2018,2,A,골목상권,1000256,용마산로100길,433,294,139
2018,2,A,골목상권,1000255,신내로7가길,276,67,209
2018,2,A,골목상권,1000254,사가정로54길,135,46,89
2018,2,A,골목상권,1000253,사가정로42길,84,24,60
2018,2,A,골목상권,1000252,봉화산로56길,558,151,407
2018,2,A,골목상권,1000251,봉화산로4길,412,158,254
2018,2,A,골목상권,1000250,봉화산로30길,354,217,137
2018,2,A,골목상권,1000249,봉우재로33길,114,43,71
2018,2,A,골목상권,1000248,면목로78길,254,146,108
2018,2,A,골목상권,1000247,면목로56길,205,154,51
2018,2,A,골목상권,1000246,면목로55길,364,109,255
2018,2,A,골목상권,1000245,면목로49길,545,182,363
2018,2,A,골목상권,1000244,면목로48길,122,61,61
2018,2,A,골목상권,1000243,면목로45길,67,30,37
2018,2,A,골목상권,1000242,면목로33길,405,163,242
2018,2,A,골목상권,1000241,면목로21길,32,25,7
2018,2,A,골목상권,1000240,망우로73길,8,4,4
2018,2,A,골목상권,1000239,망우로68길,83,28,55
2018,2,A,골목상권,1000238,동일로163길,90,57,33
2018,2,A,골목상권,1000237,동일로157길,223,122,101
2018,2,A,골목상권,1000236,동일로149길,1154,859,295
2018,2,A,골목상권,1000235,동일로140길,189,84,105
2018,2,A,골목상권,1000234,동일로139길,64,35,29
2018,2,A,골목상권,1000233,동일로139가길,1207,688,519
2018,2,A,골목상권,1000232,동일로130길,118,46,72
2018,2,A,골목상권,1000231,동일로123길,184,96,88
2018,2,A,골목상권,1000230,동일로112길,156,71,85
2018,2,A,골목상권,1000229,동일로101길,289,116,173
2018,2,A,골목상권,1000228,동일로100길,74,36,38
2018,2,A,골목상권,1000227,답십리로75길,106,55,51
2018,2,A,골목상권,1000226,공릉로2길,665,299,366
2018,2,A,골목상권,1000225,공릉로12가길,28,19,9
2018,2,A,골목상권,1000224,겸재로54길,107,44,63
2018,2,A,골목상권,1000223,겸재로36길,242,195,47
2018,2,A,골목상권,1000222,겸재로29길,449,182,267
2018,2,A,골목상권,1000221,휘경로3길,232,114,118
2018,2,A,골목상권,1000220,휘경로2길,9,2,7
2018,2,A,골목상권,1000219,휘경로23길,19,4,15
2018,2,A,골목상권,1000218,휘경로14길,128,46,82
2018,2,A,골목상권,1000217,한천로46길,323,95,228
2018,2,A,골목상권,1000216,한천로40길,302,150,152
2018,2,A,골목상권,1000215,한천로33길,81,40,41
2018,2,A,골목상권,1000214,한천로14길,584,344,240
2018,2,A,골목상권,1000213,천호대로97길,343,218,125
2018,2,A,골목상권,1000212,천호대로77길,2055,1049,1006
2018,2,A,골목상권,1000211,천호대로45길,122,66,56
2018,2,A,골목상권,1000210,천호대로17길,2257,1465,792
2018,2,A,골목상권,1000209,천호대로12길,806,529,277
2018,2,A,골목상권,1000208,천장산로7길,1481,901,580
2018,2,A,골목상권,1000207,제기로5길,224,95,129
2018,2,A,골목상권,1000206,제기로21길,232,153,79
2018,2,A,골목상권,1000205,전농로4길,689,425,264
2018,2,A,골목상권,1000204,전농로3길,73,36,37
2018,2,A,골목상권,1000203,전농로29길,321,141,180
2018,2,A,골목상권,1000202,장한로8길,802,474,328
2018,2,A,골목상권,1000201,장한로5길,3043,2165,878
2018,2,A,골목상권,1000200,장한로27길,140,39,101
2018,2,A,골목상권,1000199,장한로27가길,422,201,221
2018,2,A,골목상권,1000198,장한로26길,533,253,280
2018,2,A,골목상권,1000197,장한로26가길,328,151,177
2018,2,A,골목상권,1000196,장한로25길,1042,478,564
2018,2,A,골목상권,1000195,장한로14길,184,150,34
2018,2,A,골목상권,1000194,이문로42길,270,115,155
2018,2,A,골목상권,1000193,왕산로43길,897,386,511
2018,2,A,골목상권,1000192,왕산로33길,158,108,50
2018,2,A,골목상권,1000191,왕산로32길,6,5,1
2018,2,A,골목상권,1000190,약령시로17길,340,163,177
2018,2,A,골목상권,1000189,서울시립대로4길,659,356,303
2018,2,A,골목상권,1000188,서울시립대로29길,221,123,98
2018,2,A,골목상권,1000187,서울시립대로16길,136,32,104
2018,2,A,골목상권,1000186,사가정로2길,86,67,19
2018,2,A,골목상권,1000185,사가정로23가길,98,64,34
2018,2,A,골목상권,1000184,사가정로13길,278,82,196
2018,2,A,골목상권,1000183,무학로45길,345,204,141
2018,2,A,골목상권,1000182,무학로16길,1213,1110,103
2018,2,A,골목상권,1000181,망우로21길,196,103,93
2018,2,A,골목상권,1000180,망우로18길,363,121,242
2018,2,A,골목상권,1000179,망우로18가길,71,30,41
2018,2,A,골목상권,1000178,답십리로72길,4,2,2
2018,2,A,골목상권,1000177,답십리로69길,926,401,525
2018,2,A,골목상권,1000176,답십리로68길,97,60,37
2018,2,A,골목상권,1000175,답십리로64길,355,213,142
2018,2,A,골목상권,1000174,답십리로63길,81,50,31
2018,2,A,골목상권,1000173,답십리로60길,14,6,8
2018,2,A,골목상권,1000172,답십리로56길,16,13,3
2018,2,A,골목상권,1000171,답십리로23길,6,4,2
2018,2,A,골목상권,1000170,난계로30길,131,89,42
2018,2,A,골목상권,1000168,경희대로3길,289,185,104
2018,2,A,골목상권,1000167,천호대로129길,230,85,145
2018,2,A,골목상권,1000166,천호대로123길,294,114,180
2018,2,A,골목상권,1000165,천호대로109길,1212,662,550
2018,2,A,골목상권,1000164,자양번영로3길,87,37,50
2018,2,A,골목상권,1000163,자양로53길,2,1,1
2018,2,A,골목상권,1000162,자양로50길,24,9,15
2018,2,A,골목상권,1000161,자양로45길,570,294,276
2018,2,A,골목상권,1000160,자양로26길,298,112,186
2018,2,A,골목상권,1000159,자양로15길,331,227,104
2018,2,A,골목상권,1000158,자양로11길,1347,689,658
2018,2,A,골목상권,1000157,용마산로3길,1005,588,417
2018,2,A,골목상권,1000156,용마산로21길,171,84,87
2018,2,A,골목상권,1000155,아차산로78길,2678,1322,1356
2018,2,A,골목상권,1000154,아차산로65길,675,447,228
2018,2,A,골목상권,1000153,아차산로55길,398,219,179
2018,2,A,골목상권,1000152,아차산로51길,243,144,99
2018,2,A,골목상권,1000151,아차산로40길,536,306,230
2018,2,A,골목상권,1000150,면목로17길,272,174,98
2018,2,A,골목상권,1000149,뚝섬로64길,300,162,138
2018,2,A,골목상권,1000148,뚝섬로58길,189,61,128
2018,2,A,골목상권,1000147,뚝섬로54길,152,93,59
2018,2,A,골목상권,1000146,뚝섬로48길,847,387,460
2018,2,A,골목상권,1000145,뚝섬로24길,96,30,66
2018,2,A,골목상권,1000144,뚝섬로23길,110,63,47
2018,2,A,골목상권,1000143,동일로24길,16,4,12
2018,2,A,골목상권,1000142,동일로18길,200,84,116
2018,2,A,골목상권,1000141,능동로4길,236,101,135
2018,2,A,골목상권,1000140,능동로3길,204,99,105
2018,2,A,골목상권,1000139,능동로34길,911,509,402
2018,2,A,골목상권,1000138,능동로19길,324,212,112
2018,2,A,골목상권,1000137,능동로13길,332,138,194
2018,2,A,골목상권,1000136,긴고랑로9길,47,24,23
2018,2,A,골목상권,1000135,긴고랑로8길,224,178,46
2018,2,A,골목상권,1000134,긴고랑로7길,497,246,251
2018,2,A,골목상권,1000133,긴고랑로20길,587,283,304
2018,2,A,골목상권,1000132,광나루로52길,1932,882,1050
2018,2,A,골목상권,1000131,광나루로40길,137,63,74
2018,2,A,골목상권,1000130,광나루로37길,306,186,120
2018,2,A,골목상권,1000129,광나루로36길,50,30,20
2018,2,A,골목상권,1000128,광나루로24길,83,47,36
2018,2,A,골목상권,1000127,광나루로12길,1047,586,461
2018,2,A,골목상권,1000126,한림말길,65,35,30
2018,2,A,골목상권,1000124,청계천로10나길,1826,1072,754
2018,2,A,골목상권,1000123,장터길,39,15,24
2018,2,A,골목상권,1000122,용답중앙길,92,47,45
2018,2,A,골목상권,1000121,용답29길,1708,902,806
2018,2,A,골목상권,1000120,왕십리로6길,1457,808,649
2018,2,A,골목상권,1000119,왕십리로31길,81,42,39
2018,2,A,골목상권,1000118,왕십리로26길,4069,2485,1584
2018,2,A,골목상권,1000117,왕십리로21길,196,65,131
2018,2,A,골목상권,1000116,왕십리로14길,2760,1981,779
2018,2,A,골목상권,1000115,아차산로5길,2254,1475,779
2018,2,A,골목상권,1000114,아차산로15길,4423,3129,1294
2018,2,A,골목상권,1000113,아차산로11길,3763,2445,1318
2018,2,A,골목상권,1000112,송정4가길,1033,447,586
2018,2,A,골목상권,1000111,송정12라길,266,184,82
2018,2,A,골목상권,1000110,성수일로6길,2624,1639,985
2018,2,A,골목상권,1000109,성수이로7길,558,315,243
2018,2,A,골목상권,1000108,성수이로18길,2355,1649,706
2018,2,A,골목상권,1000107,성덕정길,897,521,376
2018,2,A,골목상권,1000106,성덕정17길,234,123,111
2018,2,A,골목상권,1000105,서울숲2길,1098,643,455
2018,2,A,골목상권,1000104,상원길,1553,997,556
2018,2,A,골목상권,1000103,상원12길,170,105,65
2018,2,A,골목상권,1000102,사근동길,30,18,12
2018,2,A,골목상권,1000101,무학봉길,5,3,2
2018,2,A,골목상권,1000100,무학봉28길,134,60,74
2018,2,A,골목상권,1000099,무학로6길,387,216,171
2018,2,A,골목상권,1000098,무수막길,153,74,79
2018,2,A,골목상권,1000097,매봉길,10,7,3
2018,2,A,골목상권,1000096,마조로1길,216,79,137
2018,2,A,골목상권,1000095,마조로16길,839,589,250
2018,2,A,골목상권,1000094,마장로39길,107,51,56
2018,2,A,골목상권,1000093,마장로27길,77,22,55
2018,2,A,골목상권,1000091,둘레9길,391,231,160
2018,2,A,골목상권,1000090,금호산길,436,156,280
2018,2,A,골목상권,1000089,금호산2길,36,12,24
2018,2,A,골목상권,1000088,고산자로6길,9832,3564,6268
2018,2,A,골목상권,1000087,후암로28길,209,92,117
2018,2,A,골목상권,1000086,효창원로39길,57,31,26
2018,2,A,골목상권,1000085,회나무로13길,85,46,39
2018,2,A,골목상권,1000084,한남대로20길,772,432,340
2018,2,A,골목상권,1000082,한강대로7길,491,331,160
2018,2,A,골목상권,1000081,한강대로62길,742,505,237
2018,2,A,골목상권,1000080,한강대로52길,1146,735,411
2018,2,A,골목상권,1000079,한강대로43길,5969,3751,2218
2018,2,A,골목상권,1000078,한강대로15길,1230,345,885
2018,2,A,골목상권,1000077,한강대로104길,11313,4081,7232
2018,2,A,골목상권,1000076,청파로73길,1175,614,561
2018,2,A,골목상권,1000075,청파로71길,228,112,116
2018,2,A,골목상권,1000074,청파로47나길,171,97,74
2018,2,A,골목상권,1000073,청파로47길,969,423,546
2018,2,A,골목상권,1000072,장문로45길,55,13,42
2018,2,A,골목상권,1000071,이태원로54길,2259,1093,1166
2018,2,A,골목상권,1000070,이태원로27길,629,356,273
2018,2,A,골목상권,1000069,이촌로22길,279,165,114
2018,2,A,골목상권,1000068,원효로89길,893,734,159
2018,2,A,골목상권,1000067,원효로53길,867,532,335
2018,2,A,골목상권,1000066,원효로41길,1490,1016,474
2018,2,A,골목상권,1000065,원효로19길,1038,733,305
2018,2,A,골목상권,1000064,우사단로4길,152,91,61
2018,2,A,골목상권,1000063,우사단로14길,1886,905,981
2018,2,A,골목상권,1000062,우사단로10길,87,39,48
2018,2,A,골목상권,1000061,신흥로20길,216,93,123
2018,2,A,골목상권,1000060,소월로20길,136,53,83
2018,2,A,골목상권,1000059,서빙고로71길,469,283,186
2018,2,A,골목상권,1000058,백범로90길,256,155,101
2018,2,A,골목상권,1000057,백범로79길,725,440,285
2018,2,A,골목상권,1000056,두텁바위로1길,2758,1484,1274
2018,2,A,골목상권,1000055,대사관로34길,291,142,149
2018,2,A,골목상권,1000054,녹사평대로46길,74,46,28
2018,2,A,골목상권,1000053,녹사평대로40나길,65,29,36
2018,2,A,골목상권,1000052,녹사평대로32길,389,218,171
2018,2,A,골목상권,1000051,녹사평대로26길,2081,1090,991
2018,2,A,골목상권,1000050,녹사평대로11길,267,175,92
2018,2,A,골목상권,1000049,퇴계로90길,599,220,379
2018,2,A,골목상권,1000048,퇴계로8길,2397,1293,1104
2018,2,A,골목상권,1000047,퇴계로56길,1285,1042,243
2018,2,A,골목상권,1000046,퇴계로46길,2119,1001,1118
2018,2,A,골목상권,1000045,퇴계로18길,3099,1354,1745
2018,2,A,골목상권,1000044,퇴계로12길,1154,488,666
2018,2,A,골목상권,1000043,청구로1길,250,84,166
2018,2,A,골목상권,1000042,청구로17길,1721,804,917
2018,2,A,골목상권,1000041,장충단로8길,3242,1195,2047
2018,2,A,골목상권,1000040,삼일대로4길,957,571,386
2018,2,A,골목상권,1000039,명동길,36306,17786,18520
2018,2,A,골목상권,1000037,동호로20길,854,337,517
2018,2,A,골목상권,1000036,동호로15길,4108,2168,1940
2018,2,A,골목상권,1000035,동호로11길,17,11,6
2018,2,A,골목상권,1000034,동호로10길,1587,702,885
2018,2,A,골목상권,1000033,다산로39길,1339,742,597
2018,2,A,골목상권,1000032,다산로38길,1628,724,904
2018,2,A,골목상권,1000031,다산로36길,70,42,28
2018,2,A,골목상권,1000030,다산로33길,396,202,194
2018,2,A,골목상권,1000029,난계로21길,252,160,92
2018,2,A,골목상권,1000028,난계로11길,1823,1066,757
2018,2,A,골목상권,1000027,필운대로1길,4,1,3
2018,2,A,골목상권,1000026,평창길,206,101,105
2018,2,A,골목상권,1000025,통일로12길,236,94,142
2018,2,A,골목상권,1000024,창신길,271,69,202
2018,2,A,골목상권,1000023,창신5길,8,3,5
2018,2,A,골목상권,1000022,창신2길,56,26,30
2018,2,A,골목상권,1000021,창경궁로35길,1114,326,788
2018,2,A,골목상권,1000020,지봉로8길,195,97,98
2018,2,A,골목상권,1000019,종로65길,486,250,236
2018,2,A,골목상권,1000016,자하문로7길,624,398,226
2018,2,A,골목상권,1000015,이화장길,1996,960,1036
2018,2,A,골목상권,1000014,율곡로16길,103,90,13
2018,2,A,골목상권,1000013,율곡로10길,2228,1612,616
2018,2,A,골목상권,1000012,옥인길,469,195,274
2018,2,A,골목상권,1000011,숭인동길,24,5,19
2018,2,A,골목상권,1000010,성균관로5길,133,82,51
2018,2,A,골목상권,1000009,삼청로5길,449,169,280
2018,2,A,골목상권,1000008,북촌로5나길,1693,1128,565
2018,2,A,골목상권,1000007,북촌로5길,57,24,33
2018,2,A,골목상권,1000006,북촌로11길,12,5,7
2018,2,A,골목상권,1000005,백석동길,139,73,66
2018,2,A,골목상권,1000004,명륜길,18,8,10
2018,2,A,골목상권,1000003,돈화문로11가길,1048,569,479
2018,2,A,골목상권,1000001,계동길,829,356,473
2018,1,U,관광특구,1001496,강남 마이스 관광특구,22435,12791,9644
2018,1,U,관광특구,1001495,잠실 관광특구,29135,16836,12299
2018,1,U,관광특구,1001494,종로?청계 관광특구,31373,18799,12574
2018,1,U,관광특구,1001493,동대문패션타운 관광특구,10146,5690,4456
2018,1,U,관광특구,1001492,명동 남대문 북창동 다동 무교동 관광특구,163479,80965,82514
2018,1,U,관광특구,1001491,이태원 관광특구,6036,3295,2741
2018,1,R,전통시장,1001490,길동복조리시장,448,301,147
2018,1,R,전통시장,1001489,둔촌역전통시장,169,81,88
2018,1,R,전통시장,1001488,성내골목시장,7,2,5
2018,1,R,전통시장,1001487,천호시장,19,10,9
2018,1,R,전통시장,1001483,암사종합시장,758,366,392
2018,1,R,전통시장,1001482,고덕전통시장,384,371,13
2018,1,R,전통시장,1001481,명일골목시장,461,166,295
2018,1,R,전통시장,1001480,새마을시장,362,201,161
2018,1,R,전통시장,1001479,석촌시장,173,108,65
2018,1,R,전통시장,1001478,방이시장,643,400,243
2018,1,R,전통시장,1001477,마천시장,202,70,132
2018,1,R,전통시장,1001476,풍납시장,22,8,14
2018,1,R,전통시장,1001475,강남개포시장,40,33,7
2018,1,R,전통시장,1001474,도곡시장,492,218,274
2018,1,R,전통시장,1001471,영동전통시장,2966,2171,795
2018,1,R,전통시장,1001466,미성동도깨비시장,419,178,241
2018,1,R,전통시장,1001465,신신림시장,2,2,0
2018,1,R,전통시장,1001464,삼성동시장,88,39,49
2018,1,R,전통시장,1001463,신림중앙시장,16,10,6
2018,1,R,전통시장,1001462,강남골목시장,279,128,151
2018,1,R,전통시장,1001460,관악신사시장,149,76,73
2018,1,R,전통시장,1001459,신원시장,315,116,199
2018,1,R,전통시장,1001458,인헌시장,211,98,113
2018,1,R,전통시장,1001456,봉천현대시장,7,4,3
2018,1,R,전통시장,1001454,봉천제일종합시장,56,25,31
2018,1,R,전통시장,1001453,낙성대시장,18,14,4
2018,1,R,전통시장,1001452,중부시장,182,58,124
2018,1,R,전통시장,1001450,남성역골목시장,545,247,298
2018,1,R,전통시장,1001449,남성사계시장,2019,924,1095
2018,1,R,전통시장,1001448,흑석시장,185,73,112
2018,1,R,전통시장,1001447,상도4동도깨비골목시장,323,82,241
2018,1,R,전통시장,1001445,영도시장,70,28,42
2018,1,R,전통시장,1001441,본동인정시장,120,61,59
2018,1,R,전통시장,1001439,대림중앙시장,22,10,12
2018,1,R,전통시장,1001438,우리시장,16,8,8
2018,1,R,전통시장,1001437,영진시장A동,49,42,7
2018,1,R,전통시장,1001436,사러가시장,26,7,19
2018,1,R,전통시장,1001431,영등포청과시장,191,122,69
2018,1,R,전통시장,1001430,영등포전통시장,3892,1947,1945
2018,1,R,전통시장,1001429,은행나무시장,56,12,44
2018,1,R,전통시장,1001427,현대시장,56,16,40
2018,1,R,전통시장,1001424,남문시장,269,112,157
2018,1,R,전통시장,1001423,독산동 우시장,147,62,85
2018,1,R,전통시장,1001421,개봉중앙시장,7,3,4
2018,1,R,전통시장,1001419,가리봉시장,19,15,4
2018,1,R,전통시장,1001418,남구로시장,16,3,13
2018,1,R,전통시장,1001417,구로시장,58,24,34
2018,1,R,전통시장,1001415,방신전통시장,38,22,16
2018,1,R,전통시장,1001414,송화골목시장,544,184,360
2018,1,R,전통시장,1001413,까치산시장,43,28,15
2018,1,R,전통시장,1001411,남부골목시장,216,88,128
2018,1,R,전통시장,1001409,화곡중앙골목시장,2,2,0
2018,1,R,전통시장,1001407,등마루시장,817,469,348
2018,1,R,전통시장,1001406,신정3동골목시장,204,106,98
2018,1,R,전통시장,1001405,신정2동골목시장,6,5,1
2018,1,R,전통시장,1001402,신월6동골목시장,227,109,118
2018,1,R,전통시장,1001401,신곡종합시장,11,7,4
2018,1,R,전통시장,1001400,신월3동골목시장,63,18,45
2018,1,R,전통시장,1001399,경창시장,189,82,107
2018,1,R,전통시장,1001398,월정로시장,115,63,52
2018,1,R,전통시장,1001397,신영시장,50,21,29
2018,1,R,전통시장,1001396,목4동시장,211,64,147
2018,1,R,전통시장,1001395,목3동시장,662,313,349
2018,1,R,전통시장,1001394,목2동시장,236,108,128
2018,1,R,전통시장,1001393,마포농수산물시장,494,319,175
2018,1,R,전통시장,1001391,망원월드컵시장,15,10,5
2018,1,R,전통시장,1001390,망원시장,48,24,24
2018,1,R,전통시장,1001386,신수시장,125,89,36
2018,1,R,전통시장,1001385,아현시장,26,5,21
2018,1,R,전통시장,1001374,대림골목시장,383,135,248
2018,1,R,전통시장,1001367,상계중앙시장,34,15,19
2018,1,R,전통시장,1001364,방학동도깨비시장,156,65,91
2018,1,R,전통시장,1001363,쌍문역골목시장,72,35,37
2018,1,R,전통시장,1001361,신도봉시장,24,13,11
2018,1,R,전통시장,1001359,창동신창시장,142,68,74
2018,1,R,전통시장,1001358,수유북부시장,9,2,7
2018,1,R,전통시장,1001357,장미원골목시장,73,45,28
2018,1,R,전통시장,1001356,수유중앙시장,127,70,57
2018,1,R,전통시장,1001355,강북종합시장,64,26,38
2018,1,R,전통시장,1001354,우이시장,158,62,96
2018,1,R,전통시장,1001353,수유전통시장,443,138,305
2018,1,R,전통시장,1001352,번동북부골목시장,81,45,36
2018,1,R,전통시장,1001351,솔샘시장,107,43,64
2018,1,R,전통시장,1001349,방천골목시장,72,27,45
2018,1,R,전통시장,1001347,석관황금시장,73,23,50
2018,1,R,전통시장,1001343,장위전통시장,185,77,108
2018,1,R,전통시장,1001340,정릉시장,33,11,22
2018,1,R,전통시장,1001339,정릉아리랑시장,2,1,1
2018,1,R,전통시장,1001338,돈암제일시장,53,17,36
2018,1,R,전통시장,1001336,우림골목시장,217,109,108
2018,1,R,전통시장,1001335,묵1동도깨비시장,280,126,154
2018,1,R,전통시장,1001334,태능시장,4,3,1
2018,1,R,전통시장,1001333,중화제일시장,23,1,22
2018,1,R,전통시장,1001332,사가정시장,260,187,73
2018,1,R,전통시장,1001330,동원시장,80,34,46
2018,1,R,전통시장,1001329,동부골목시장,101,35,66
2018,1,R,전통시장,1001326,회기시장,115,50,65
2018,1,R,전통시장,1001323,답십리시장,26,8,18
2018,1,R,전통시장,1001321,답십리현대시장,85,69,16
2018,1,R,전통시장,1001319,청량리종합시장,13,10,3
2018,1,R,전통시장,1001317,청량리농수산물시장,18,15,3
2018,1,R,전통시장,1001316,서울약령시장,1335,806,529
2018,1,R,전통시장,1001313,청량리수산시장,222,110,112
2018,1,R,전통시장,1001310,구의시장,121,72,49
2018,1,R,전통시장,1001309,조양시장,93,48,45
2018,1,R,전통시장,1001308,영동교골목시장,18,12,6
2018,1,R,전통시장,1001307,능동로골목시장,198,164,34
2018,1,R,전통시장,1001304,자양골목시장,88,46,42
2018,1,R,전통시장,1001301,중곡제일시장,120,69,51
2018,1,R,전통시장,1001299,한아름시장,141,80,61
2018,1,R,전통시장,1001298,성동용답상가시장,292,144,148
2018,1,R,전통시장,1001297,뚝도시장,34,12,22
2018,1,R,전통시장,1001296,금남시장,22,12,10
2018,1,R,전통시장,1001295,행당시장,243,123,120
2018,1,R,전통시장,1001294,마장축산물시장,1501,1017,484
2018,1,R,전통시장,1001289,용문전통시장,39,20,19
2018,1,R,전통시장,1001286,후암시장,50,19,31
2018,1,R,전통시장,1001285,합동(새벽)시장,2442,1364,1078
2018,1,R,전통시장,1001284,서울중앙시장,268,182,86
2018,1,R,전통시장,1001283,백학시장,466,240,226
2018,1,R,전통시장,1001282,약수시장,1757,696,1061
2018,1,R,전통시장,1001281,청평화시장,3287,1991,1296
2018,1,R,전통시장,1001280,제일평화시장,516,299,217
2018,1,R,전통시장,1001278,남평화시장,195,118,77
2018,1,R,전통시장,1001277,방산종합시장,1838,1161,677
2018,1,R,전통시장,1001275,인현시장,1123,708,415
2018,1,R,전통시장,1001274,신중부시장,2387,1590,797
2018,1,R,전통시장,1001273,남대문시장,7058,3595,3463
2018,1,R,전통시장,1001271,동묘시장,915,580,335
2018,1,R,전통시장,1001270,창신골목시장,227,115,112
2018,1,R,전통시장,1001268,충신시장,328,203,125
2018,1,R,전통시장,1001267,종로신진시장,39,17,22
2018,1,R,전통시장,1001266,동대문종합시장,308,171,137
2018,1,R,전통시장,1001265,광장시장,194,143,51
2018,1,D,발달상권,1001263,서울 노원구 노원역_3,759,317,442
2018,1,D,발달상권,1001261,서울 노원구 노원역_1,947,284,663
2018,1,D,발달상권,1001260,창동역,2396,1556,840
2018,1,D,발달상권,1001259,서울 강북구 수유역_3,71,33,38
2018,1,D,발달상권,1001257,서울 강북구 수유역_2,4324,2172,2152
2018,1,D,발달상권,1001256,서울 강북구 수유역_1,51,37,14
2018,1,D,발달상권,1001255,서울 은평구 연신내역_3,664,202,462
2018,1,D,발달상권,1001254,서울 은평구 연신내역_2,428,182,246
2018,1,D,발달상권,1001253,서울 은평구 연신내역_1,83,41,42
2018,1,D,발달상권,1001252,서울 성북구 미아삼거리역_2,521,209,312
2018,1,D,발달상권,1001251,서울 강북구 미아삼거리역_1,527,193,334
2018,1,D,발달상권,1001250,서울 은평구 불광역_3,57,21,36
2018,1,D,발달상권,1001249,서울 은평구 불광역_2,88,31,57
2018,1,D,발달상권,1001248,서울 은평구 불광역_1,246,94,152
2018,1,D,발달상권,1001247,미아사거리_2,110,26,84
2018,1,D,발달상권,1001246,미아사거리_1,528,236,292
2018,1,D,발달상권,1001245,서울 성북구 성신여대입구역,5122,3116,2006
2018,1,D,발달상권,1001244,경희대학교,341,161,180
2018,1,D,발달상권,1001243,서울 성북구 안암역,110,67,43
2018,1,D,발달상권,1001242,혜화역 대학로_3,1654,774,880
2018,1,D,발달상권,1001241,혜화역 대학로_2,1498,813,685
2018,1,D,발달상권,1001240,혜화역 대학로_1,1166,626,540
2018,1,D,발달상권,1001239,디지털미디어시티,16813,10770,6043
2018,1,D,발달상권,1001238,서울 동대문구 청량리역,3541,2418,1123
2018,1,D,발달상권,1001236,서울 종로구 안국역_2,656,273,383
2018,1,D,발달상권,1001235,서울 종로구 안국역_1,11611,9406,2205
2018,1,D,발달상권,1001234,서울 종로구 경복궁역_1,203,78,125
2018,1,D,발달상권,1001233,서울 종로구 종로3가역_3,3303,1754,1549
2018,1,D,발달상권,1001232,서울 종로구 종로3가역_2,1862,1009,853
2018,1,D,발달상권,1001231,서울 동대문구 신설동역_2,4556,2170,2386
2018,1,D,발달상권,1001230,인사동,20646,12784,7862
2018,1,D,발달상권,1001229,서울 종로구 종로5가역_4,654,355,299
2018,1,D,발달상권,1001228,서울 종로구 종로5가역_3,5069,3422,1647
2018,1,D,발달상권,1001227,종로구청,18223,10024,8199
2018,1,D,발달상권,1001226,서울 종로구 종로5가역_2,17663,11671,5992
2018,1,D,발달상권,1001225,신설동역,744,414,330
2018,1,D,발달상권,1001224,서울 동대문구 신설동역_1,2,2,0
2018,1,D,발달상권,1001223,서울 종로구 광화문역_2,54526,32877,21649
2018,1,D,발달상권,1001222,동묘앞역,52,31,21
2018,1,D,발달상권,1001221,장안동사거리,494,258,236
2018,1,D,발달상권,1001220,서울 종로구 동대문역_2,1090,555,535
2018,1,D,발달상권,1001218,동대문시장_2,490,300,190
2018,1,D,발달상권,1001217,서울 종로구 종로5가역_1,48,36,12
2018,1,D,발달상권,1001216,서울 종로구 종로3가역_1,4196,1807,2389
2018,1,D,발달상권,1001215,서울 종로구 광화문역_1,2092,1335,757
2018,1,D,발달상권,1001214,종각역,20629,13378,7251
2018,1,D,발달상권,1001213,종각역 젊음의 거리,2385,1017,1368
2018,1,D,발달상권,1001212,서대문구 서대문역_1,362,251,111
2018,1,D,발달상권,1001211,동대문시장_1,435,229,206
2018,1,D,발달상권,1001210,시청역_2,22471,14281,8190
2018,1,D,발달상권,1001209,서울시청,24111,11723,12388
2018,1,D,발달상권,1001208,서울 중구 을지로3가역_2,7696,4978,2718
2018,1,D,발달상권,1001207,서울 중구 신당역_2,1347,675,672
2018,1,D,발달상권,1001206,서대문구 서대문역_2,1405,861,544
2018,1,D,발달상권,1001205,동대문역사문화공원역,2212,1257,955
2018,1,D,발달상권,1001204,서울 중구 을지로3가역_1,15222,9995,5227
2018,1,D,발달상권,1001203,명동거리,9708,5218,4490
2018,1,D,발달상권,1001202,롯데백화점,43758,23437,20321
2018,1,D,발달상권,1001201,서울 중구 신당역_1,1012,668,344
2018,1,D,발달상권,1001200,북창동,10134,5387,4747
2018,1,D,발달상권,1001199,서울 중구 충무로역_2,14218,6370,7848
2018,1,D,발달상권,1001198,서울 강서구 송정역,630,416,214
2018,1,D,발달상권,1001197,장한평역_2,5310,3241,2069
2018,1,D,발달상권,1001196,시청역_1,55012,33341,21671
2018,1,D,발달상권,1001195,왕십리역_2,661,279,382
2018,1,D,발달상권,1001194,서울 강서구 발산역,854,496,358
2018,1,D,발달상권,1001193,장한평역_1,2293,1530,763
2018,1,D,발달상권,1001192,서울 중구 충무로역_1,3243,2252,991
2018,1,D,발달상권,1001190,장한평역,2192,1545,647
2018,1,D,발달상권,1001189,서울 중구 명동역,3845,1963,1882
2018,1,D,발달상권,1001188,장충동 족발거리,199,98,101
2018,1,D,발달상권,1001187,한양시장,298,151,147
2018,1,D,발달상권,1001186,서울 서대문구 이대역,1286,572,714
2018,1,D,발달상권,1001185,서울 서대문구 신촌역,3137,1358,1779
2018,1,D,발달상권,1001184,서울 마포구 홍대입구역_3,331,162,169
2018,1,D,발달상권,1001183,서울 마포구 홍대입구역_2,3456,1278,2178
2018,1,D,발달상권,1001182,홍익대학교 주변,16348,7888,8460
2018,1,D,발달상권,1001181,서울 광진구 군자역,176,101,75
2018,1,D,발달상권,1001180,신촌역,222,109,113
2018,1,D,발달상권,1001179,강서구청,3403,2241,1162
2018,1,D,발달상권,1001178,서울 마포구 홍대입구역_1,860,476,384
2018,1,D,발달상권,1001175,서울 강동구 고덕역,476,274,202
2018,1,D,발달상권,1001173,서울 강동구 명일역,886,357,529
2018,1,D,발달상권,1001172,어린이대공원역,93,51,42
2018,1,D,발달상권,1001171,서울 마포구 공덕역_2,4357,2524,1833
2018,1,D,발달상권,1001170,공덕역,7579,4503,3076
2018,1,D,발달상권,1001169,서울 용산구 숙대입구역,2726,1988,738
2018,1,D,발달상권,1001168,남영역,13126,5769,7357
2018,1,D,발달상권,1001167,서울 마포구 공덕역_1,4948,2420,2528
2018,1,D,발달상권,1001166,서울 마포구 마포역_2,957,522,435
2018,1,D,발달상권,1001165,서울 광진구 건대입구역_2,2899,1009,1890
2018,1,D,발달상권,1001164,서울 마포구 마포역_1,11787,7085,4702
2018,1,D,발달상권,1001163,서울 강동구 천호역_2,3879,1870,2009
2018,1,D,발달상권,1001162,서울 광진구 건대입구역_1,886,425,461
2018,1,D,발달상권,1001161,건대입구역,718,386,332
2018,1,D,발달상권,1001160,서울 광진구 구의역,826,511,315
2018,1,D,발달상권,1001159,서울 강동구 천호역,931,452,479
2018,1,D,발달상권,1001158,당산역_2,4972,2952,2020
2018,1,D,발달상권,1001156,서울 강동구 길동역,1179,662,517
2018,1,D,발달상권,1001155,용산 전자상가_5,2463,1801,662
2018,1,D,발달상권,1001153,당산역_1,1149,727,422
2018,1,D,발달상권,1001152,서울 광진구 강변역,1808,1436,372
2018,1,D,발달상권,1001151,용산 전자상가_3,2474,1780,694
2018,1,D,발달상권,1001150,서울 용산구 이태원역,673,404,269
2018,1,D,발달상권,1001149,한남오거리,562,293,269
2018,1,D,발달상권,1001147,용산 전자상가_2,461,363,98
2018,1,D,발달상권,1001146,용산구청,84,51,33
2018,1,D,발달상권,1001145,용산 전자상가_1,13362,8405,4957
2018,1,D,발달상권,1001144,국회의사당역_2,37259,21154,16105
2018,1,D,발달상권,1001143,서울 용산구 신용산역,508,233,275
2018,1,D,발달상권,1001142,국회의사당역_1,5701,4395,1306
2018,1,D,발달상권,1001141,압구정 로데오거리_2,16393,6863,9530
2018,1,D,발달상권,1001140,서울 강남구 압구정역,11363,5229,6134
2018,1,D,발달상권,1001139,서울 영등포구 영등포구청역,3727,1138,2589
2018,1,D,발달상권,1001138,압구정 로데오거리_1,7848,2550,5298
2018,1,D,발달상권,1001137,서울 강동구 둔촌동역,45,12,33
2018,1,D,발달상권,1001136,오목교역,194,81,113
2018,1,D,발달상권,1001135,신사동 가로수길,22334,10463,11871
2018,1,D,발달상권,1001134,서울 영등포구 여의도역_2,48879,32436,16443
2018,1,D,발달상권,1001133,청담사거리_3,1791,592,1199
2018,1,D,발달상권,1001132,영등포유통상가,2130,1309,821
2018,1,D,발달상권,1001131,청담역_2,1341,939,402
2018,1,D,발달상권,1001130,청담역_1,190,150,40
2018,1,D,발달상권,1001129,청담사거리_2,1008,760,248
2018,1,D,발달상권,1001127,서울 영등포구 여의도역_1,51592,30941,20651
2018,1,D,발달상권,1001125,학동사거리_2,2880,1649,1231
2018,1,D,발달상권,1001124,서울 영등포구 영등포시장역,334,256,78
2018,1,D,발달상권,1001123,학동사거리_1,4274,2207,2067
2018,1,D,발달상권,1001122,여의도 시범아파트앞,2147,1405,742
2018,1,D,발달상권,1001121,영등포역_3,871,511,360
2018,1,D,발달상권,1001120,도산공원사거리_1,9955,5887,4068
2018,1,D,발달상권,1001119,영등포역_2,1207,649,558
2018,1,D,발달상권,1001118,문래동 주민센터,74,61,13
2018,1,D,발달상권,1001117,강남구 신사역_2,8223,5124,3099
2018,1,D,발달상권,1001115,서울 강남구 강남구청역_2,4550,2824,1726
2018,1,D,발달상권,1001114,강남구 신사역_1,2479,1088,1391
2018,1,D,발달상권,1001113,서울 동작구 노량진1동_1,26,13,13
2018,1,D,발달상권,1001112,서울 강남구 학동역_3,9290,5379,3911
2018,1,D,발달상권,1001111,서울 강남구 강남구청역_1,3568,2108,1460
2018,1,D,발달상권,1001110,잠실역,6089,4538,1551
2018,1,D,발달상권,1001109,강남구 논현역_4,6622,3405,3217
2018,1,D,발달상권,1001108,학동역,1452,553,899
2018,1,D,발달상권,1001107,방이동 먹자골목,5272,3313,1959
2018,1,D,발달상권,1001106,서울 강남구 학동역_2,5932,3345,2587
2018,1,D,발달상권,1001105,서울 동작구 노량진역,3863,2198,1665
2018,1,D,발달상권,1001104,삼성역_3,8944,4997,3947
2018,1,D,발달상권,1001103,코엑스,22435,12791,9644
2018,1,D,발달상권,1001102,서울 강남구 학동역_1,5146,3297,1849
2018,1,D,발달상권,1001101,선정릉역_2,6606,4052,2554
2018,1,D,발달상권,1001100,강남구 논현역_3,1558,947,611
2018,1,D,발달상권,1001099,포스코사거리_2,7496,4762,2734
2018,1,D,발달상권,1001098,포스코사거리_1,44391,29259,15132
2018,1,D,발달상권,1001097,잠실역 롯데월드,3972,1974,1998
2018,1,D,발달상권,1001096,신도림역,3335,1773,1562
2018,1,D,발달상권,1001095,강남구 논현역_2,9434,4499,4935
2018,1,D,발달상권,1001094,선정릉역_1,1893,1347,546
2018,1,D,발달상권,1001093,신천역,5817,3114,2703
2018,1,D,발달상권,1001092,강남구 논현역_1,3544,2067,1477
2018,1,D,발달상권,1001091,삼성역_2,18112,10907,7205
2018,1,D,발달상권,1001090,삼정역_2,2637,1374,1263
2018,1,D,발달상권,1001089,삼정역_1,3181,1656,1525
2018,1,D,발달상권,1001088,삼성역_1,34086,21853,12233
2018,1,D,발달상권,1001087,서울 강남구 선릉역_2,7247,4637,2610
2018,1,D,발달상권,1001086,고속터미널역,16010,4725,11285
2018,1,D,발달상권,1001085,서울 서초구 강남역,32833,18506,14327
2018,1,D,발달상권,1001084,서울 강남구 선릉역_1,20105,8197,11908
2018,1,D,발달상권,1001082,선릉역_2,21074,10853,10221
2018,1,D,발달상권,1001081,서울 강남구 역삼역_2,26755,21043,5712
2018,1,D,발달상권,1001080,서울 송파구 석촌역_1,37,23,14
2018,1,D,발달상권,1001078,서울 강남구 강남역_2,5454,3172,2282
2018,1,D,발달상권,1001077,선릉역_1,55040,29720,25320
2018,1,D,발달상권,1001076,구로역,157,90,67
2018,1,D,발달상권,1001075,역삼역_2,4606,2561,2045
2018,1,D,발달상권,1001074,대림역_2,7770,5930,1840
2018,1,D,발달상권,1001073,서울 강남구 역삼역_1,25570,15878,9692
2018,1,D,발달상권,1001072,신대방삼거리역,232,109,123
2018,1,D,발달상권,1001071,서울 강남구 한티역,1106,444,662
2018,1,D,발달상권,1001070,은마아파트입구사거리_4,102,51,51
2018,1,D,발달상권,1001067,오류동역,1539,779,760
2018,1,D,발달상권,1001066,서울 강남구 강남역,39619,18744,20875
2018,1,D,발달상권,1001063,교대역_4,5010,2740,2270
2018,1,D,발달상권,1001062,서울 강남구 강남역_1,133206,97624,35582
2018,1,D,발달상권,1001061,방배동카페골목,113,48,65
2018,1,D,발달상권,1001060,가락시장,17236,10769,6467
2018,1,D,발달상권,1001059,교대역_3,4329,2632,1697
2018,1,D,발달상권,1001058,역삼역_1,1666,1013,653
2018,1,D,발달상권,1001057,교대역_2,3448,2191,1257
2018,1,D,발달상권,1001056,서울 송파구 가락시장역,5261,3391,1870
2018,1,D,발달상권,1001055,서울 서초구 서초역,12915,5397,7518
2018,1,D,발달상권,1001054,서울 강남구 대치역_2,1506,906,600
2018,1,D,발달상권,1001052,뱅뱅사거리_2,25312,16270,9042
2018,1,D,발달상권,1001051,보라매공원,14218,8051,6167
2018,1,D,발달상권,1001050,교대역_1,12772,7610,5162
2018,1,D,발달상권,1001049,개봉동 현대아파트 인근,149,62,87
2018,1,D,발달상권,1001048,뱅뱅사거리,7522,4955,2567
2018,1,D,발달상권,1001047,뱅뱅사거리_1,10840,7695,3145
2018,1,D,발달상권,1001046,서울 관악구 신림역_4,987,443,544
2018,1,D,발달상권,1001045,동작구 총신대입구역_1,243,114,129
2018,1,D,발달상권,1001044,양재역_3,3664,2387,1277
2018,1,D,발달상권,1001043,동작구 총신대입구역_2,790,327,463
2018,1,D,발달상권,1001042,서울 서초구 남부터미널역_3,1460,790,670
2018,1,D,발달상권,1001041,서울 강남구 수서역,15828,11213,4615
2018,1,D,발달상권,1001039,서울 서초구 남부터미널역_2,10951,5473,5478
2018,1,D,발달상권,1001038,구로디지탈1단지,65994,41668,24326
2018,1,D,발달상권,1001037,양재역,120,49,71
2018,1,D,발달상권,1001035,매봉역,584,219,365
2018,1,D,발달상권,1001034,서울 서초구 방배역,3536,2094,1442
2018,1,D,발달상권,1001033,서울 서초구 남부터미널역_1,548,399,149
2018,1,D,발달상권,1001032,서울 관악구 신림역_2,32,17,15
2018,1,D,발달상권,1001031,서울 관악구 신림역_1,1869,899,970
2018,1,D,발달상권,1001030,양재역_2,10112,5277,4835
2018,1,D,발달상권,1001029,양재역_1,918,648,270
2018,1,D,발달상권,1001028,서울 관악구 서울대입구역_2,38,2,36
2018,1,D,발달상권,1001027,가산디지털단지역_3,30011,17798,12213
2018,1,D,발달상권,1001026,구로디지털단지역,2293,1476,817
2018,1,D,발달상권,1001025,서울 관악구 서울대입구역_1,1981,833,1148
2018,1,D,발달상권,1001024,관악구 사당역_1,3726,1480,2246
2018,1,D,발달상권,1001023,가산디지털단지역_2,59572,36023,23549
2018,1,D,발달상권,1001022,관악구 사당역_2,471,238,233
2018,1,D,발달상권,1001021,가산디지털단지역_1,27543,18660,8883
2018,1,D,발달상권,1001020,장지역,4692,2933,1759
2018,1,D,발달상권,1001019,포이사거리_1,5883,3267,2616
2018,1,D,발달상권,1001018,포이사거리_2,8511,5899,2612
2018,1,D,발달상권,1001016,서울 관악구 대학동_1,97,57,40
2018,1,D,발달상권,1001015,서울 금천구 독산1동_1,2864,1865,999
2018,1,D,발달상권,1001013,양재 화물트럭터미널앞_2,146,65,81
2018,1,D,발달상권,1001012,양재 화물트럭터미널앞_1,4204,3395,809
2018,1,D,발달상권,1001011,서울 금천구 시흥1동_4,963,435,528
2018,1,A,골목상권,1001010,풍성로37가길,39,19,20
2018,1,A,골목상권,1001009,천호옛길,487,327,160
2018,1,A,골목상권,1001008,천호옛14길,618,307,311
2018,1,A,골목상권,1001007,천호대로219길,944,582,362
2018,1,A,골목상권,1001006,천호대로197길,26,9,17
2018,1,A,골목상권,1001005,천호대로187길,901,517,384
2018,1,A,골목상권,1001004,천호대로170길,238,139,99
2018,1,A,골목상권,1001003,천호대로162길,1317,836,481
2018,1,A,골목상권,1001002,천중로51길,425,218,207
2018,1,A,골목상권,1001001,천중로39길,618,221,397
2018,1,A,골목상권,1001000,진황도로47길,1425,676,749
2018,1,A,골목상권,1000999,진황도로27길,566,296,270
2018,1,A,골목상권,1000998,올림픽로98길,39,15,24
2018,1,A,골목상권,1000995,올림픽로77길,16,8,8
2018,1,A,골목상권,1000994,올림픽로71길,347,264,83
2018,1,A,골목상권,1000993,올림픽로48길,6401,3825,2576
2018,1,A,골목상권,1000992,양재대로96길,1337,819,518
2018,1,A,골목상권,1000991,양재대로95길,674,357,317
2018,1,A,골목상권,1000990,양재대로91길,1137,613,524
2018,1,A,골목상권,1000989,양재대로133길,319,117,202
2018,1,A,골목상권,1000988,양재대로124길,591,355,236
2018,1,A,골목상권,1000987,양재대로116길,212,84,128
2018,1,A,골목상권,1000986,양재대로101길,1241,729,512
2018,1,A,골목상권,1000985,암사길,383,174,209
2018,1,A,골목상권,1000984,성안로3길,1386,814,572
2018,1,A,골목상권,1000983,성내로5길,1119,569,550
2018,1,A,골목상권,1000982,상일로5길,42,24,18
2018,1,A,골목상권,1000981,상암로5길,583,262,321
2018,1,A,골목상권,1000980,상암로51길,763,324,439
2018,1,A,골목상권,1000979,상암로4길,373,272,101
2018,1,A,골목상권,1000978,상암로14길,462,280,182
2018,1,A,골목상권,1000977,명일로13길,108,48,60
2018,1,A,골목상권,1000976,동남로85길,119,65,54
2018,1,A,골목상권,1000975,동남로82길,10,4,6
2018,1,A,골목상권,1000974,동남로65길,69,20,49
2018,1,A,골목상권,1000973,구천면로42길,354,181,173
2018,1,A,골목상권,1000972,구천면로41길,605,253,352
2018,1,A,골목상권,1000971,구천면로36길,41,25,16
2018,1,A,골목상권,1000969,고덕로25길,26,14,12
2018,1,A,골목상권,1000968,고덕로10길,170,73,97
2018,1,A,골목상권,1000967,강동대로53길,928,517,411
2018,1,A,골목상권,1000966,풍성로25길,775,273,502
2018,1,A,골목상권,1000965,오금로46길,1459,729,730
2018,1,A,골목상권,1000964,오금로36길,1185,867,318
2018,1,A,골목상권,1000963,오금로11길,2097,1358,739
2018,1,A,골목상권,1000962,양재대로72길,650,329,321
2018,1,A,골목상권,1000961,양재대로71길,1394,853,541
2018,1,A,골목상권,1000960,양재대로64길,1481,630,851
2018,1,A,골목상권,1000959,양재대로62길,6569,4083,2486
2018,1,A,골목상권,1000958,송파대로30길,1626,999,627
2018,1,A,골목상권,1000957,송이로36길,1978,1402,576
2018,1,A,골목상권,1000956,송이로32길,714,391,323
2018,1,A,골목상권,1000955,송이로23길,1340,819,521
2018,1,A,골목상권,1000954,삼전로13길,1668,798,870
2018,1,A,골목상권,1000953,백제고분로50길,1460,888,572
2018,1,A,골목상권,1000952,백제고분로46길,1610,943,667
2018,1,A,골목상권,1000951,백제고분로45길,480,304,176
2018,1,A,골목상권,1000950,백제고분로42길,131,76,55
2018,1,A,골목상권,1000949,백제고분로39길,1770,1237,533
2018,1,A,골목상권,1000948,백제고분로34길,1529,968,561
2018,1,A,골목상권,1000947,백제고분로33길,1092,693,399
2018,1,A,골목상권,1000946,백제고분로32길,1072,482,590
2018,1,A,골목상권,1000945,백제고분로31길,340,179,161
2018,1,A,골목상권,1000944,백제고분로22길,1236,734,502
2018,1,A,골목상권,1000943,백제고분로21길,199,141,58
2018,1,A,골목상권,1000942,마천로51길,148,58,90
2018,1,A,골목상권,1000941,동남로20길,134,72,62
2018,1,A,골목상권,1000940,거마로20길,515,216,299
2018,1,A,골목상권,1000939,학동로77길,2940,1524,1416
2018,1,A,골목상권,1000938,학동로6길,1854,911,943
2018,1,A,골목상권,1000937,학동로56길,921,476,445
2018,1,A,골목상권,1000936,학동로38길,7344,4204,3140
2018,1,A,골목상권,1000935,테헤란로81길,570,224,346
2018,1,A,골목상권,1000934,일원로9길,542,311,231
2018,1,A,골목상권,1000933,일원로3길,221,107,114
2018,1,A,골목상권,1000932,영동대로65길,3282,1972,1310
2018,1,A,골목상권,1000931,영동대로112길,605,383,222
2018,1,A,골목상권,1000930,언주로81길,8479,4618,3861
2018,1,A,골목상권,1000929,압구정로2길,2657,1444,1213
2018,1,A,골목상권,1000928,선릉로18길,414,227,187
2018,1,A,골목상권,1000927,선릉로146길,1927,1023,904
2018,1,A,골목상권,1000926,선릉로133길,234,127,107
2018,1,A,골목상권,1000925,선릉로132길,1008,567,441
2018,1,A,골목상권,1000924,선릉로121길,1883,960,923
2018,1,A,골목상권,1000923,삼성로75길,2726,1519,1207
2018,1,A,골목상권,1000922,삼성로69길,328,167,161
2018,1,A,골목상권,1000921,삼성로64길,488,241,247
2018,1,A,골목상권,1000920,삼성로63길,225,99,126
2018,1,A,골목상권,1000919,삼성로57길,822,262,560
2018,1,A,골목상권,1000918,삼성로147길,981,390,591
2018,1,A,골목상권,1000917,삼성로115길,264,159,105
2018,1,A,골목상권,1000916,봉은사로68길,214,99,115
2018,1,A,골목상권,1000915,봉은사로57길,1063,663,400
2018,1,A,골목상권,1000914,봉은사로43길,1059,681,378
2018,1,A,골목상권,1000913,봉은사로29길,136,92,44
2018,1,A,골목상권,1000912,봉은사로109길,332,169,163
2018,1,A,골목상권,1000911,도산대로89길,2437,913,1524
2018,1,A,골목상권,1000910,도산대로81길,4309,1403,2906
2018,1,A,골목상권,1000909,도산대로50길,2752,1904,848
2018,1,A,골목상권,1000908,도산대로38길,160,89,71
2018,1,A,골목상권,1000907,도산대로30길,3166,1543,1623
2018,1,A,골목상권,1000906,도산대로23길,1335,830,505
2018,1,A,골목상권,1000905,도산대로15길,1643,744,899
2018,1,A,골목상권,1000904,도곡로37길,4042,2193,1849
2018,1,A,골목상권,1000903,논현로8길,787,438,349
2018,1,A,골목상권,1000902,논현로63길,12527,3369,9158
2018,1,A,골목상권,1000901,논현로28길,10312,7066,3246
2018,1,A,골목상권,1000900,논현로26길,7756,5083,2673
2018,1,A,골목상권,1000898,논현로139길,2712,1293,1419
2018,1,A,골목상권,1000897,논현로123길,102,64,38
2018,1,A,골목상권,1000896,논현로115길,2832,1478,1354
2018,1,A,골목상권,1000895,논현로10길,2555,1682,873
2018,1,A,골목상권,1000894,논현로106길,2682,1583,1099
2018,1,A,골목상권,1000893,남부순환로365길,173,122,51
2018,1,A,골목상권,1000891,개포로28길,282,187,95
2018,1,A,골목상권,1000890,개포로20길,4058,2238,1820
2018,1,A,골목상권,1000889,개포로17길,2690,1706,984
2018,1,A,골목상권,1000888,강남대로140길,4108,2093,2015
2018,1,A,골목상권,1000887,강남대로136길,1291,725,566
2018,1,A,골목상권,1000886,강남대로118길,626,328,298
2018,1,A,골목상권,1000885,서초중앙로8길,7043,5231,1812
2018,1,A,골목상권,1000884,방배중앙로21길,1254,641,613
2018,1,A,골목상권,1000883,효령로72길,192,107,85
2018,1,A,골목상권,1000882,효령로34길,32,27,5
2018,1,A,골목상권,1000881,효령로31길,1346,733,613
2018,1,A,골목상권,1000880,효령로23길,707,416,291
2018,1,A,골목상권,1000879,청두곶길,2085,1320,765
2018,1,A,골목상권,1000878,주흥길,328,212,116
2018,1,A,골목상권,1000877,주흥15길,1413,917,496
2018,1,A,골목상권,1000876,언남길,1692,1150,542
2018,1,A,골목상권,1000875,신반포로45길,438,274,164
2018,1,A,골목상권,1000874,서초대로8길,255,141,114
2018,1,A,골목상권,1000873,서초대로64길,534,370,164
2018,1,A,골목상권,1000872,서초대로4길,659,488,171
2018,1,A,골목상권,1000871,서초대로25길,3516,2058,1458
2018,1,A,골목상권,1000870,서초대로23길,579,344,235
2018,1,A,골목상권,1000869,서초대로15길,1479,682,797
2018,1,A,골목상권,1000868,사평대로57길,169,68,101
2018,1,A,골목상권,1000867,사평대로26길,14,9,5
2018,1,A,골목상권,1000866,사평대로22길,1423,834,589
2018,1,A,골목상권,1000865,사임당로17길,1806,1055,751
2018,1,A,골목상권,1000864,방배로42길,153,80,73
2018,1,A,골목상권,1000863,방배로35길,2322,1472,850
2018,1,A,골목상권,1000862,방배로18길,91,46,45
2018,1,A,골목상권,1000861,반포대로9길,663,399,264
2018,1,A,골목상권,1000860,바우뫼로39길,2109,1328,781
2018,1,A,골목상권,1000859,마방로2길,3784,2370,1414
2018,1,A,골목상권,1000858,방배천로4안길,1289,831,458
2018,1,A,골목상권,1000857,동산로19길,1312,874,438
2018,1,A,골목상권,1000856,동산로10길,2832,1533,1299
2018,1,A,골목상권,1000855,동광로39길,45,28,17
2018,1,A,골목상권,1000854,동광로1길,1211,717,494
2018,1,A,골목상권,1000853,동광로12길,778,503,275
2018,1,A,골목상권,1000852,논현로27길,3605,2527,1078
2018,1,A,골목상권,1000851,논현로1길,555,360,195
2018,1,A,골목상권,1000850,남부순환로339길,13231,5774,7457
2018,1,A,골목상권,1000849,남부순환로325길,8081,3910,4171
2018,1,A,골목상권,1000848,남부순환로317길,1704,1181,523
2018,1,A,골목상권,1000847,고무래로8길,6567,3390,3177
2018,1,A,골목상권,1000846,강남대로8길,2653,1587,1066
2018,1,A,골목상권,1000845,강남대로34길,1036,663,373
2018,1,A,골목상권,1000844,강남대로23길,6445,4474,1971
2018,1,A,골목상권,1000843,소담길,27,7,20
2018,1,A,골목상권,1000842,원신길,295,114,181
2018,1,A,골목상권,1000840,양산길,342,241,101
2018,1,A,골목상권,1000839,호암로24길,655,251,404
2018,1,A,골목상권,1000838,호암로20길,40,27,13
2018,1,A,골목상권,1000837,행운길,21,5,16
2018,1,A,골목상권,1000836,행운1길,101,72,29
2018,1,A,골목상권,1000835,청림3길,79,39,40
2018,1,A,골목상권,1000834,청룡길,84,43,41
2018,1,A,골목상권,1000833,청룡8길,7,3,4
2018,1,A,골목상권,1000832,중앙길,257,99,158
2018,1,A,골목상권,1000831,조원중앙로2길,1156,837,319
2018,1,A,골목상권,1000830,조원로18길,1045,558,487
2018,1,A,골목상권,1000829,조원로10길,266,124,142
2018,1,A,골목상권,1000828,장군봉2길,215,114,101
2018,1,A,골목상권,1000827,장군봉1길,86,14,72
2018,1,A,골목상권,1000826,인헌길,88,50,38
2018,1,A,골목상권,1000825,은천로25길,280,89,191
2018,1,A,골목상권,1000824,양녕로6길,868,500,368
2018,1,A,골목상권,1000823,신원로3길,27,19,8
2018,1,A,골목상권,1000822,신사로20길,34,10,24
2018,1,A,골목상권,1000820,신림로64길,237,107,130
2018,1,A,골목상권,1000819,신림로48길,74,36,38
2018,1,A,골목상권,1000818,신림로38길,60,32,28
2018,1,A,골목상권,1000817,신림로28길,314,218,96
2018,1,A,골목상권,1000816,신림로11길,453,412,41
2018,1,A,골목상권,1000815,신림동길,371,223,148
2018,1,A,골목상권,1000814,승방길,573,372,201
2018,1,A,골목상권,1000813,서림7길,283,106,177
2018,1,A,골목상권,1000812,봉천로33길,350,226,124
2018,1,A,골목상권,1000811,봉천로13길,314,88,226
2018,1,A,골목상권,1000810,복은길,164,61,103
2018,1,A,골목상권,1000808,법원단지9길,91,40,51
2018,1,A,골목상권,1000807,미성5길,72,39,33
2018,1,A,골목상권,1000806,대학길,81,34,47
2018,1,A,골목상권,1000805,대학14길,12,3,9
2018,1,A,골목상권,1000804,당곡길,383,198,185
2018,1,A,골목상권,1000803,남현길,225,80,145
2018,1,A,골목상권,1000802,남현3길,400,253,147
2018,1,A,골목상권,1000800,남부순환로248길,234,118,116
2018,1,A,골목상권,1000799,남부순환로234길,132,87,45
2018,1,A,골목상권,1000798,남부순환로172길,1398,778,620
2018,1,A,골목상권,1000797,남부순환로161길,30,12,18
2018,1,A,골목상권,1000796,남부순환로151길,185,133,52
2018,1,A,골목상권,1000795,남부순환로142길,74,35,39
2018,1,A,골목상권,1000794,난향길,168,41,127
2018,1,A,골목상권,1000793,난우길,415,160,255
2018,1,A,골목상권,1000792,난곡로74길,135,62,73
2018,1,A,골목상권,1000791,난곡로34길,24,8,16
2018,1,A,골목상권,1000790,난곡로26길,131,51,80
2018,1,A,골목상권,1000789,난곡로24길,32,17,15
2018,1,A,골목상권,1000788,낙성대역길,689,437,252
2018,1,A,골목상권,1000787,국회단지길,545,258,287
2018,1,A,골목상권,1000786,구암길,72,26,46
2018,1,A,골목상권,1000785,관천로22길,23,9,14
2018,1,A,골목상권,1000784,관천로15길,137,73,64
2018,1,A,골목상권,1000783,관악로30길,185,63,122
2018,1,A,골목상권,1000782,관악로28길,145,67,78
2018,1,A,골목상권,1000781,관악로14길,443,241,202
2018,1,A,골목상권,1000780,관악로10길,227,159,68
2018,1,A,골목상권,1000779,흑석로9길,186,88,98
2018,1,A,골목상권,1000778,흑석로13길,132,10,122
2018,1,A,골목상권,1000777,장승배기로27길,37,18,19
2018,1,A,골목상권,1000776,장승배기로19길,7,4,3
2018,1,A,골목상권,1000774,여의대방로46길,474,150,324
2018,1,A,골목상권,1000773,여의대방로24길,17503,8680,8823
2018,1,A,골목상권,1000772,여의대방로22카길,289,115,174
2018,1,A,골목상권,1000771,여의대방로22나길,138,57,81
2018,1,A,골목상권,1000770,여의대방로22길,214,120,94
2018,1,A,골목상권,1000769,양녕로26길,129,60,69
2018,1,A,골목상권,1000768,신대방길,107,68,39
2018,1,A,골목상권,1000767,성대로29길,2,2,0
2018,1,A,골목상권,1000766,성대로1길,315,130,185
2018,1,A,골목상권,1000765,서달로8가길,264,104,160
2018,1,A,골목상권,1000763,서달로14길,30,12,18
2018,1,A,골목상권,1000762,서달로10길,58,28,30
2018,1,A,골목상권,1000761,상도로62길,191,58,133
2018,1,A,골목상권,1000760,상도로61길,46,19,27
2018,1,A,골목상권,1000759,상도로47길,55,41,14
2018,1,A,골목상권,1000758,상도로37길,1918,938,980
2018,1,A,골목상권,1000757,상도로15길,330,144,186
2018,1,A,골목상권,1000756,사당로8길,118,64,54
2018,1,A,골목상권,1000755,사당로30길,314,211,103
2018,1,A,골목상권,1000754,사당로2차길,118,81,37
2018,1,A,골목상권,1000753,사당로29길,16,13,3
2018,1,A,골목상권,1000752,사당로26길,268,149,119
2018,1,A,골목상권,1000751,사당로23나길,130,39,91
2018,1,A,골목상권,1000750,사당로23길,13,9,4
2018,1,A,골목상권,1000749,사당로20길,194,144,50
2018,1,A,골목상권,1000748,사당로16길,136,41,95
2018,1,A,골목상권,1000747,사당로16가길,716,461,255
2018,1,A,골목상권,1000746,만양로8길,86,40,46
2018,1,A,골목상권,1000745,만양로14길,328,143,185
2018,1,A,골목상권,1000744,등용로14길,678,460,218
2018,1,A,골목상권,1000743,동작대로7길,1712,644,1068
2018,1,A,골목상권,1000742,동작대로35길,895,120,775
2018,1,A,골목상권,1000741,동작대로33길,116,63,53
2018,1,A,골목상권,1000740,동작대로29길,32,18,14
2018,1,A,골목상권,1000739,동작대로17길,1411,718,693
2018,1,A,골목상권,1000738,대방동2길,462,215,247
2018,1,A,골목상권,1000737,대방동27길,107,61,46
2018,1,A,골목상권,1000736,노량진로6길,107,28,79
2018,1,A,골목상권,1000735,국사봉길,38,6,32
2018,1,A,골목상권,1000734,국사봉2길,53,19,34
2018,1,A,골목상권,1000733,국사봉1길,7,3,4
2018,1,A,골목상권,1000732,영신로9길,333,176,157
2018,1,A,골목상권,1000731,영등포로84길,406,96,310
2018,1,A,골목상권,1000730,영등포로80길,52,24,28
2018,1,A,골목상권,1000729,영등포로62길,2,2,0
2018,1,A,골목상권,1000728,영등포로35길,89,56,33
2018,1,A,골목상권,1000727,영등포로27길,323,187,136
2018,1,A,골목상권,1000724,여의대방로43나길,2158,1708,450
2018,1,A,골목상권,1000723,여의대방로39길,14,10,4
2018,1,A,골목상권,1000722,여의대방로35길,817,426,391
2018,1,A,골목상권,1000721,양평로28길,599,470,129
2018,1,A,골목상권,1000720,양평로22라길,29,14,15
2018,1,A,골목상권,1000719,양평로19길,4405,3439,966
2018,1,A,골목상권,1000718,신길로60길,497,184,313
2018,1,A,골목상권,1000717,신길로42길,377,174,203
2018,1,A,골목상권,1000716,신길로42가길,101,36,65
2018,1,A,골목상권,1000715,신길로39길,112,49,63
2018,1,A,골목상권,1000714,신길로17길,48,33,15
2018,1,A,골목상권,1000713,선유서로28길,389,212,177
2018,1,A,골목상권,1000712,선유서로25길,2516,1819,697
2018,1,A,골목상권,1000711,선유서로24길,134,78,56
2018,1,A,골목상권,1000710,선유로55길,2446,1497,949
2018,1,A,골목상권,1000709,디지털로74길,46,28,18
2018,1,A,골목상권,1000708,디지털로57길,6,3,3
2018,1,A,골목상권,1000707,디지털로37길,211,93,118
2018,1,A,골목상권,1000706,도신로62길,184,57,127
2018,1,A,골목상권,1000705,도신로60길,74,12,62
2018,1,A,골목상권,1000704,도신로29길,85,38,47
2018,1,A,골목상권,1000703,도신로15길,80,39,41
2018,1,A,골목상권,1000702,도림천로21길,77,33,44
2018,1,A,골목상권,1000701,도림로63길,37,26,11
2018,1,A,골목상권,1000700,도림로147길,1709,1243,466
2018,1,A,골목상권,1000699,도림로112길,14,12,2
2018,1,A,골목상권,1000698,대림로8길,1839,589,1250
2018,1,A,골목상권,1000697,대림로7길,9,5,4
2018,1,A,골목상권,1000696,대림로44길,25,15,10
2018,1,A,골목상권,1000695,대림로34길,188,76,112
2018,1,A,골목상권,1000694,대림로31길,1043,548,495
2018,1,A,골목상권,1000693,대림로29길,1681,800,881
2018,1,A,골목상권,1000692,대림로22길,361,200,161
2018,1,A,골목상권,1000691,당산로46길,4479,2666,1813
2018,1,A,골목상권,1000690,당산로38길,172,114,58
2018,1,A,골목상권,1000689,당산로37길,3971,2595,1376
2018,1,A,골목상권,1000688,당산로31길,4319,2309,2010
2018,1,A,골목상권,1000687,국회대로56길,1675,1079,596
2018,1,A,골목상권,1000686,경인로90길,323,182,141
2018,1,A,골목상권,1000685,경인로80길,1545,1091,454
2018,1,A,골목상권,1000684,경인로77길,697,450,247
2018,1,A,골목상권,1000683,가마산로61길,196,71,125
2018,1,A,골목상권,1000682,시흥대로94길,687,346,341
2018,1,A,골목상권,1000681,시흥대로84길,186,76,110
2018,1,A,골목상권,1000680,시흥대로68길,751,201,550
2018,1,A,골목상권,1000679,시흥대로63길,2941,1455,1486
2018,1,A,골목상권,1000678,시흥대로62가길,437,116,321
2018,1,A,골목상권,1000677,시흥대로36길,386,228,158
2018,1,A,골목상권,1000676,시흥대로22길,478,332,146
2018,1,A,골목상권,1000675,시흥대로153길,664,384,280
2018,1,A,골목상권,1000674,시흥대로150길,537,249,288
2018,1,A,골목상권,1000673,시흥대로141길,656,389,267
2018,1,A,골목상권,1000672,시흥대로138길,18,10,8
2018,1,A,골목상권,1000671,시흥대로120길,501,323,178
2018,1,A,골목상권,1000670,벚꽃로56길,1863,1315,548
2018,1,A,골목상권,1000669,범안로17길,145,86,59
2018,1,A,골목상권,1000668,범안로11길,1095,859,236
2018,1,A,골목상권,1000667,문성로5길,162,51,111
2018,1,A,골목상권,1000666,독산로85길,93,24,69
2018,1,A,골목상권,1000665,독산로78다길,219,93,126
2018,1,A,골목상권,1000664,독산로70길,2,2,0
2018,1,A,골목상권,1000663,독산로64길,114,28,86
2018,1,A,골목상권,1000662,독산로50길,93,37,56
2018,1,A,골목상권,1000661,독산로40길,53,19,34
2018,1,A,골목상권,1000660,독산로108길,715,340,375
2018,1,A,골목상권,1000659,남부순환로112길,9,4,5
2018,1,A,골목상권,1000658,금하로24길,205,66,139
2018,1,A,골목상권,1000657,금하로1길,70,32,38
2018,1,A,골목상권,1000656,금하로14길,21,8,13
2018,1,A,골목상권,1000655,가산로5길,592,465,127
2018,1,A,골목상권,1000654,가산로3길,2351,1800,551
2018,1,A,골목상권,1000653,중앙로1길,1508,1058,450
2018,1,A,골목상권,1000652,중앙로15길,89,42,47
2018,1,A,골목상권,1000651,우마길,35,21,14
2018,1,A,골목상권,1000650,오류로8길,210,97,113
2018,1,A,골목상권,1000649,신도림로13길,779,581,198
2018,1,A,골목상권,1000648,새말로18길,1067,442,625
2018,1,A,골목상권,1000647,부일로1길,759,607,152
2018,1,A,골목상권,1000646,부일로15길,182,150,32
2018,1,A,골목상권,1000645,부일로11길,27,7,20
2018,1,A,골목상권,1000644,디지털로32길,1101,565,536
2018,1,A,골목상권,1000643,디지털로32가길,7234,4978,2256
2018,1,A,골목상권,1000642,디지털로27길,388,250,138
2018,1,A,골목상권,1000641,도림로6길,114,48,66
2018,1,A,골목상권,1000640,도림로12길,97,37,60
2018,1,A,골목상권,1000639,남부순환로97길,269,86,183
2018,1,A,골목상권,1000638,구로중앙로8길,214,76,138
2018,1,A,골목상권,1000637,구로중앙로7길,192,70,122
2018,1,A,골목상권,1000636,구로중앙로42길,806,605,201
2018,1,A,골목상권,1000635,구로중앙로34길,563,323,240
2018,1,A,골목상권,1000634,구로중앙로28길,3163,1519,1644
2018,1,A,골목상권,1000633,구로중앙로19길,10,6,4
2018,1,A,골목상권,1000632,구로동로8길,140,41,99
2018,1,A,골목상권,1000631,구로동로7길,168,62,106
2018,1,A,골목상권,1000630,구로동로42길,21,14,7
2018,1,A,골목상권,1000629,구로동로41길,447,282,165
2018,1,A,골목상권,1000628,구로동로38길,36,14,22
2018,1,A,골목상권,1000627,구로동로28길,197,90,107
2018,1,A,골목상권,1000626,구로동로15길,25,4,21
2018,1,A,골목상권,1000625,공원로6가길,292,200,92
2018,1,A,골목상권,1000624,고척로52길,221,62,159
2018,1,A,골목상권,1000623,고척로27다길,210,79,131
2018,1,A,골목상권,1000622,고척로27길,241,111,130
2018,1,A,골목상권,1000621,고척로21나길,214,54,160
2018,1,A,골목상권,1000620,경인로47길,915,509,406
2018,1,A,골목상권,1000619,경인로35길,287,116,171
2018,1,A,골목상권,1000618,경인로31길,54,19,35
2018,1,A,골목상권,1000617,경인로15길,149,65,84
2018,1,A,골목상권,1000616,개봉로3길,260,168,92
2018,1,A,골목상권,1000615,개봉로2길,487,134,353
2018,1,A,골목상권,1000614,개봉로23가길,837,480,357
2018,1,A,골목상권,1000613,개봉로20길,130,74,56
2018,1,A,골목상권,1000612,개봉로1길,52,26,26
2018,1,A,골목상권,1000611,개봉로17다길,191,96,95
2018,1,A,골목상권,1000610,개봉로17길,870,357,513
2018,1,A,골목상권,1000609,개봉로11길,43,6,37
2018,1,A,골목상권,1000608,화곡로64길,1606,921,685
2018,1,A,골목상권,1000607,화곡로59길,478,198,280
2018,1,A,골목상권,1000606,화곡로44나길,804,678,126
2018,1,A,골목상권,1000605,화곡로31길,1174,448,726
2018,1,A,골목상권,1000604,화곡로20길,503,316,187
2018,1,A,골목상권,1000603,화곡로13길,272,95,177
2018,1,A,골목상권,1000602,초원로16길,669,284,385
2018,1,A,골목상권,1000601,초록마을로8길,177,37,140
2018,1,A,골목상권,1000600,초록마을로3길,45,22,23
2018,1,A,골목상권,1000599,월정로20길,4,2,2
2018,1,A,골목상권,1000598,우장산로6길,315,176,139
2018,1,A,골목상권,1000597,양천로73가길,1307,828,479
2018,1,A,골목상권,1000596,양천로71길,215,133,82
2018,1,A,골목상권,1000595,양천로49길,735,574,161
2018,1,A,골목상권,1000594,양천로26길,163,73,90
2018,1,A,골목상권,1000593,양천로24길,360,147,213
2018,1,A,골목상권,1000592,양천로24가길,735,347,388
2018,1,A,골목상권,1000591,양천로14길,239,142,97
2018,1,A,골목상권,1000590,방화대로6라길,782,487,295
2018,1,A,골목상권,1000589,방화대로21길,860,515,345
2018,1,A,골목상권,1000588,등촌로5길,10,3,7
2018,1,A,골목상권,1000587,등촌로55길,519,354,165
2018,1,A,골목상권,1000586,등촌로51길,16,10,6
2018,1,A,골목상권,1000585,등촌로39길,69,26,43
2018,1,A,골목상권,1000584,등촌로13길,195,103,92
2018,1,A,골목상권,1000583,남부순환로11길,413,280,133
2018,1,A,골목상권,1000582,까치산로4길,149,59,90
2018,1,A,골목상권,1000581,국회대로7길,396,235,161
2018,1,A,골목상권,1000580,공항대로8길,201,76,125
2018,1,A,골목상권,1000579,공항대로61길,203,137,66
2018,1,A,골목상권,1000578,공항대로59다길,925,664,261
2018,1,A,골목상권,1000577,공항대로59길,1120,726,394
2018,1,A,골목상권,1000576,공항대로55길,1086,726,360
2018,1,A,골목상권,1000575,공항대로42길,9,5,4
2018,1,A,골목상권,1000574,공항대로38길,271,143,128
2018,1,A,골목상권,1000573,곰달래로60길,554,298,256
2018,1,A,골목상권,1000572,곰달래로53길,60,18,42
2018,1,A,골목상권,1000571,곰달래로47길,40,15,25
2018,1,A,골목상권,1000570,곰달래로31길,9,7,2
2018,1,A,골목상권,1000569,곰달래로25길,778,273,505
2018,1,A,골목상권,1000568,개화동로25길,657,431,226
2018,1,A,골목상권,1000567,개화동로23길,128,86,42
2018,1,A,골목상권,1000566,강서로8길,150,80,70
2018,1,A,골목상권,1000565,강서로5라길,303,182,121
2018,1,A,골목상권,1000564,강서로5나길,100,57,43
2018,1,A,골목상권,1000563,강서로5가길,48,25,23
2018,1,A,골목상권,1000562,강서로47라길,121,56,65
2018,1,A,골목상권,1000561,강서로47길,379,202,177
2018,1,A,골목상권,1000560,강서로45다길,539,349,190
2018,1,A,골목상권,1000559,강서로45길,141,59,82
2018,1,A,골목상권,1000558,강서로35길,173,99,74
2018,1,A,골목상권,1000557,강서로29길,386,171,215
2018,1,A,골목상권,1000556,강서로18길,28,12,16
2018,1,A,골목상권,1000555,강서로17가길,120,52,68
2018,1,A,골목상권,1000554,강서로15길,303,146,157
2018,1,A,골목상권,1000553,가로공원로80길,48,23,25
2018,1,A,골목상권,1000552,가로공원로76가길,24,10,14
2018,1,A,골목상권,1000551,화곡로4길,235,86,149
2018,1,A,골목상권,1000550,화곡로3길,163,57,106
2018,1,A,골목상권,1000549,지양로7길,223,73,150
2018,1,A,골목상권,1000548,중앙로55길,367,190,177
2018,1,A,골목상권,1000547,중앙로51길,141,86,55
2018,1,A,골목상권,1000546,중앙로47길,120,25,95
2018,1,A,골목상권,1000545,중앙로45길,155,53,102
2018,1,A,골목상권,1000544,중앙로36길,2,2,0
2018,1,A,골목상권,1000543,중앙로32길,607,294,313
2018,1,A,골목상권,1000542,중앙로25길,240,64,176
2018,1,A,골목상권,1000541,은행정로7길,495,169,326
2018,1,A,골목상권,1000539,오목로5길,311,185,126
2018,1,A,골목상권,1000538,오목로3길,401,377,24
2018,1,A,골목상권,1000537,오목로30길,140,73,67
2018,1,A,골목상권,1000536,오목로23길,790,464,326
2018,1,A,골목상권,1000535,신월로20길,215,78,137
2018,1,A,골목상권,1000534,신월로15길,767,357,410
2018,1,A,골목상권,1000533,신목로6길,240,132,108
2018,1,A,골목상권,1000532,신목로5길,871,333,538
2018,1,A,골목상권,1000531,신목로2길,104,47,57
2018,1,A,골목상권,1000530,목동중앙서로8가길,190,110,80
2018,1,A,골목상권,1000529,목동중앙서로7길,231,71,160
2018,1,A,골목상권,1000528,목동중앙북로8길,348,115,233
2018,1,A,골목상권,1000527,목동중앙북로16길,257,68,189
2018,1,A,골목상권,1000526,목동중앙본로7길,105,42,63
2018,1,A,골목상권,1000525,목동중앙로3길,119,66,53
2018,1,A,골목상권,1000524,목동중앙로13나길,284,207,77
2018,1,A,골목상권,1000523,목동중앙남로3가길,537,358,179
2018,1,A,골목상권,1000522,목동로9길,2315,1468,847
2018,1,A,골목상권,1000521,목동로19길,987,354,633
2018,1,A,골목상권,1000519,목동동로12길,389,140,249
2018,1,A,골목상권,1000518,목동남로4길,11,5,6
2018,1,A,골목상권,1000517,남부순환로88길,276,124,152
2018,1,A,골목상권,1000516,남부순환로79길,377,284,93
2018,1,A,골목상권,1000515,남부순환로70길,522,314,208
2018,1,A,골목상권,1000514,남부순환로58길,195,118,77
2018,1,A,골목상권,1000513,남부순환로40길,15,6,9
2018,1,A,골목상권,1000512,남부순환로33길,1183,976,207
2018,1,A,골목상권,1000511,곰달래로5길,59,35,24
2018,1,A,골목상권,1000510,곰달래로3길,381,203,178
2018,1,A,골목상권,1000509,곰달래로2길,305,167,138
2018,1,A,골목상권,1000508,곰달래로10길,334,236,98
2018,1,A,골목상권,1000507,가로공원로58길,76,15,61
2018,1,A,골목상권,1000506,효창원로93길,93,47,46
2018,1,A,골목상권,1000505,토정로37길,140,62,78
2018,1,A,골목상권,1000504,월드컵로8길,1788,913,875
2018,1,A,골목상권,1000503,월드컵로7길,4,2,2
2018,1,A,골목상권,1000502,월드컵로36길,144,59,85
2018,1,A,골목상권,1000501,월드컵로25길,278,162,116
2018,1,A,골목상권,1000500,월드컵로19길,568,300,268
2018,1,A,골목상권,1000499,월드컵로16길,4043,2077,1966
2018,1,A,골목상권,1000498,월드컵로11길,240,91,149
2018,1,A,골목상권,1000497,월드컵로10길,1716,908,808
2018,1,A,골목상권,1000496,와우산로3길,181,104,77
2018,1,A,골목상권,1000495,와우산로29길,178,94,84
2018,1,A,골목상권,1000494,와우산로29가길,18,9,9
2018,1,A,골목상권,1000493,양화진길,509,361,148
2018,1,A,골목상권,1000492,양화로1길,4158,1962,2196
2018,1,A,골목상권,1000491,양화로11길,440,292,148
2018,1,A,골목상권,1000490,신촌로30길,26,17,9
2018,1,A,골목상권,1000489,신촌로28가길,102,39,63
2018,1,A,골목상권,1000488,신촌로12길,1467,665,802
2018,1,A,골목상권,1000487,숭문길,5265,4008,1257
2018,1,A,골목상권,1000486,숭문8길,116,69,47
2018,1,A,골목상권,1000485,성지3길,485,232,253
2018,1,A,골목상권,1000484,성산로4길,1686,1028,658
2018,1,A,골목상권,1000483,성미산로32길,403,203,200
2018,1,A,골목상권,1000482,성미산로1길,638,462,176
2018,1,A,골목상권,1000481,성미산로11길,1042,709,333
2018,1,A,골목상권,1000480,백범로16길,745,375,370
2018,1,A,골목상권,1000479,방울내로9안길,323,196,127
2018,1,A,골목상권,1000478,모래내로7길,263,127,136
2018,1,A,골목상권,1000477,매봉산로2길,1597,970,627
2018,1,A,골목상권,1000476,망원로2길,242,145,97
2018,1,A,골목상권,1000475,망원로11길,1105,624,481
2018,1,A,골목상권,1000474,만리재옛길,1433,618,815
2018,1,A,골목상권,1000473,마포대로4길,176,93,83
2018,1,A,골목상권,1000472,마포대로20길,1147,601,546
2018,1,A,골목상권,1000471,마포대로12길,68,36,32
2018,1,A,골목상권,1000470,동교로38길,238,123,115
2018,1,A,골목상권,1000469,동교로27길,3408,1524,1884
2018,1,A,골목상권,1000468,동교로25길,545,252,293
2018,1,A,골목상권,1000467,동교로19길,4191,2771,1420
2018,1,A,골목상권,1000466,동교로17길,732,371,361
2018,1,A,골목상권,1000465,독막로8길,319,141,178
2018,1,A,골목상권,1000464,독막로32길,479,207,272
2018,1,A,골목상권,1000463,독막로22길,108,61,47
2018,1,A,골목상권,1000462,도화길,1004,502,502
2018,1,A,골목상권,1000461,도화4길,401,135,266
2018,1,A,골목상권,1000460,대흥로28길,48,41,7
2018,1,A,골목상권,1000459,대흥로21길,458,83,375
2018,1,A,골목상권,1000458,광성로6길,160,102,58
2018,1,A,골목상권,1000457,홍제내길,119,67,52
2018,1,A,골목상권,1000456,홍연길,85,49,36
2018,1,A,골목상권,1000455,통일로39길,5,5,0
2018,1,A,골목상권,1000454,통일로37길,352,129,223
2018,1,A,골목상권,1000453,통일로11길,10,8,2
2018,1,A,골목상권,1000452,충정로6길,13125,8089,5036
2018,1,A,골목상권,1000451,충정로4길,3103,2037,1066
2018,1,A,골목상권,1000450,증가로6길,215,104,111
2018,1,A,골목상권,1000449,증가로23나길,485,254,231
2018,1,A,골목상권,1000448,증가로20가길,253,93,160
2018,1,A,골목상권,1000447,증가로10길,160,80,80
2018,1,A,골목상권,1000446,응암로1길,384,277,107
2018,1,A,골목상권,1000445,연희로10길,114,75,39
2018,1,A,골목상권,1000444,신촌로37길,101,50,51
2018,1,A,골목상권,1000443,수색로8길,2820,2621,199
2018,1,A,골목상권,1000442,세무서길,328,110,218
2018,1,A,골목상권,1000440,세검정로1길,415,181,234
2018,1,A,골목상권,1000439,북아현로4길,430,93,337
2018,1,A,골목상권,1000438,모래내로15길,106,33,73
2018,1,A,골목상권,1000437,명지대길,402,289,113
2018,1,A,골목상권,1000436,독립문로8길,732,278,454
2018,1,A,골목상권,1000435,가재울로6길,20,12,8
2018,1,A,골목상권,1000434,통일로92길,86,35,51
2018,1,A,골목상권,1000433,통일로87길,203,90,113
2018,1,A,골목상권,1000432,통일로78길,224,65,159
2018,1,A,골목상권,1000430,진흥로1길,523,162,361
2018,1,A,골목상권,1000429,진흥로12길,502,208,294
2018,1,A,골목상권,1000428,증산서길,397,278,119
2018,1,A,골목상권,1000427,증산로9길,92,29,63
2018,1,A,골목상권,1000426,증산로5길,781,400,381
2018,1,A,골목상권,1000425,증산로21길,238,150,88
2018,1,A,골목상권,1000424,증산로17길,755,298,457
2018,1,A,골목상권,1000423,증산로15길,214,81,133
2018,1,A,골목상권,1000422,증산로13길,73,36,37
2018,1,A,골목상권,1000421,응암로34길,57,36,21
2018,1,A,골목상권,1000420,응암로22길,154,54,100
2018,1,A,골목상권,1000419,응암로14길,371,123,248
2018,1,A,골목상권,1000418,응암로13길,293,121,172
2018,1,A,골목상권,1000417,응암로12길,205,114,91
2018,1,A,골목상권,1000416,은평로8길,245,125,120
2018,1,A,골목상권,1000415,은평로3길,301,95,206
2018,1,A,골목상권,1000414,은평로20길,18,8,10
2018,1,A,골목상권,1000413,은평로13길,375,236,139
2018,1,A,골목상권,1000412,은평로10길,284,128,156
2018,1,A,골목상권,1000411,연서로5길,44,13,31
2018,1,A,골목상권,1000410,연서로41길,240,76,164
2018,1,A,골목상권,1000409,연서로3길,104,40,64
2018,1,A,골목상권,1000408,연서로34길,161,59,102
2018,1,A,골목상권,1000407,연서로33길,30,10,20
2018,1,A,골목상권,1000406,연서로29길,300,101,199
2018,1,A,골목상권,1000405,연서로28길,839,386,453
2018,1,A,골목상권,1000404,연서로27길,80,23,57
2018,1,A,골목상권,1000403,연서로21길,297,167,130
2018,1,A,골목상권,1000402,연서로17길,1188,353,835
2018,1,A,골목상권,1000401,연서로16길,265,98,167
2018,1,A,골목상권,1000400,연서로13길,730,217,513
2018,1,A,골목상권,1000399,연서로11길,234,110,124
2018,1,A,골목상권,1000398,역말로9길,22,15,7
2018,1,A,골목상권,1000397,수색로18길,24,12,12
2018,1,A,골목상권,1000396,서오릉로8길,12,0,12
2018,1,A,골목상권,1000395,서오릉로21길,418,100,318
2018,1,A,골목상권,1000394,불광천길,189,93,96
2018,1,A,골목상권,1000393,갈현로7길,930,257,673
2018,1,A,골목상권,1000392,갈현로41길,95,35,60
2018,1,A,골목상권,1000391,갈현로33길,36,8,28
2018,1,A,골목상권,1000390,갈현로1길,168,74,94
2018,1,A,골목상권,1000389,가좌로7길,68,35,33
2018,1,A,골목상권,1000388,한글비석로44길,405,222,183
2018,1,A,골목상권,1000387,한글비석로24길,407,159,248
2018,1,A,골목상권,1000386,한글비석로22길,706,326,380
2018,1,A,골목상권,1000385,석계로1길,100,61,39
2018,1,A,골목상권,1000384,상계로9가길,291,95,196
2018,1,A,골목상권,1000382,상계로12길,25,15,10
2018,1,A,골목상권,1000381,동일로242길,301,190,111
2018,1,A,골목상권,1000380,동일로192길,469,202,267
2018,1,A,골목상권,1000379,동일로173가길,2329,1258,1071
2018,1,A,골목상권,1000378,공릉로58길,148,45,103
2018,1,A,골목상권,1000377,해등로16길,69,55,14
2018,1,A,골목상권,1000376,우이천로4다길,181,109,72
2018,1,A,골목상권,1000375,우이천로32길,87,53,34
2018,1,A,골목상권,1000374,시루봉로23길,49,21,28
2018,1,A,골목상권,1000373,삼양로144길,80,57,23
2018,1,A,골목상권,1000372,방학로6가길,176,87,89
2018,1,A,골목상권,1000371,방학로5길,137,80,57
2018,1,A,골목상권,1000370,방학로15길,318,204,114
2018,1,A,골목상권,1000369,방학로10길,169,66,103
2018,1,A,골목상권,1000367,도봉산4길,316,277,39
2018,1,A,골목상권,1000366,도봉로181길,188,80,108
2018,1,A,골목상권,1000365,도봉로169나길,290,122,168
2018,1,A,골목상권,1000364,도봉로156길,281,142,139
2018,1,A,골목상권,1000363,도봉로152가길,416,365,51
2018,1,A,골목상권,1000362,도봉로147길,533,308,225
2018,1,A,골목상권,1000360,도봉로114길,514,175,339
2018,1,A,골목상권,1000359,도봉로109길,26,9,17
2018,1,A,골목상권,1000358,도당로29길,863,500,363
2018,1,A,골목상권,1000357,도당로19길,162,72,90
2018,1,A,골목상권,1000356,도당로13바길,188,74,114
2018,1,A,골목상권,1000355,도당로13가길,167,69,98
2018,1,A,골목상권,1000354,덕릉로60길,82,49,33
2018,1,A,골목상권,1000353,노해로63다길,612,258,354
2018,1,A,골목상권,1000352,노해로60길,325,141,184
2018,1,A,골목상권,1000351,한천로140길,103,50,53
2018,1,A,골목상권,1000350,한천로139가길,52,31,21
2018,1,A,골목상권,1000349,한천로132길,321,118,203
2018,1,A,골목상권,1000348,한천로130길,274,113,161
2018,1,A,골목상권,1000347,한천로124나길,111,66,45
2018,1,A,골목상권,1000346,한천로109길,605,259,346
2018,1,A,골목상권,1000345,인수봉로79길,171,44,127
2018,1,A,골목상권,1000344,인수봉로72길,85,40,45
2018,1,A,골목상권,1000342,오패산로67길,579,288,291
2018,1,A,골목상권,1000341,오패산로52길,97,34,63
2018,1,A,골목상권,1000339,수유로12길,250,164,86
2018,1,A,골목상권,1000338,솔샘로65길,506,240,266
2018,1,A,골목상권,1000337,솔매로50길,717,285,432
2018,1,A,골목상권,1000336,솔매로45길,171,84,87
2018,1,A,골목상권,1000335,솔매로41길,87,21,66
2018,1,A,골목상권,1000334,삼양로93길,18,4,14
2018,1,A,골목상권,1000333,삼양로77길,432,149,283
2018,1,A,골목상권,1000332,삼양로54길,8,4,4
2018,1,A,골목상권,1000331,삼양로41길,310,149,161
2018,1,A,골목상권,1000329,삼양로24길,82,39,43
2018,1,A,골목상권,1000328,삼양로20길,127,47,80
2018,1,A,골목상권,1000327,삼각산로28길,823,415,408
2018,1,A,골목상권,1000326,도봉로99길,220,104,116
2018,1,A,골목상권,1000325,도봉로8길,251,192,59
2018,1,A,골목상권,1000324,도봉로76길,397,210,187
2018,1,A,골목상권,1000323,도봉로67길,6,3,3
2018,1,A,골목상권,1000322,도봉로45길,115,70,45
2018,1,A,골목상권,1000321,도봉로18길,374,178,196
2018,1,A,골목상권,1000320,도봉로13길,35,9,26
2018,1,A,골목상권,1000319,덕릉로41길,792,625,167
2018,1,A,골목상권,1000318,덕릉로40길,895,692,203
2018,1,A,골목상권,1000317,노해로33길,34,13,21
2018,1,A,골목상권,1000315,노해로17길,239,69,170
2018,1,A,골목상권,1000314,화랑로40길,172,96,76
2018,1,A,골목상권,1000313,화랑로32길,471,349,122
2018,1,A,골목상권,1000312,화랑로1길,159,85,74
2018,1,A,골목상권,1000311,화랑로19길,498,267,231
2018,1,A,골목상권,1000310,화랑로14길,43,20,23
2018,1,A,골목상권,1000309,화랑로13길,86,44,42
2018,1,A,골목상권,1000308,한천로76길,129,73,56
2018,1,A,골목상권,1000307,한천로101가길,37,23,14
2018,1,A,골목상권,1000306,창경궁로43길,37,23,14
2018,1,A,골목상권,1000305,지봉로20길,98,58,40
2018,1,A,골목상권,1000304,종암로5길,117,80,37
2018,1,A,골목상권,1000303,종암로24가길,303,143,160
2018,1,A,골목상권,1000302,종암로21길,258,48,210
2018,1,A,골목상권,1000301,종암로19길,391,119,272
2018,1,A,골목상권,1000300,종암로16길,86,40,46
2018,1,A,골목상권,1000299,정릉로8길,189,112,77
2018,1,A,골목상권,1000298,정릉로27길,194,86,108
2018,1,A,골목상권,1000296,장위로50길,860,479,381
2018,1,A,골목상권,1000295,장월로1길,345,188,157
2018,1,A,골목상권,1000294,인촌로6길,2937,1680,1257
2018,1,A,골목상권,1000293,인촌로5길,24,2,22
2018,1,A,골목상권,1000292,인촌로24길,216,146,70
2018,1,A,골목상권,1000291,개운사길,3612,2193,1419
2018,1,A,골목상권,1000290,인촌로1길,154,105,49
2018,1,A,골목상권,1000289,인촌로17가길,3260,1162,2098
2018,1,A,골목상권,1000288,오패산로4길,651,204,447
2018,1,A,골목상권,1000287,오패산로3길,1230,713,517
2018,1,A,골목상권,1000286,오패산로19길,42,17,25
2018,1,A,골목상권,1000285,안암로5길,616,385,231
2018,1,A,골목상권,1000284,아리랑로4길,562,213,349
2018,1,A,골목상권,1000283,솔샘로6길,157,72,85
2018,1,A,골목상권,1000282,성북로8길,53,21,32
2018,1,A,골목상권,1000281,삼양로8길,77,51,26
2018,1,A,골목상권,1000280,삼선교로16가길,715,409,306
2018,1,A,골목상권,1000279,삼선교로10다길,100,44,56
2018,1,A,골목상권,1000278,삼선교로10길,280,126,154
2018,1,A,골목상권,1000277,보문로32길,1000,407,593
2018,1,A,골목상권,1000276,보문로31길,706,291,415
2018,1,A,골목상권,1000274,보문로13길,824,511,313
2018,1,A,골목상권,1000273,보국문로16길,371,247,124
2018,1,A,골목상권,1000270,동소문로26가길,217,99,118
2018,1,A,골목상권,1000269,동소문로15길,120,51,69
2018,1,A,골목상권,1000268,동소문로13길,432,224,208
2018,1,A,골목상권,1000267,돌곶이로8길,190,92,98
2018,1,A,골목상권,1000266,돌곶이로41길,47,22,25
2018,1,A,골목상권,1000265,돌곶이로28길,223,137,86
2018,1,A,골목상권,1000264,돌곶이로27길,75,40,35
2018,1,A,골목상권,1000263,돌곶이로22길,125,62,63
2018,1,A,골목상권,1000261,길음로7길,8,5,3
2018,1,A,골목상권,1000260,중랑천로10길,766,392,374
2018,1,A,골목상권,1000259,용마산로94길,441,270,171
2018,1,A,골목상권,1000258,용마산로118길,565,284,281
2018,1,A,골목상권,1000257,용마산로112길,326,132,194
2018,1,A,골목상권,1000256,용마산로100길,425,294,131
2018,1,A,골목상권,1000255,신내로7가길,266,66,200
2018,1,A,골목상권,1000254,사가정로54길,119,35,84
2018,1,A,골목상권,1000253,사가정로42길,86,24,62
2018,1,A,골목상권,1000252,봉화산로56길,578,155,423
2018,1,A,골목상권,1000251,봉화산로4길,386,135,251
2018,1,A,골목상권,1000250,봉화산로30길,326,196,130
2018,1,A,골목상권,1000249,봉우재로33길,96,37,59
2018,1,A,골목상권,1000248,면목로78길,270,151,119
2018,1,A,골목상권,1000247,면목로56길,213,162,51
2018,1,A,골목상권,1000246,면목로55길,354,107,247
2018,1,A,골목상권,1000245,면목로49길,530,173,357
2018,1,A,골목상권,1000244,면목로48길,114,54,60
2018,1,A,골목상권,1000243,면목로45길,60,26,34
2018,1,A,골목상권,1000242,면목로33길,379,149,230
2018,1,A,골목상권,1000241,면목로21길,31,25,6
2018,1,A,골목상권,1000240,망우로73길,8,4,4
2018,1,A,골목상권,1000239,망우로68길,86,32,54
2018,1,A,골목상권,1000238,동일로163길,93,60,33
2018,1,A,골목상권,1000237,동일로157길,221,120,101
2018,1,A,골목상권,1000236,동일로149길,1140,842,298
2018,1,A,골목상권,1000235,동일로140길,208,80,128
2018,1,A,골목상권,1000234,동일로139길,68,40,28
2018,1,A,골목상권,1000233,동일로139가길,1149,666,483
2018,1,A,골목상권,1000232,동일로130길,95,21,74
2018,1,A,골목상권,1000231,동일로123길,172,90,82
2018,1,A,골목상권,1000230,동일로112길,157,65,92
2018,1,A,골목상권,1000229,동일로101길,273,109,164
2018,1,A,골목상권,1000228,동일로100길,83,38,45
2018,1,A,골목상권,1000227,답십리로75길,96,47,49
2018,1,A,골목상권,1000226,공릉로2길,649,302,347
2018,1,A,골목상권,1000225,공릉로12가길,29,19,10
2018,1,A,골목상권,1000224,겸재로54길,122,53,69
2018,1,A,골목상권,1000223,겸재로36길,239,197,42
2018,1,A,골목상권,1000222,겸재로29길,424,171,253
2018,1,A,골목상권,1000221,휘경로3길,207,99,108
2018,1,A,골목상권,1000220,휘경로2길,7,2,5
2018,1,A,골목상권,1000219,휘경로23길,19,4,15
2018,1,A,골목상권,1000218,휘경로14길,103,42,61
2018,1,A,골목상권,1000217,한천로46길,363,110,253
2018,1,A,골목상권,1000216,한천로40길,305,151,154
2018,1,A,골목상권,1000215,한천로33길,80,36,44
2018,1,A,골목상권,1000214,한천로14길,580,348,232
2018,1,A,골목상권,1000213,천호대로97길,339,214,125
2018,1,A,골목상권,1000212,천호대로77길,1994,1050,944
2018,1,A,골목상권,1000211,천호대로45길,130,70,60
2018,1,A,골목상권,1000210,천호대로17길,2258,1465,793
2018,1,A,골목상권,1000209,천호대로12길,839,557,282
2018,1,A,골목상권,1000208,천장산로7길,1496,909,587
2018,1,A,골목상권,1000207,제기로5길,223,103,120
2018,1,A,골목상권,1000206,제기로21길,217,140,77
2018,1,A,골목상권,1000205,전농로4길,705,442,263
2018,1,A,골목상권,1000204,전농로3길,73,34,39
2018,1,A,골목상권,1000203,전농로29길,323,146,177
2018,1,A,골목상권,1000202,장한로8길,802,464,338
2018,1,A,골목상권,1000201,장한로5길,2968,2104,864
2018,1,A,골목상권,1000200,장한로27길,137,39,98
2018,1,A,골목상권,1000199,장한로27가길,435,199,236
2018,1,A,골목상권,1000198,장한로26길,552,255,297
2018,1,A,골목상권,1000197,장한로26가길,340,146,194
2018,1,A,골목상권,1000196,장한로25길,1015,450,565
2018,1,A,골목상권,1000195,장한로14길,182,151,31
2018,1,A,골목상권,1000194,이문로42길,240,100,140
2018,1,A,골목상권,1000193,왕산로43길,991,477,514
2018,1,A,골목상권,1000192,왕산로33길,150,99,51
2018,1,A,골목상권,1000191,왕산로32길,9,7,2
2018,1,A,골목상권,1000190,약령시로17길,295,130,165
2018,1,A,골목상권,1000189,서울시립대로4길,619,322,297
2018,1,A,골목상권,1000188,서울시립대로29길,237,128,109
2018,1,A,골목상권,1000187,서울시립대로16길,131,32,99
2018,1,A,골목상권,1000186,사가정로2길,83,67,16
2018,1,A,골목상권,1000185,사가정로23가길,97,60,37
2018,1,A,골목상권,1000184,사가정로13길,269,82,187
2018,1,A,골목상권,1000183,무학로45길,354,211,143
2018,1,A,골목상권,1000182,무학로16길,1175,1078,97
2018,1,A,골목상권,1000181,망우로21길,198,111,87
2018,1,A,골목상권,1000180,망우로18길,373,127,246
2018,1,A,골목상권,1000179,망우로18가길,70,26,44
2018,1,A,골목상권,1000178,답십리로72길,5,3,2
2018,1,A,골목상권,1000177,답십리로69길,917,390,527
2018,1,A,골목상권,1000176,답십리로68길,111,68,43
2018,1,A,골목상권,1000175,답십리로64길,361,213,148
2018,1,A,골목상권,1000174,답십리로63길,80,45,35
2018,1,A,골목상권,1000173,답십리로60길,12,6,6
2018,1,A,골목상권,1000172,답십리로56길,5,5,0
2018,1,A,골목상권,1000171,답십리로23길,3,2,1
2018,1,A,골목상권,1000170,난계로30길,126,89,37
2018,1,A,골목상권,1000168,경희대로3길,274,179,95
2018,1,A,골목상권,1000167,천호대로129길,251,85,166
2018,1,A,골목상권,1000166,천호대로123길,274,108,166
2018,1,A,골목상권,1000165,천호대로109길,1147,618,529
2018,1,A,골목상권,1000164,자양번영로3길,88,33,55
2018,1,A,골목상권,1000163,자양로53길,2,0,2
2018,1,A,골목상권,1000162,자양로50길,19,6,13
2018,1,A,골목상권,1000161,자양로45길,580,301,279
2018,1,A,골목상권,1000160,자양로26길,320,116,204
2018,1,A,골목상권,1000159,자양로15길,326,222,104
2018,1,A,골목상권,1000158,자양로11길,1400,684,716
2018,1,A,골목상권,1000157,용마산로3길,942,529,413
2018,1,A,골목상권,1000156,용마산로21길,156,64,92
2018,1,A,골목상권,1000155,아차산로78길,2703,1387,1316
2018,1,A,골목상권,1000154,아차산로65길,731,490,241
2018,1,A,골목상권,1000153,아차산로55길,340,191,149
2018,1,A,골목상권,1000152,아차산로51길,249,147,102
2018,1,A,골목상권,1000151,아차산로40길,544,296,248
2018,1,A,골목상권,1000150,면목로17길,256,162,94
2018,1,A,골목상권,1000149,뚝섬로64길,327,177,150
2018,1,A,골목상권,1000148,뚝섬로58길,193,63,130
2018,1,A,골목상권,1000147,뚝섬로54길,194,131,63
2018,1,A,골목상권,1000146,뚝섬로48길,864,396,468
2018,1,A,골목상권,1000145,뚝섬로24길,90,28,62
2018,1,A,골목상권,1000144,뚝섬로23길,122,71,51
2018,1,A,골목상권,1000143,동일로24길,14,4,10
2018,1,A,골목상권,1000142,동일로18길,194,76,118
2018,1,A,골목상권,1000141,능동로4길,239,104,135
2018,1,A,골목상권,1000140,능동로3길,202,92,110
2018,1,A,골목상권,1000139,능동로34길,978,522,456
2018,1,A,골목상권,1000138,능동로19길,312,196,116
2018,1,A,골목상권,1000137,능동로13길,374,123,251
2018,1,A,골목상권,1000136,긴고랑로9길,52,26,26
2018,1,A,골목상권,1000135,긴고랑로8길,223,179,44
2018,1,A,골목상권,1000134,긴고랑로7길,517,259,258
2018,1,A,골목상권,1000133,긴고랑로20길,566,273,293
2018,1,A,골목상권,1000132,광나루로52길,1975,977,998
2018,1,A,골목상권,1000131,광나루로40길,125,57,68
2018,1,A,골목상권,1000130,광나루로37길,259,142,117
2018,1,A,골목상권,1000129,광나루로36길,51,31,20
2018,1,A,골목상권,1000128,광나루로24길,61,37,24
2018,1,A,골목상권,1000127,광나루로12길,1001,552,449
2018,1,A,골목상권,1000126,한림말길,59,33,26
2018,1,A,골목상권,1000124,청계천로10나길,1805,1063,742
2018,1,A,골목상권,1000123,장터길,41,13,28
2018,1,A,골목상권,1000122,용답중앙길,97,51,46
2018,1,A,골목상권,1000121,용답29길,1699,905,794
2018,1,A,골목상권,1000120,왕십리로6길,1421,780,641
2018,1,A,골목상권,1000119,왕십리로31길,107,52,55
2018,1,A,골목상권,1000118,왕십리로26길,3861,2479,1382
2018,1,A,골목상권,1000117,왕십리로21길,172,56,116
2018,1,A,골목상권,1000116,왕십리로14길,2853,2023,830
2018,1,A,골목상권,1000115,아차산로5길,2228,1463,765
2018,1,A,골목상권,1000114,아차산로15길,4349,3090,1259
2018,1,A,골목상권,1000113,아차산로11길,3643,2378,1265
2018,1,A,골목상권,1000112,송정4가길,1069,469,600
2018,1,A,골목상권,1000111,송정12라길,298,186,112
2018,1,A,골목상권,1000110,성수일로6길,2718,1665,1053
2018,1,A,골목상권,1000109,성수이로7길,528,308,220
2018,1,A,골목상권,1000108,성수이로18길,2450,1749,701
2018,1,A,골목상권,1000107,성덕정길,879,484,395
2018,1,A,골목상권,1000106,성덕정17길,233,126,107
2018,1,A,골목상권,1000105,서울숲2길,1212,679,533
2018,1,A,골목상권,1000104,상원길,1491,966,525
2018,1,A,골목상권,1000103,상원12길,175,104,71
2018,1,A,골목상권,1000102,사근동길,28,17,11
2018,1,A,골목상권,1000101,무학봉길,9,6,3
2018,1,A,골목상권,1000100,무학봉28길,136,59,77
2018,1,A,골목상권,1000099,무학로6길,383,217,166
2018,1,A,골목상권,1000098,무수막길,134,55,79
2018,1,A,골목상권,1000097,매봉길,9,6,3
2018,1,A,골목상권,1000096,마조로1길,213,79,134
2018,1,A,골목상권,1000095,마조로16길,812,567,245
2018,1,A,골목상권,1000094,마장로39길,115,45,70
2018,1,A,골목상권,1000093,마장로27길,84,25,59
2018,1,A,골목상권,1000091,둘레9길,390,229,161
2018,1,A,골목상권,1000090,금호산길,427,156,271
2018,1,A,골목상권,1000089,금호산2길,33,12,21
2018,1,A,골목상권,1000088,고산자로6길,9672,3415,6257
2018,1,A,골목상권,1000087,후암로28길,201,89,112
2018,1,A,골목상권,1000086,효창원로39길,46,29,17
2018,1,A,골목상권,1000085,회나무로13길,71,33,38
2018,1,A,골목상권,1000084,한남대로20길,732,422,310
2018,1,A,골목상권,1000082,한강대로7길,529,357,172
2018,1,A,골목상권,1000081,한강대로62길,748,507,241
2018,1,A,골목상권,1000080,한강대로52길,1107,708,399
2018,1,A,골목상권,1000079,한강대로43길,5982,3756,2226
2018,1,A,골목상권,1000078,한강대로15길,1553,338,1215
2018,1,A,골목상권,1000077,한강대로104길,10716,3983,6733
2018,1,A,골목상권,1000076,청파로73길,1179,631,548
2018,1,A,골목상권,1000075,청파로71길,236,115,121
2018,1,A,골목상권,1000074,청파로47나길,174,100,74
2018,1,A,골목상권,1000073,청파로47길,929,415,514
2018,1,A,골목상권,1000072,장문로45길,49,9,40
2018,1,A,골목상권,1000071,이태원로54길,2379,1142,1237
2018,1,A,골목상권,1000070,이태원로27길,653,367,286
2018,1,A,골목상권,1000069,이촌로22길,222,131,91
2018,1,A,골목상권,1000068,원효로89길,913,746,167
2018,1,A,골목상권,1000067,원효로53길,818,496,322
2018,1,A,골목상권,1000066,원효로41길,1379,934,445
2018,1,A,골목상권,1000065,원효로19길,1000,697,303
2018,1,A,골목상권,1000064,우사단로4길,189,127,62
2018,1,A,골목상권,1000063,우사단로14길,1836,887,949
2018,1,A,골목상권,1000062,우사단로10길,88,42,46
2018,1,A,골목상권,1000061,신흥로20길,197,78,119
2018,1,A,골목상권,1000060,소월로20길,134,42,92
2018,1,A,골목상권,1000059,서빙고로71길,472,287,185
2018,1,A,골목상권,1000058,백범로90길,280,172,108
2018,1,A,골목상권,1000057,백범로79길,753,486,267
2018,1,A,골목상권,1000056,두텁바위로1길,2663,1432,1231
2018,1,A,골목상권,1000055,대사관로34길,271,144,127
2018,1,A,골목상권,1000054,녹사평대로46길,75,50,25
2018,1,A,골목상권,1000053,녹사평대로40나길,62,31,31
2018,1,A,골목상권,1000052,녹사평대로32길,293,154,139
2018,1,A,골목상권,1000051,녹사평대로26길,2231,1171,1060
2018,1,A,골목상권,1000050,녹사평대로11길,283,186,97
2018,1,A,골목상권,1000049,퇴계로90길,596,211,385
2018,1,A,골목상권,1000048,퇴계로8길,2348,1328,1020
2018,1,A,골목상권,1000047,퇴계로56길,1234,994,240
2018,1,A,골목상권,1000046,퇴계로46길,1943,844,1099
2018,1,A,골목상권,1000045,퇴계로18길,3016,1334,1682
2018,1,A,골목상권,1000044,퇴계로12길,1102,470,632
2018,1,A,골목상권,1000043,청구로1길,231,93,138
2018,1,A,골목상권,1000042,청구로17길,1696,785,911
2018,1,A,골목상권,1000041,장충단로8길,3378,1290,2088
2018,1,A,골목상권,1000040,삼일대로4길,1005,611,394
2018,1,A,골목상권,1000039,명동길,35854,17667,18187
2018,1,A,골목상권,1000037,동호로20길,812,313,499
2018,1,A,골목상권,1000036,동호로15길,4140,2165,1975
2018,1,A,골목상권,1000035,동호로11길,17,9,8
2018,1,A,골목상권,1000034,동호로10길,1533,661,872
2018,1,A,골목상권,1000033,다산로39길,1312,715,597
2018,1,A,골목상권,1000032,다산로38길,1556,741,815
2018,1,A,골목상권,1000031,다산로36길,74,44,30
2018,1,A,골목상권,1000030,다산로33길,376,197,179
2018,1,A,골목상권,1000029,난계로21길,253,168,85
2018,1,A,골목상권,1000028,난계로11길,1745,1054,691
2018,1,A,골목상권,1000027,필운대로1길,4,1,3
2018,1,A,골목상권,1000026,평창길,179,92,87
2018,1,A,골목상권,1000025,통일로12길,240,97,143
2018,1,A,골목상권,1000024,창신길,287,75,212
2018,1,A,골목상권,1000023,창신5길,8,3,5
2018,1,A,골목상권,1000022,창신2길,58,27,31
2018,1,A,골목상권,1000021,창경궁로35길,1277,365,912
2018,1,A,골목상권,1000020,지봉로8길,184,99,85
2018,1,A,골목상권,1000019,종로65길,575,256,319
2018,1,A,골목상권,1000016,자하문로7길,578,366,212
2018,1,A,골목상권,1000015,이화장길,1886,868,1018
2018,1,A,골목상권,1000014,율곡로16길,104,91,13
2018,1,A,골목상권,1000013,율곡로10길,2236,1625,611
2018,1,A,골목상권,1000012,옥인길,497,216,281
2018,1,A,골목상권,1000011,숭인동길,23,6,17
2018,1,A,골목상권,1000010,성균관로5길,146,91,55
2018,1,A,골목상권,1000009,삼청로5길,471,178,293
2018,1,A,골목상권,1000008,북촌로5나길,1643,1117,526
2018,1,A,골목상권,1000007,북촌로5길,61,27,34
2018,1,A,골목상권,1000006,북촌로11길,19,10,9
2018,1,A,골목상권,1000005,백석동길,128,69,59
2018,1,A,골목상권,1000004,명륜길,20,11,9
2018,1,A,골목상권,1000003,돈화문로11가길,1073,590,483
2018,1,A,골목상권,1000001,계동길,831,366,465
2017,4,U,관광특구,1001496,강남 마이스 관광특구,22435,12791,9644
2017,4,U,관광특구,1001495,잠실 관광특구,29135,16836,12299
2017,4,U,관광특구,1001494,종로?청계 관광특구,31373,18799,12574
2017,4,U,관광특구,1001493,동대문패션타운 관광특구,10146,5690,4456
2017,4,U,관광특구,1001492,명동 남대문 북창동 다동 무교동 관광특구,163479,80965,82514
2017,4,U,관광특구,1001491,이태원 관광특구,6036,3295,2741
2017,4,R,전통시장,1001490,길동복조리시장,448,301,147
2017,4,R,전통시장,1001489,둔촌역전통시장,169,81,88
2017,4,R,전통시장,1001488,성내골목시장,7,2,5
2017,4,R,전통시장,1001487,천호시장,19,10,9
2017,4,R,전통시장,1001483,암사종합시장,758,366,392
2017,4,R,전통시장,1001482,고덕전통시장,384,371,13
2017,4,R,전통시장,1001481,명일골목시장,461,166,295
2017,4,R,전통시장,1001480,새마을시장,362,201,161
2017,4,R,전통시장,1001479,석촌시장,173,108,65
2017,4,R,전통시장,1001478,방이시장,643,400,243
2017,4,R,전통시장,1001477,마천시장,202,70,132
2017,4,R,전통시장,1001476,풍납시장,22,8,14
2017,4,R,전통시장,1001475,강남개포시장,40,33,7
2017,4,R,전통시장,1001474,도곡시장,492,218,274
2017,4,R,전통시장,1001471,영동전통시장,2966,2171,795
2017,4,R,전통시장,1001466,미성동도깨비시장,419,178,241
2017,4,R,전통시장,1001465,신신림시장,2,2,0
2017,4,R,전통시장,1001464,삼성동시장,88,39,49
2017,4,R,전통시장,1001463,신림중앙시장,16,10,6
2017,4,R,전통시장,1001462,강남골목시장,279,128,151
2017,4,R,전통시장,1001460,관악신사시장,149,76,73
2017,4,R,전통시장,1001459,신원시장,315,116,199
2017,4,R,전통시장,1001458,인헌시장,211,98,113
2017,4,R,전통시장,1001456,봉천현대시장,7,4,3
2017,4,R,전통시장,1001454,봉천제일종합시장,56,25,31
2017,4,R,전통시장,1001453,낙성대시장,18,14,4
2017,4,R,전통시장,1001452,중부시장,182,58,124
2017,4,R,전통시장,1001450,남성역골목시장,545,247,298
2017,4,R,전통시장,1001449,남성사계시장,2019,924,1095
2017,4,R,전통시장,1001448,흑석시장,185,73,112
2017,4,R,전통시장,1001447,상도4동도깨비골목시장,323,82,241
2017,4,R,전통시장,1001445,영도시장,70,28,42
2017,4,R,전통시장,1001441,본동인정시장,120,61,59
2017,4,R,전통시장,1001439,대림중앙시장,22,10,12
2017,4,R,전통시장,1001438,우리시장,16,8,8
2017,4,R,전통시장,1001437,영진시장A동,49,42,7
2017,4,R,전통시장,1001436,사러가시장,26,7,19
2017,4,R,전통시장,1001431,영등포청과시장,191,122,69
2017,4,R,전통시장,1001430,영등포전통시장,3892,1947,1945
2017,4,R,전통시장,1001429,은행나무시장,56,12,44
2017,4,R,전통시장,1001427,현대시장,56,16,40
2017,4,R,전통시장,1001424,남문시장,269,112,157
2017,4,R,전통시장,1001423,독산동 우시장,147,62,85
2017,4,R,전통시장,1001421,개봉중앙시장,7,3,4
2017,4,R,전통시장,1001419,가리봉시장,19,15,4
2017,4,R,전통시장,1001418,남구로시장,16,3,13
2017,4,R,전통시장,1001417,구로시장,58,24,34
2017,4,R,전통시장,1001415,방신전통시장,38,22,16
2017,4,R,전통시장,1001414,송화골목시장,544,184,360
2017,4,R,전통시장,1001413,까치산시장,43,28,15
2017,4,R,전통시장,1001411,남부골목시장,216,88,128
2017,4,R,전통시장,1001409,화곡중앙골목시장,2,2,0
2017,4,R,전통시장,1001407,등마루시장,817,469,348
2017,4,R,전통시장,1001406,신정3동골목시장,204,106,98
2017,4,R,전통시장,1001405,신정2동골목시장,6,5,1
2017,4,R,전통시장,1001402,신월6동골목시장,227,109,118
2017,4,R,전통시장,1001401,신곡종합시장,11,7,4
2017,4,R,전통시장,1001400,신월3동골목시장,63,18,45
2017,4,R,전통시장,1001399,경창시장,189,82,107
2017,4,R,전통시장,1001398,월정로시장,115,63,52
2017,4,R,전통시장,1001397,신영시장,50,21,29
2017,4,R,전통시장,1001396,목4동시장,211,64,147
2017,4,R,전통시장,1001395,목3동시장,662,313,349
2017,4,R,전통시장,1001394,목2동시장,236,108,128
2017,4,R,전통시장,1001393,마포농수산물시장,494,319,175
2017,4,R,전통시장,1001391,망원월드컵시장,15,10,5
2017,4,R,전통시장,1001390,망원시장,48,24,24
2017,4,R,전통시장,1001386,신수시장,125,89,36
2017,4,R,전통시장,1001385,아현시장,26,5,21
2017,4,R,전통시장,1001374,대림골목시장,383,135,248
2017,4,R,전통시장,1001367,상계중앙시장,34,15,19
2017,4,R,전통시장,1001364,방학동도깨비시장,156,65,91
2017,4,R,전통시장,1001363,쌍문역골목시장,72,35,37
2017,4,R,전통시장,1001361,신도봉시장,24,13,11
2017,4,R,전통시장,1001359,창동신창시장,142,68,74
2017,4,R,전통시장,1001358,수유북부시장,9,2,7
2017,4,R,전통시장,1001357,장미원골목시장,73,45,28
2017,4,R,전통시장,1001356,수유중앙시장,127,70,57
2017,4,R,전통시장,1001355,강북종합시장,64,26,38
2017,4,R,전통시장,1001354,우이시장,158,62,96
2017,4,R,전통시장,1001353,수유전통시장,443,138,305
2017,4,R,전통시장,1001352,번동북부골목시장,81,45,36
2017,4,R,전통시장,1001351,솔샘시장,107,43,64
2017,4,R,전통시장,1001349,방천골목시장,72,27,45
2017,4,R,전통시장,1001347,석관황금시장,73,23,50
2017,4,R,전통시장,1001343,장위전통시장,185,77,108
2017,4,R,전통시장,1001340,정릉시장,33,11,22
2017,4,R,전통시장,1001339,정릉아리랑시장,2,1,1
2017,4,R,전통시장,1001338,돈암제일시장,53,17,36
2017,4,R,전통시장,1001336,우림골목시장,217,109,108
2017,4,R,전통시장,1001335,묵1동도깨비시장,280,126,154
2017,4,R,전통시장,1001334,태능시장,4,3,1
2017,4,R,전통시장,1001333,중화제일시장,23,1,22
2017,4,R,전통시장,1001332,사가정시장,260,187,73
2017,4,R,전통시장,1001330,동원시장,80,34,46
2017,4,R,전통시장,1001329,동부골목시장,101,35,66
2017,4,R,전통시장,1001326,회기시장,115,50,65
2017,4,R,전통시장,1001323,답십리시장,26,8,18
2017,4,R,전통시장,1001321,답십리현대시장,85,69,16
2017,4,R,전통시장,1001319,청량리종합시장,13,10,3
2017,4,R,전통시장,1001317,청량리농수산물시장,18,15,3
2017,4,R,전통시장,1001316,서울약령시장,1335,806,529
2017,4,R,전통시장,1001313,청량리수산시장,222,110,112
2017,4,R,전통시장,1001310,구의시장,121,72,49
2017,4,R,전통시장,1001309,조양시장,93,48,45
2017,4,R,전통시장,1001308,영동교골목시장,18,12,6
2017,4,R,전통시장,1001307,능동로골목시장,198,164,34
2017,4,R,전통시장,1001304,자양골목시장,88,46,42
2017,4,R,전통시장,1001301,중곡제일시장,120,69,51
2017,4,R,전통시장,1001299,한아름시장,141,80,61
2017,4,R,전통시장,1001298,성동용답상가시장,292,144,148
2017,4,R,전통시장,1001297,뚝도시장,34,12,22
2017,4,R,전통시장,1001296,금남시장,22,12,10
2017,4,R,전통시장,1001295,행당시장,243,123,120
2017,4,R,전통시장,1001294,마장축산물시장,1501,1017,484
2017,4,R,전통시장,1001289,용문전통시장,39,20,19
2017,4,R,전통시장,1001286,후암시장,50,19,31
2017,4,R,전통시장,1001285,합동(새벽)시장,2442,1364,1078
2017,4,R,전통시장,1001284,서울중앙시장,268,182,86
2017,4,R,전통시장,1001283,백학시장,466,240,226
2017,4,R,전통시장,1001282,약수시장,1757,696,1061
2017,4,R,전통시장,1001281,청평화시장,3287,1991,1296
2017,4,R,전통시장,1001280,제일평화시장,516,299,217
2017,4,R,전통시장,1001278,남평화시장,195,118,77
2017,4,R,전통시장,1001277,방산종합시장,1838,1161,677
2017,4,R,전통시장,1001275,인현시장,1123,708,415
2017,4,R,전통시장,1001274,신중부시장,2387,1590,797
2017,4,R,전통시장,1001273,남대문시장,7058,3595,3463
2017,4,R,전통시장,1001271,동묘시장,915,580,335
2017,4,R,전통시장,1001270,창신골목시장,227,115,112
2017,4,R,전통시장,1001268,충신시장,328,203,125
2017,4,R,전통시장,1001267,종로신진시장,39,17,22
2017,4,R,전통시장,1001266,동대문종합시장,308,171,137
2017,4,R,전통시장,1001265,광장시장,194,143,51
2017,4,D,발달상권,1001263,서울 노원구 노원역_3,759,317,442
2017,4,D,발달상권,1001261,서울 노원구 노원역_1,947,284,663
2017,4,D,발달상권,1001260,창동역,2396,1556,840
2017,4,D,발달상권,1001259,서울 강북구 수유역_3,71,33,38
2017,4,D,발달상권,1001257,서울 강북구 수유역_2,4324,2172,2152
2017,4,D,발달상권,1001256,서울 강북구 수유역_1,51,37,14
2017,4,D,발달상권,1001255,서울 은평구 연신내역_3,664,202,462
2017,4,D,발달상권,1001254,서울 은평구 연신내역_2,428,182,246
2017,4,D,발달상권,1001253,서울 은평구 연신내역_1,83,41,42
2017,4,D,발달상권,1001252,서울 성북구 미아삼거리역_2,521,209,312
2017,4,D,발달상권,1001251,서울 강북구 미아삼거리역_1,527,193,334
2017,4,D,발달상권,1001250,서울 은평구 불광역_3,57,21,36
2017,4,D,발달상권,1001249,서울 은평구 불광역_2,88,31,57
2017,4,D,발달상권,1001248,서울 은평구 불광역_1,246,94,152
2017,4,D,발달상권,1001247,미아사거리_2,110,26,84
2017,4,D,발달상권,1001246,미아사거리_1,528,236,292
2017,4,D,발달상권,1001245,서울 성북구 성신여대입구역,5122,3116,2006
2017,4,D,발달상권,1001244,경희대학교,341,161,180
2017,4,D,발달상권,1001243,서울 성북구 안암역,110,67,43
2017,4,D,발달상권,1001242,혜화역 대학로_3,1654,774,880
2017,4,D,발달상권,1001241,혜화역 대학로_2,1498,813,685
2017,4,D,발달상권,1001240,혜화역 대학로_1,1166,626,540
2017,4,D,발달상권,1001239,디지털미디어시티,16813,10770,6043
2017,4,D,발달상권,1001238,서울 동대문구 청량리역,3541,2418,1123
2017,4,D,발달상권,1001236,서울 종로구 안국역_2,656,273,383
2017,4,D,발달상권,1001235,서울 종로구 안국역_1,11611,9406,2205
2017,4,D,발달상권,1001234,서울 종로구 경복궁역_1,203,78,125
2017,4,D,발달상권,1001233,서울 종로구 종로3가역_3,3303,1754,1549
2017,4,D,발달상권,1001232,서울 종로구 종로3가역_2,1862,1009,853
2017,4,D,발달상권,1001231,서울 동대문구 신설동역_2,4556,2170,2386
2017,4,D,발달상권,1001230,인사동,20646,12784,7862
2017,4,D,발달상권,1001229,서울 종로구 종로5가역_4,654,355,299
2017,4,D,발달상권,1001228,서울 종로구 종로5가역_3,5069,3422,1647
2017,4,D,발달상권,1001227,종로구청,18223,10024,8199
2017,4,D,발달상권,1001226,서울 종로구 종로5가역_2,17663,11671,5992
2017,4,D,발달상권,1001225,신설동역,744,414,330
2017,4,D,발달상권,1001224,서울 동대문구 신설동역_1,2,2,0
2017,4,D,발달상권,1001223,서울 종로구 광화문역_2,54526,32877,21649
2017,4,D,발달상권,1001222,동묘앞역,52,31,21
2017,4,D,발달상권,1001221,장안동사거리,494,258,236
2017,4,D,발달상권,1001220,서울 종로구 동대문역_2,1090,555,535
2017,4,D,발달상권,1001218,동대문시장_2,490,300,190
2017,4,D,발달상권,1001217,서울 종로구 종로5가역_1,48,36,12
2017,4,D,발달상권,1001216,서울 종로구 종로3가역_1,4196,1807,2389
2017,4,D,발달상권,1001215,서울 종로구 광화문역_1,2092,1335,757
2017,4,D,발달상권,1001214,종각역,20629,13378,7251
2017,4,D,발달상권,1001213,종각역 젊음의 거리,2385,1017,1368
2017,4,D,발달상권,1001212,서대문구 서대문역_1,362,251,111
2017,4,D,발달상권,1001211,동대문시장_1,435,229,206
2017,4,D,발달상권,1001210,시청역_2,22471,14281,8190
2017,4,D,발달상권,1001209,서울시청,24111,11723,12388
2017,4,D,발달상권,1001208,서울 중구 을지로3가역_2,7696,4978,2718
2017,4,D,발달상권,1001207,서울 중구 신당역_2,1347,675,672
2017,4,D,발달상권,1001206,서대문구 서대문역_2,1405,861,544
2017,4,D,발달상권,1001205,동대문역사문화공원역,2212,1257,955
2017,4,D,발달상권,1001204,서울 중구 을지로3가역_1,15222,9995,5227
2017,4,D,발달상권,1001203,명동거리,9708,5218,4490
2017,4,D,발달상권,1001202,롯데백화점,43758,23437,20321
2017,4,D,발달상권,1001201,서울 중구 신당역_1,1012,668,344
2017,4,D,발달상권,1001200,북창동,10134,5387,4747
2017,4,D,발달상권,1001199,서울 중구 충무로역_2,14218,6370,7848
2017,4,D,발달상권,1001198,서울 강서구 송정역,630,416,214
2017,4,D,발달상권,1001197,장한평역_2,5310,3241,2069
2017,4,D,발달상권,1001196,시청역_1,55012,33341,21671
2017,4,D,발달상권,1001195,왕십리역_2,661,279,382
2017,4,D,발달상권,1001194,서울 강서구 발산역,854,496,358
2017,4,D,발달상권,1001193,장한평역_1,2293,1530,763
2017,4,D,발달상권,1001192,서울 중구 충무로역_1,3243,2252,991
2017,4,D,발달상권,1001190,장한평역,2192,1545,647
2017,4,D,발달상권,1001189,서울 중구 명동역,3845,1963,1882
2017,4,D,발달상권,1001188,장충동 족발거리,199,98,101
2017,4,D,발달상권,1001187,한양시장,298,151,147
2017,4,D,발달상권,1001186,서울 서대문구 이대역,1286,572,714
2017,4,D,발달상권,1001185,서울 서대문구 신촌역,3137,1358,1779
2017,4,D,발달상권,1001184,서울 마포구 홍대입구역_3,331,162,169
2017,4,D,발달상권,1001183,서울 마포구 홍대입구역_2,3456,1278,2178
2017,4,D,발달상권,1001182,홍익대학교 주변,16348,7888,8460
2017,4,D,발달상권,1001181,서울 광진구 군자역,176,101,75
2017,4,D,발달상권,1001180,신촌역,222,109,113
2017,4,D,발달상권,1001179,강서구청,3403,2241,1162
2017,4,D,발달상권,1001178,서울 마포구 홍대입구역_1,860,476,384
2017,4,D,발달상권,1001175,서울 강동구 고덕역,476,274,202
2017,4,D,발달상권,1001173,서울 강동구 명일역,886,357,529
2017,4,D,발달상권,1001172,어린이대공원역,93,51,42
2017,4,D,발달상권,1001171,서울 마포구 공덕역_2,4357,2524,1833
2017,4,D,발달상권,1001170,공덕역,7579,4503,3076
2017,4,D,발달상권,1001169,서울 용산구 숙대입구역,2726,1988,738
2017,4,D,발달상권,1001168,남영역,13126,5769,7357
2017,4,D,발달상권,1001167,서울 마포구 공덕역_1,4948,2420,2528
2017,4,D,발달상권,1001166,서울 마포구 마포역_2,957,522,435
2017,4,D,발달상권,1001165,서울 광진구 건대입구역_2,2899,1009,1890
2017,4,D,발달상권,1001164,서울 마포구 마포역_1,11787,7085,4702
2017,4,D,발달상권,1001163,서울 강동구 천호역_2,3879,1870,2009
2017,4,D,발달상권,1001162,서울 광진구 건대입구역_1,886,425,461
2017,4,D,발달상권,1001161,건대입구역,718,386,332
2017,4,D,발달상권,1001160,서울 광진구 구의역,826,511,315
2017,4,D,발달상권,1001159,서울 강동구 천호역,931,452,479
2017,4,D,발달상권,1001158,당산역_2,4972,2952,2020
2017,4,D,발달상권,1001156,서울 강동구 길동역,1179,662,517
2017,4,D,발달상권,1001155,용산 전자상가_5,2463,1801,662
2017,4,D,발달상권,1001153,당산역_1,1149,727,422
2017,4,D,발달상권,1001152,서울 광진구 강변역,1808,1436,372
2017,4,D,발달상권,1001151,용산 전자상가_3,2474,1780,694
2017,4,D,발달상권,1001150,서울 용산구 이태원역,673,404,269
2017,4,D,발달상권,1001149,한남오거리,562,293,269
2017,4,D,발달상권,1001147,용산 전자상가_2,461,363,98
2017,4,D,발달상권,1001146,용산구청,84,51,33
2017,4,D,발달상권,1001145,용산 전자상가_1,13362,8405,4957
2017,4,D,발달상권,1001144,국회의사당역_2,37259,21154,16105
2017,4,D,발달상권,1001143,서울 용산구 신용산역,508,233,275
2017,4,D,발달상권,1001142,국회의사당역_1,5701,4395,1306
2017,4,D,발달상권,1001141,압구정 로데오거리_2,16393,6863,9530
2017,4,D,발달상권,1001140,서울 강남구 압구정역,11363,5229,6134
2017,4,D,발달상권,1001139,서울 영등포구 영등포구청역,3727,1138,2589
2017,4,D,발달상권,1001138,압구정 로데오거리_1,7848,2550,5298
2017,4,D,발달상권,1001137,서울 강동구 둔촌동역,45,12,33
2017,4,D,발달상권,1001136,오목교역,194,81,113
2017,4,D,발달상권,1001135,신사동 가로수길,22334,10463,11871
2017,4,D,발달상권,1001134,서울 영등포구 여의도역_2,48879,32436,16443
2017,4,D,발달상권,1001133,청담사거리_3,1791,592,1199
2017,4,D,발달상권,1001132,영등포유통상가,2130,1309,821
2017,4,D,발달상권,1001131,청담역_2,1341,939,402
2017,4,D,발달상권,1001130,청담역_1,190,150,40
2017,4,D,발달상권,1001129,청담사거리_2,1008,760,248
2017,4,D,발달상권,1001127,서울 영등포구 여의도역_1,51592,30941,20651
2017,4,D,발달상권,1001125,학동사거리_2,2880,1649,1231
2017,4,D,발달상권,1001124,서울 영등포구 영등포시장역,334,256,78
2017,4,D,발달상권,1001123,학동사거리_1,4274,2207,2067
2017,4,D,발달상권,1001122,여의도 시범아파트앞,2147,1405,742
2017,4,D,발달상권,1001121,영등포역_3,871,511,360
2017,4,D,발달상권,1001120,도산공원사거리_1,9955,5887,4068
2017,4,D,발달상권,1001119,영등포역_2,1207,649,558
2017,4,D,발달상권,1001118,문래동 주민센터,74,61,13
2017,4,D,발달상권,1001117,강남구 신사역_2,8223,5124,3099
2017,4,D,발달상권,1001115,서울 강남구 강남구청역_2,4550,2824,1726
2017,4,D,발달상권,1001114,강남구 신사역_1,2479,1088,1391
2017,4,D,발달상권,1001113,서울 동작구 노량진1동_1,26,13,13
2017,4,D,발달상권,1001112,서울 강남구 학동역_3,9290,5379,3911
2017,4,D,발달상권,1001111,서울 강남구 강남구청역_1,3568,2108,1460
2017,4,D,발달상권,1001110,잠실역,6089,4538,1551
2017,4,D,발달상권,1001109,강남구 논현역_4,6622,3405,3217
2017,4,D,발달상권,1001108,학동역,1452,553,899
2017,4,D,발달상권,1001107,방이동 먹자골목,5272,3313,1959
2017,4,D,발달상권,1001106,서울 강남구 학동역_2,5932,3345,2587
2017,4,D,발달상권,1001105,서울 동작구 노량진역,3863,2198,1665
2017,4,D,발달상권,1001104,삼성역_3,8944,4997,3947
2017,4,D,발달상권,1001103,코엑스,22435,12791,9644
2017,4,D,발달상권,1001102,서울 강남구 학동역_1,5146,3297,1849
2017,4,D,발달상권,1001101,선정릉역_2,6606,4052,2554
2017,4,D,발달상권,1001100,강남구 논현역_3,1558,947,611
2017,4,D,발달상권,1001099,포스코사거리_2,7496,4762,2734
2017,4,D,발달상권,1001098,포스코사거리_1,44391,29259,15132
2017,4,D,발달상권,1001097,잠실역 롯데월드,3972,1974,1998
2017,4,D,발달상권,1001096,신도림역,3335,1773,1562
2017,4,D,발달상권,1001095,강남구 논현역_2,9434,4499,4935
2017,4,D,발달상권,1001094,선정릉역_1,1893,1347,546
2017,4,D,발달상권,1001093,신천역,5817,3114,2703
2017,4,D,발달상권,1001092,강남구 논현역_1,3544,2067,1477
2017,4,D,발달상권,1001091,삼성역_2,18112,10907,7205
2017,4,D,발달상권,1001090,삼정역_2,2637,1374,1263
2017,4,D,발달상권,1001089,삼정역_1,3181,1656,1525
2017,4,D,발달상권,1001088,삼성역_1,34086,21853,12233
2017,4,D,발달상권,1001087,서울 강남구 선릉역_2,7247,4637,2610
2017,4,D,발달상권,1001086,고속터미널역,16010,4725,11285
2017,4,D,발달상권,1001085,서울 서초구 강남역,32833,18506,14327
2017,4,D,발달상권,1001084,서울 강남구 선릉역_1,20105,8197,11908
2017,4,D,발달상권,1001082,선릉역_2,21074,10853,10221
2017,4,D,발달상권,1001081,서울 강남구 역삼역_2,26755,21043,5712
2017,4,D,발달상권,1001080,서울 송파구 석촌역_1,37,23,14
2017,4,D,발달상권,1001078,서울 강남구 강남역_2,5454,3172,2282
2017,4,D,발달상권,1001077,선릉역_1,55040,29720,25320
2017,4,D,발달상권,1001076,구로역,157,90,67
2017,4,D,발달상권,1001075,역삼역_2,4606,2561,2045
2017,4,D,발달상권,1001074,대림역_2,7770,5930,1840
2017,4,D,발달상권,1001073,서울 강남구 역삼역_1,25570,15878,9692
2017,4,D,발달상권,1001072,신대방삼거리역,232,109,123
2017,4,D,발달상권,1001071,서울 강남구 한티역,1106,444,662
2017,4,D,발달상권,1001070,은마아파트입구사거리_4,102,51,51
2017,4,D,발달상권,1001067,오류동역,1539,779,760
2017,4,D,발달상권,1001066,서울 강남구 강남역,39619,18744,20875
2017,4,D,발달상권,1001063,교대역_4,5010,2740,2270
2017,4,D,발달상권,1001062,서울 강남구 강남역_1,133206,97624,35582
2017,4,D,발달상권,1001061,방배동카페골목,113,48,65
2017,4,D,발달상권,1001060,가락시장,17236,10769,6467
2017,4,D,발달상권,1001059,교대역_3,4329,2632,1697
2017,4,D,발달상권,1001058,역삼역_1,1666,1013,653
2017,4,D,발달상권,1001057,교대역_2,3448,2191,1257
2017,4,D,발달상권,1001056,서울 송파구 가락시장역,5261,3391,1870
2017,4,D,발달상권,1001055,서울 서초구 서초역,12915,5397,7518
2017,4,D,발달상권,1001054,서울 강남구 대치역_2,1506,906,600
2017,4,D,발달상권,1001052,뱅뱅사거리_2,25312,16270,9042
2017,4,D,발달상권,1001051,보라매공원,14218,8051,6167
2017,4,D,발달상권,1001050,교대역_1,12772,7610,5162
2017,4,D,발달상권,1001049,개봉동 현대아파트 인근,149,62,87
2017,4,D,발달상권,1001048,뱅뱅사거리,7522,4955,2567
2017,4,D,발달상권,1001047,뱅뱅사거리_1,10840,7695,3145
2017,4,D,발달상권,1001046,서울 관악구 신림역_4,987,443,544
2017,4,D,발달상권,1001045,동작구 총신대입구역_1,243,114,129
2017,4,D,발달상권,1001044,양재역_3,3664,2387,1277
2017,4,D,발달상권,1001043,동작구 총신대입구역_2,790,327,463
2017,4,D,발달상권,1001042,서울 서초구 남부터미널역_3,1460,790,670
2017,4,D,발달상권,1001041,서울 강남구 수서역,15828,11213,4615
2017,4,D,발달상권,1001039,서울 서초구 남부터미널역_2,10951,5473,5478
2017,4,D,발달상권,1001038,구로디지탈1단지,65994,41668,24326
2017,4,D,발달상권,1001037,양재역,120,49,71
2017,4,D,발달상권,1001035,매봉역,584,219,365
2017,4,D,발달상권,1001034,서울 서초구 방배역,3536,2094,1442
2017,4,D,발달상권,1001033,서울 서초구 남부터미널역_1,548,399,149
2017,4,D,발달상권,1001032,서울 관악구 신림역_2,32,17,15
2017,4,D,발달상권,1001031,서울 관악구 신림역_1,1869,899,970
2017,4,D,발달상권,1001030,양재역_2,10112,5277,4835
2017,4,D,발달상권,1001029,양재역_1,918,648,270
2017,4,D,발달상권,1001028,서울 관악구 서울대입구역_2,38,2,36
2017,4,D,발달상권,1001027,가산디지털단지역_3,30011,17798,12213
2017,4,D,발달상권,1001026,구로디지털단지역,2293,1476,817
2017,4,D,발달상권,1001025,서울 관악구 서울대입구역_1,1981,833,1148
2017,4,D,발달상권,1001024,관악구 사당역_1,3726,1480,2246
2017,4,D,발달상권,1001023,가산디지털단지역_2,59572,36023,23549
2017,4,D,발달상권,1001022,관악구 사당역_2,471,238,233
2017,4,D,발달상권,1001021,가산디지털단지역_1,27543,18660,8883
2017,4,D,발달상권,1001020,장지역,4692,2933,1759
2017,4,D,발달상권,1001019,포이사거리_1,5883,3267,2616
2017,4,D,발달상권,1001018,포이사거리_2,8511,5899,2612
2017,4,D,발달상권,1001016,서울 관악구 대학동_1,97,57,40
2017,4,D,발달상권,1001015,서울 금천구 독산1동_1,2864,1865,999
2017,4,D,발달상권,1001013,양재 화물트럭터미널앞_2,146,65,81
2017,4,D,발달상권,1001012,양재 화물트럭터미널앞_1,4204,3395,809
2017,4,D,발달상권,1001011,서울 금천구 시흥1동_4,963,435,528
2017,4,A,골목상권,1001010,풍성로37가길,39,19,20
2017,4,A,골목상권,1001009,천호옛길,487,327,160
2017,4,A,골목상권,1001008,천호옛14길,618,307,311
2017,4,A,골목상권,1001007,천호대로219길,944,582,362
2017,4,A,골목상권,1001006,천호대로197길,26,9,17
2017,4,A,골목상권,1001005,천호대로187길,901,517,384
2017,4,A,골목상권,1001004,천호대로170길,238,139,99
2017,4,A,골목상권,1001003,천호대로162길,1317,836,481
2017,4,A,골목상권,1001002,천중로51길,425,218,207
2017,4,A,골목상권,1001001,천중로39길,618,221,397
2017,4,A,골목상권,1001000,진황도로47길,1425,676,749
2017,4,A,골목상권,1000999,진황도로27길,566,296,270
2017,4,A,골목상권,1000998,올림픽로98길,39,15,24
2017,4,A,골목상권,1000995,올림픽로77길,16,8,8
2017,4,A,골목상권,1000994,올림픽로71길,347,264,83
2017,4,A,골목상권,1000993,올림픽로48길,6401,3825,2576
2017,4,A,골목상권,1000992,양재대로96길,1337,819,518
2017,4,A,골목상권,1000991,양재대로95길,674,357,317
2017,4,A,골목상권,1000990,양재대로91길,1137,613,524
2017,4,A,골목상권,1000989,양재대로133길,319,117,202
2017,4,A,골목상권,1000988,양재대로124길,591,355,236
2017,4,A,골목상권,1000987,양재대로116길,212,84,128
2017,4,A,골목상권,1000986,양재대로101길,1241,729,512
2017,4,A,골목상권,1000985,암사길,383,174,209
2017,4,A,골목상권,1000984,성안로3길,1386,814,572
2017,4,A,골목상권,1000983,성내로5길,1119,569,550
2017,4,A,골목상권,1000982,상일로5길,42,24,18
2017,4,A,골목상권,1000981,상암로5길,583,262,321
2017,4,A,골목상권,1000980,상암로51길,763,324,439
2017,4,A,골목상권,1000979,상암로4길,373,272,101
2017,4,A,골목상권,1000978,상암로14길,462,280,182
2017,4,A,골목상권,1000977,명일로13길,108,48,60
2017,4,A,골목상권,1000976,동남로85길,119,65,54
2017,4,A,골목상권,1000975,동남로82길,10,4,6
2017,4,A,골목상권,1000974,동남로65길,69,20,49
2017,4,A,골목상권,1000973,구천면로42길,354,181,173
2017,4,A,골목상권,1000972,구천면로41길,605,253,352
2017,4,A,골목상권,1000971,구천면로36길,41,25,16
2017,4,A,골목상권,1000969,고덕로25길,26,14,12
2017,4,A,골목상권,1000968,고덕로10길,170,73,97
2017,4,A,골목상권,1000967,강동대로53길,928,517,411
2017,4,A,골목상권,1000966,풍성로25길,775,273,502
2017,4,A,골목상권,1000965,오금로46길,1459,729,730
2017,4,A,골목상권,1000964,오금로36길,1185,867,318
2017,4,A,골목상권,1000963,오금로11길,2097,1358,739
2017,4,A,골목상권,1000962,양재대로72길,650,329,321
2017,4,A,골목상권,1000961,양재대로71길,1394,853,541
2017,4,A,골목상권,1000960,양재대로64길,1481,630,851
2017,4,A,골목상권,1000959,양재대로62길,6569,4083,2486
2017,4,A,골목상권,1000958,송파대로30길,1626,999,627
2017,4,A,골목상권,1000957,송이로36길,1978,1402,576
2017,4,A,골목상권,1000956,송이로32길,714,391,323
2017,4,A,골목상권,1000955,송이로23길,1340,819,521
2017,4,A,골목상권,1000954,삼전로13길,1668,798,870
2017,4,A,골목상권,1000953,백제고분로50길,1460,888,572
2017,4,A,골목상권,1000952,백제고분로46길,1610,943,667
2017,4,A,골목상권,1000951,백제고분로45길,480,304,176
2017,4,A,골목상권,1000950,백제고분로42길,131,76,55
2017,4,A,골목상권,1000949,백제고분로39길,1770,1237,533
2017,4,A,골목상권,1000948,백제고분로34길,1529,968,561
2017,4,A,골목상권,1000947,백제고분로33길,1092,693,399
2017,4,A,골목상권,1000946,백제고분로32길,1072,482,590
2017,4,A,골목상권,1000945,백제고분로31길,340,179,161
2017,4,A,골목상권,1000944,백제고분로22길,1236,734,502
2017,4,A,골목상권,1000943,백제고분로21길,199,141,58
2017,4,A,골목상권,1000942,마천로51길,148,58,90
2017,4,A,골목상권,1000941,동남로20길,134,72,62
2017,4,A,골목상권,1000940,거마로20길,515,216,299
2017,4,A,골목상권,1000939,학동로77길,2940,1524,1416
2017,4,A,골목상권,1000938,학동로6길,1854,911,943
2017,4,A,골목상권,1000937,학동로56길,921,476,445
2017,4,A,골목상권,1000936,학동로38길,7344,4204,3140
2017,4,A,골목상권,1000935,테헤란로81길,570,224,346
2017,4,A,골목상권,1000934,일원로9길,542,311,231
2017,4,A,골목상권,1000933,일원로3길,221,107,114
2017,4,A,골목상권,1000932,영동대로65길,3282,1972,1310
2017,4,A,골목상권,1000931,영동대로112길,605,383,222
2017,4,A,골목상권,1000930,언주로81길,8479,4618,3861
2017,4,A,골목상권,1000929,압구정로2길,2657,1444,1213
2017,4,A,골목상권,1000928,선릉로18길,414,227,187
2017,4,A,골목상권,1000927,선릉로146길,1927,1023,904
2017,4,A,골목상권,1000926,선릉로133길,234,127,107
2017,4,A,골목상권,1000925,선릉로132길,1008,567,441
2017,4,A,골목상권,1000924,선릉로121길,1883,960,923
2017,4,A,골목상권,1000923,삼성로75길,2726,1519,1207
2017,4,A,골목상권,1000922,삼성로69길,328,167,161
2017,4,A,골목상권,1000921,삼성로64길,488,241,247
2017,4,A,골목상권,1000920,삼성로63길,225,99,126
2017,4,A,골목상권,1000919,삼성로57길,822,262,560
2017,4,A,골목상권,1000918,삼성로147길,981,390,591
2017,4,A,골목상권,1000917,삼성로115길,264,159,105
2017,4,A,골목상권,1000916,봉은사로68길,214,99,115
2017,4,A,골목상권,1000915,봉은사로57길,1063,663,400
2017,4,A,골목상권,1000914,봉은사로43길,1059,681,378
2017,4,A,골목상권,1000913,봉은사로29길,136,92,44
2017,4,A,골목상권,1000912,봉은사로109길,332,169,163
2017,4,A,골목상권,1000911,도산대로89길,2437,913,1524
2017,4,A,골목상권,1000910,도산대로81길,4309,1403,2906
2017,4,A,골목상권,1000909,도산대로50길,2752,1904,848
2017,4,A,골목상권,1000908,도산대로38길,160,89,71
2017,4,A,골목상권,1000907,도산대로30길,3166,1543,1623
2017,4,A,골목상권,1000906,도산대로23길,1335,830,505
2017,4,A,골목상권,1000905,도산대로15길,1643,744,899
2017,4,A,골목상권,1000904,도곡로37길,4042,2193,1849
2017,4,A,골목상권,1000903,논현로8길,787,438,349
2017,4,A,골목상권,1000902,논현로63길,12527,3369,9158
2017,4,A,골목상권,1000901,논현로28길,10312,7066,3246
2017,4,A,골목상권,1000900,논현로26길,7756,5083,2673
2017,4,A,골목상권,1000898,논현로139길,2712,1293,1419
2017,4,A,골목상권,1000897,논현로123길,102,64,38
2017,4,A,골목상권,1000896,논현로115길,2832,1478,1354
2017,4,A,골목상권,1000895,논현로10길,2555,1682,873
2017,4,A,골목상권,1000894,논현로106길,2682,1583,1099
2017,4,A,골목상권,1000893,남부순환로365길,173,122,51
2017,4,A,골목상권,1000891,개포로28길,282,187,95
2017,4,A,골목상권,1000890,개포로20길,4058,2238,1820
2017,4,A,골목상권,1000889,개포로17길,2690,1706,984
2017,4,A,골목상권,1000888,강남대로140길,4108,2093,2015
2017,4,A,골목상권,1000887,강남대로136길,1291,725,566
2017,4,A,골목상권,1000886,강남대로118길,626,328,298
2017,4,A,골목상권,1000885,서초중앙로8길,7043,5231,1812
2017,4,A,골목상권,1000884,방배중앙로21길,1254,641,613
2017,4,A,골목상권,1000883,효령로72길,192,107,85
2017,4,A,골목상권,1000882,효령로34길,32,27,5
2017,4,A,골목상권,1000881,효령로31길,1346,733,613
2017,4,A,골목상권,1000880,효령로23길,707,416,291
2017,4,A,골목상권,1000879,청두곶길,2085,1320,765
2017,4,A,골목상권,1000878,주흥길,328,212,116
2017,4,A,골목상권,1000877,주흥15길,1413,917,496
2017,4,A,골목상권,1000876,언남길,1692,1150,542
2017,4,A,골목상권,1000875,신반포로45길,438,274,164
2017,4,A,골목상권,1000874,서초대로8길,255,141,114
2017,4,A,골목상권,1000873,서초대로64길,534,370,164
2017,4,A,골목상권,1000872,서초대로4길,659,488,171
2017,4,A,골목상권,1000871,서초대로25길,3516,2058,1458
2017,4,A,골목상권,1000870,서초대로23길,579,344,235
2017,4,A,골목상권,1000869,서초대로15길,1479,682,797
2017,4,A,골목상권,1000868,사평대로57길,169,68,101
2017,4,A,골목상권,1000867,사평대로26길,14,9,5
2017,4,A,골목상권,1000866,사평대로22길,1423,834,589
2017,4,A,골목상권,1000865,사임당로17길,1806,1055,751
2017,4,A,골목상권,1000864,방배로42길,153,80,73
2017,4,A,골목상권,1000863,방배로35길,2322,1472,850
2017,4,A,골목상권,1000862,방배로18길,91,46,45
2017,4,A,골목상권,1000861,반포대로9길,663,399,264
2017,4,A,골목상권,1000860,바우뫼로39길,2109,1328,781
2017,4,A,골목상권,1000859,마방로2길,3784,2370,1414
2017,4,A,골목상권,1000858,방배천로4안길,1289,831,458
2017,4,A,골목상권,1000857,동산로19길,1312,874,438
2017,4,A,골목상권,1000856,동산로10길,2832,1533,1299
2017,4,A,골목상권,1000855,동광로39길,45,28,17
2017,4,A,골목상권,1000854,동광로1길,1211,717,494
2017,4,A,골목상권,1000853,동광로12길,778,503,275
2017,4,A,골목상권,1000852,논현로27길,3605,2527,1078
2017,4,A,골목상권,1000851,논현로1길,555,360,195
2017,4,A,골목상권,1000850,남부순환로339길,13231,5774,7457
2017,4,A,골목상권,1000849,남부순환로325길,8081,3910,4171
2017,4,A,골목상권,1000848,남부순환로317길,1704,1181,523
2017,4,A,골목상권,1000847,고무래로8길,6567,3390,3177
2017,4,A,골목상권,1000846,강남대로8길,2653,1587,1066
2017,4,A,골목상권,1000845,강남대로34길,1036,663,373
2017,4,A,골목상권,1000844,강남대로23길,6445,4474,1971
2017,4,A,골목상권,1000843,소담길,27,7,20
2017,4,A,골목상권,1000842,원신길,295,114,181
2017,4,A,골목상권,1000840,양산길,342,241,101
2017,4,A,골목상권,1000839,호암로24길,655,251,404
2017,4,A,골목상권,1000838,호암로20길,40,27,13
2017,4,A,골목상권,1000837,행운길,21,5,16
2017,4,A,골목상권,1000836,행운1길,101,72,29
2017,4,A,골목상권,1000835,청림3길,79,39,40
2017,4,A,골목상권,1000834,청룡길,84,43,41
2017,4,A,골목상권,1000833,청룡8길,7,3,4
2017,4,A,골목상권,1000832,중앙길,257,99,158
2017,4,A,골목상권,1000831,조원중앙로2길,1156,837,319
2017,4,A,골목상권,1000830,조원로18길,1045,558,487
2017,4,A,골목상권,1000829,조원로10길,266,124,142
2017,4,A,골목상권,1000828,장군봉2길,215,114,101
2017,4,A,골목상권,1000827,장군봉1길,86,14,72
2017,4,A,골목상권,1000826,인헌길,88,50,38
2017,4,A,골목상권,1000825,은천로25길,280,89,191
2017,4,A,골목상권,1000824,양녕로6길,868,500,368
2017,4,A,골목상권,1000823,신원로3길,27,19,8
2017,4,A,골목상권,1000822,신사로20길,34,10,24
2017,4,A,골목상권,1000820,신림로64길,237,107,130
2017,4,A,골목상권,1000819,신림로48길,74,36,38
2017,4,A,골목상권,1000818,신림로38길,60,32,28
2017,4,A,골목상권,1000817,신림로28길,314,218,96
2017,4,A,골목상권,1000816,신림로11길,453,412,41
2017,4,A,골목상권,1000815,신림동길,371,223,148
2017,4,A,골목상권,1000814,승방길,573,372,201
2017,4,A,골목상권,1000813,서림7길,283,106,177
2017,4,A,골목상권,1000812,봉천로33길,350,226,124
2017,4,A,골목상권,1000811,봉천로13길,314,88,226
2017,4,A,골목상권,1000810,복은길,164,61,103
2017,4,A,골목상권,1000808,법원단지9길,91,40,51
2017,4,A,골목상권,1000807,미성5길,72,39,33
2017,4,A,골목상권,1000806,대학길,81,34,47
2017,4,A,골목상권,1000805,대학14길,12,3,9
2017,4,A,골목상권,1000804,당곡길,383,198,185
2017,4,A,골목상권,1000803,남현길,225,80,145
2017,4,A,골목상권,1000802,남현3길,400,253,147
2017,4,A,골목상권,1000800,남부순환로248길,234,118,116
2017,4,A,골목상권,1000799,남부순환로234길,132,87,45
2017,4,A,골목상권,1000798,남부순환로172길,1398,778,620
2017,4,A,골목상권,1000797,남부순환로161길,30,12,18
2017,4,A,골목상권,1000796,남부순환로151길,185,133,52
2017,4,A,골목상권,1000795,남부순환로142길,74,35,39
2017,4,A,골목상권,1000794,난향길,168,41,127
2017,4,A,골목상권,1000793,난우길,415,160,255
2017,4,A,골목상권,1000792,난곡로74길,135,62,73
2017,4,A,골목상권,1000791,난곡로34길,24,8,16
2017,4,A,골목상권,1000790,난곡로26길,131,51,80
2017,4,A,골목상권,1000789,난곡로24길,32,17,15
2017,4,A,골목상권,1000788,낙성대역길,689,437,252
2017,4,A,골목상권,1000787,국회단지길,545,258,287
2017,4,A,골목상권,1000786,구암길,72,26,46
2017,4,A,골목상권,1000785,관천로22길,23,9,14
2017,4,A,골목상권,1000784,관천로15길,137,73,64
2017,4,A,골목상권,1000783,관악로30길,185,63,122
2017,4,A,골목상권,1000782,관악로28길,145,67,78
2017,4,A,골목상권,1000781,관악로14길,443,241,202
2017,4,A,골목상권,1000780,관악로10길,227,159,68
2017,4,A,골목상권,1000779,흑석로9길,186,88,98
2017,4,A,골목상권,1000778,흑석로13길,132,10,122
2017,4,A,골목상권,1000777,장승배기로27길,37,18,19
2017,4,A,골목상권,1000776,장승배기로19길,7,4,3
2017,4,A,골목상권,1000774,여의대방로46길,474,150,324
2017,4,A,골목상권,1000773,여의대방로24길,17503,8680,8823
2017,4,A,골목상권,1000772,여의대방로22카길,289,115,174
2017,4,A,골목상권,1000771,여의대방로22나길,138,57,81
2017,4,A,골목상권,1000770,여의대방로22길,214,120,94
2017,4,A,골목상권,1000769,양녕로26길,129,60,69
2017,4,A,골목상권,1000768,신대방길,107,68,39
2017,4,A,골목상권,1000767,성대로29길,2,2,0
2017,4,A,골목상권,1000766,성대로1길,315,130,185
2017,4,A,골목상권,1000765,서달로8가길,264,104,160
2017,4,A,골목상권,1000763,서달로14길,30,12,18
2017,4,A,골목상권,1000762,서달로10길,58,28,30
2017,4,A,골목상권,1000761,상도로62길,191,58,133
2017,4,A,골목상권,1000760,상도로61길,46,19,27
2017,4,A,골목상권,1000759,상도로47길,55,41,14
2017,4,A,골목상권,1000758,상도로37길,1918,938,980
2017,4,A,골목상권,1000757,상도로15길,330,144,186
2017,4,A,골목상권,1000756,사당로8길,118,64,54
2017,4,A,골목상권,1000755,사당로30길,314,211,103
2017,4,A,골목상권,1000754,사당로2차길,118,81,37
2017,4,A,골목상권,1000753,사당로29길,16,13,3
2017,4,A,골목상권,1000752,사당로26길,268,149,119
2017,4,A,골목상권,1000751,사당로23나길,130,39,91
2017,4,A,골목상권,1000750,사당로23길,13,9,4
2017,4,A,골목상권,1000749,사당로20길,194,144,50
2017,4,A,골목상권,1000748,사당로16길,136,41,95
2017,4,A,골목상권,1000747,사당로16가길,716,461,255
2017,4,A,골목상권,1000746,만양로8길,86,40,46
2017,4,A,골목상권,1000745,만양로14길,328,143,185
2017,4,A,골목상권,1000744,등용로14길,678,460,218
2017,4,A,골목상권,1000743,동작대로7길,1712,644,1068
2017,4,A,골목상권,1000742,동작대로35길,895,120,775
2017,4,A,골목상권,1000741,동작대로33길,116,63,53
2017,4,A,골목상권,1000740,동작대로29길,32,18,14
2017,4,A,골목상권,1000739,동작대로17길,1411,718,693
2017,4,A,골목상권,1000738,대방동2길,462,215,247
2017,4,A,골목상권,1000737,대방동27길,107,61,46
2017,4,A,골목상권,1000736,노량진로6길,107,28,79
2017,4,A,골목상권,1000735,국사봉길,38,6,32
2017,4,A,골목상권,1000734,국사봉2길,53,19,34
2017,4,A,골목상권,1000733,국사봉1길,7,3,4
2017,4,A,골목상권,1000732,영신로9길,333,176,157
2017,4,A,골목상권,1000731,영등포로84길,406,96,310
2017,4,A,골목상권,1000730,영등포로80길,52,24,28
2017,4,A,골목상권,1000729,영등포로62길,2,2,0
2017,4,A,골목상권,1000728,영등포로35길,89,56,33
2017,4,A,골목상권,1000727,영등포로27길,323,187,136
2017,4,A,골목상권,1000724,여의대방로43나길,2158,1708,450
2017,4,A,골목상권,1000723,여의대방로39길,14,10,4
2017,4,A,골목상권,1000722,여의대방로35길,817,426,391
2017,4,A,골목상권,1000721,양평로28길,599,470,129
2017,4,A,골목상권,1000720,양평로22라길,29,14,15
2017,4,A,골목상권,1000719,양평로19길,4405,3439,966
2017,4,A,골목상권,1000718,신길로60길,497,184,313
2017,4,A,골목상권,1000717,신길로42길,377,174,203
2017,4,A,골목상권,1000716,신길로42가길,101,36,65
2017,4,A,골목상권,1000715,신길로39길,112,49,63
2017,4,A,골목상권,1000714,신길로17길,48,33,15
2017,4,A,골목상권,1000713,선유서로28길,389,212,177
2017,4,A,골목상권,1000712,선유서로25길,2516,1819,697
2017,4,A,골목상권,1000711,선유서로24길,134,78,56
2017,4,A,골목상권,1000710,선유로55길,2446,1497,949
2017,4,A,골목상권,1000709,디지털로74길,46,28,18
2017,4,A,골목상권,1000708,디지털로57길,6,3,3
2017,4,A,골목상권,1000707,디지털로37길,211,93,118
2017,4,A,골목상권,1000706,도신로62길,184,57,127
2017,4,A,골목상권,1000705,도신로60길,74,12,62
2017,4,A,골목상권,1000704,도신로29길,85,38,47
2017,4,A,골목상권,1000703,도신로15길,80,39,41
2017,4,A,골목상권,1000702,도림천로21길,77,33,44
2017,4,A,골목상권,1000701,도림로63길,37,26,11
2017,4,A,골목상권,1000700,도림로147길,1709,1243,466
2017,4,A,골목상권,1000699,도림로112길,14,12,2
2017,4,A,골목상권,1000698,대림로8길,1839,589,1250
2017,4,A,골목상권,1000697,대림로7길,9,5,4
2017,4,A,골목상권,1000696,대림로44길,25,15,10
2017,4,A,골목상권,1000695,대림로34길,188,76,112
2017,4,A,골목상권,1000694,대림로31길,1043,548,495
2017,4,A,골목상권,1000693,대림로29길,1681,800,881
2017,4,A,골목상권,1000692,대림로22길,361,200,161
2017,4,A,골목상권,1000691,당산로46길,4479,2666,1813
2017,4,A,골목상권,1000690,당산로38길,172,114,58
2017,4,A,골목상권,1000689,당산로37길,3971,2595,1376
2017,4,A,골목상권,1000688,당산로31길,4319,2309,2010
2017,4,A,골목상권,1000687,국회대로56길,1675,1079,596
2017,4,A,골목상권,1000686,경인로90길,323,182,141
2017,4,A,골목상권,1000685,경인로80길,1545,1091,454
2017,4,A,골목상권,1000684,경인로77길,697,450,247
2017,4,A,골목상권,1000683,가마산로61길,196,71,125
2017,4,A,골목상권,1000682,시흥대로94길,687,346,341
2017,4,A,골목상권,1000681,시흥대로84길,186,76,110
2017,4,A,골목상권,1000680,시흥대로68길,751,201,550
2017,4,A,골목상권,1000679,시흥대로63길,2941,1455,1486
2017,4,A,골목상권,1000678,시흥대로62가길,437,116,321
2017,4,A,골목상권,1000677,시흥대로36길,386,228,158
2017,4,A,골목상권,1000676,시흥대로22길,478,332,146
2017,4,A,골목상권,1000675,시흥대로153길,664,384,280
2017,4,A,골목상권,1000674,시흥대로150길,537,249,288
2017,4,A,골목상권,1000673,시흥대로141길,656,389,267
2017,4,A,골목상권,1000672,시흥대로138길,18,10,8
2017,4,A,골목상권,1000671,시흥대로120길,501,323,178
2017,4,A,골목상권,1000670,벚꽃로56길,1863,1315,548
2017,4,A,골목상권,1000669,범안로17길,145,86,59
2017,4,A,골목상권,1000668,범안로11길,1095,859,236
2017,4,A,골목상권,1000667,문성로5길,162,51,111
2017,4,A,골목상권,1000666,독산로85길,93,24,69
2017,4,A,골목상권,1000665,독산로78다길,219,93,126
2017,4,A,골목상권,1000664,독산로70길,2,2,0
2017,4,A,골목상권,1000663,독산로64길,114,28,86
2017,4,A,골목상권,1000662,독산로50길,93,37,56
2017,4,A,골목상권,1000661,독산로40길,53,19,34
2017,4,A,골목상권,1000660,독산로108길,715,340,375
2017,4,A,골목상권,1000659,남부순환로112길,9,4,5
2017,4,A,골목상권,1000658,금하로24길,205,66,139
2017,4,A,골목상권,1000657,금하로1길,70,32,38
2017,4,A,골목상권,1000656,금하로14길,21,8,13
2017,4,A,골목상권,1000655,가산로5길,592,465,127
2017,4,A,골목상권,1000654,가산로3길,2351,1800,551
2017,4,A,골목상권,1000653,중앙로1길,1508,1058,450
2017,4,A,골목상권,1000652,중앙로15길,89,42,47
2017,4,A,골목상권,1000651,우마길,35,21,14
2017,4,A,골목상권,1000650,오류로8길,210,97,113
2017,4,A,골목상권,1000649,신도림로13길,779,581,198
2017,4,A,골목상권,1000648,새말로18길,1067,442,625
2017,4,A,골목상권,1000647,부일로1길,759,607,152
2017,4,A,골목상권,1000646,부일로15길,182,150,32
2017,4,A,골목상권,1000645,부일로11길,27,7,20
2017,4,A,골목상권,1000644,디지털로32길,1101,565,536
2017,4,A,골목상권,1000643,디지털로32가길,7234,4978,2256
2017,4,A,골목상권,1000642,디지털로27길,388,250,138
2017,4,A,골목상권,1000641,도림로6길,114,48,66
2017,4,A,골목상권,1000640,도림로12길,97,37,60
2017,4,A,골목상권,1000639,남부순환로97길,269,86,183
2017,4,A,골목상권,1000638,구로중앙로8길,214,76,138
2017,4,A,골목상권,1000637,구로중앙로7길,192,70,122
2017,4,A,골목상권,1000636,구로중앙로42길,806,605,201
2017,4,A,골목상권,1000635,구로중앙로34길,563,323,240
2017,4,A,골목상권,1000634,구로중앙로28길,3163,1519,1644
2017,4,A,골목상권,1000633,구로중앙로19길,10,6,4
2017,4,A,골목상권,1000632,구로동로8길,140,41,99
2017,4,A,골목상권,1000631,구로동로7길,168,62,106
2017,4,A,골목상권,1000630,구로동로42길,21,14,7
2017,4,A,골목상권,1000629,구로동로41길,447,282,165
2017,4,A,골목상권,1000628,구로동로38길,36,14,22
2017,4,A,골목상권,1000627,구로동로28길,197,90,107
2017,4,A,골목상권,1000626,구로동로15길,25,4,21
2017,4,A,골목상권,1000625,공원로6가길,292,200,92
2017,4,A,골목상권,1000624,고척로52길,221,62,159
2017,4,A,골목상권,1000623,고척로27다길,210,79,131
2017,4,A,골목상권,1000622,고척로27길,241,111,130
2017,4,A,골목상권,1000621,고척로21나길,214,54,160
2017,4,A,골목상권,1000620,경인로47길,915,509,406
2017,4,A,골목상권,1000619,경인로35길,287,116,171
2017,4,A,골목상권,1000618,경인로31길,54,19,35
2017,4,A,골목상권,1000617,경인로15길,149,65,84
2017,4,A,골목상권,1000616,개봉로3길,260,168,92
2017,4,A,골목상권,1000615,개봉로2길,487,134,353
2017,4,A,골목상권,1000614,개봉로23가길,837,480,357
2017,4,A,골목상권,1000613,개봉로20길,130,74,56
2017,4,A,골목상권,1000612,개봉로1길,52,26,26
2017,4,A,골목상권,1000611,개봉로17다길,191,96,95
2017,4,A,골목상권,1000610,개봉로17길,870,357,513
2017,4,A,골목상권,1000609,개봉로11길,43,6,37
2017,4,A,골목상권,1000608,화곡로64길,1606,921,685
2017,4,A,골목상권,1000607,화곡로59길,478,198,280
2017,4,A,골목상권,1000606,화곡로44나길,804,678,126
2017,4,A,골목상권,1000605,화곡로31길,1174,448,726
2017,4,A,골목상권,1000604,화곡로20길,503,316,187
2017,4,A,골목상권,1000603,화곡로13길,272,95,177
2017,4,A,골목상권,1000602,초원로16길,669,284,385
2017,4,A,골목상권,1000601,초록마을로8길,177,37,140
2017,4,A,골목상권,1000600,초록마을로3길,45,22,23
2017,4,A,골목상권,1000599,월정로20길,4,2,2
2017,4,A,골목상권,1000598,우장산로6길,315,176,139
2017,4,A,골목상권,1000597,양천로73가길,1307,828,479
2017,4,A,골목상권,1000596,양천로71길,215,133,82
2017,4,A,골목상권,1000595,양천로49길,735,574,161
2017,4,A,골목상권,1000594,양천로26길,163,73,90
2017,4,A,골목상권,1000593,양천로24길,360,147,213
2017,4,A,골목상권,1000592,양천로24가길,735,347,388
2017,4,A,골목상권,1000591,양천로14길,239,142,97
2017,4,A,골목상권,1000590,방화대로6라길,782,487,295
2017,4,A,골목상권,1000589,방화대로21길,860,515,345
2017,4,A,골목상권,1000588,등촌로5길,10,3,7
2017,4,A,골목상권,1000587,등촌로55길,519,354,165
2017,4,A,골목상권,1000586,등촌로51길,16,10,6
2017,4,A,골목상권,1000585,등촌로39길,69,26,43
2017,4,A,골목상권,1000584,등촌로13길,195,103,92
2017,4,A,골목상권,1000583,남부순환로11길,413,280,133
2017,4,A,골목상권,1000582,까치산로4길,149,59,90
2017,4,A,골목상권,1000581,국회대로7길,396,235,161
2017,4,A,골목상권,1000580,공항대로8길,201,76,125
2017,4,A,골목상권,1000579,공항대로61길,203,137,66
2017,4,A,골목상권,1000578,공항대로59다길,925,664,261
2017,4,A,골목상권,1000577,공항대로59길,1120,726,394
2017,4,A,골목상권,1000576,공항대로55길,1086,726,360
2017,4,A,골목상권,1000575,공항대로42길,9,5,4
2017,4,A,골목상권,1000574,공항대로38길,271,143,128
2017,4,A,골목상권,1000573,곰달래로60길,554,298,256
2017,4,A,골목상권,1000572,곰달래로53길,60,18,42
2017,4,A,골목상권,1000571,곰달래로47길,40,15,25
2017,4,A,골목상권,1000570,곰달래로31길,9,7,2
2017,4,A,골목상권,1000569,곰달래로25길,778,273,505
2017,4,A,골목상권,1000568,개화동로25길,657,431,226
2017,4,A,골목상권,1000567,개화동로23길,128,86,42
2017,4,A,골목상권,1000566,강서로8길,150,80,70
2017,4,A,골목상권,1000565,강서로5라길,303,182,121
2017,4,A,골목상권,1000564,강서로5나길,100,57,43
2017,4,A,골목상권,1000563,강서로5가길,48,25,23
2017,4,A,골목상권,1000562,강서로47라길,121,56,65
2017,4,A,골목상권,1000561,강서로47길,379,202,177
2017,4,A,골목상권,1000560,강서로45다길,539,349,190
2017,4,A,골목상권,1000559,강서로45길,141,59,82
2017,4,A,골목상권,1000558,강서로35길,173,99,74
2017,4,A,골목상권,1000557,강서로29길,386,171,215
2017,4,A,골목상권,1000556,강서로18길,28,12,16
2017,4,A,골목상권,1000555,강서로17가길,120,52,68
2017,4,A,골목상권,1000554,강서로15길,303,146,157
2017,4,A,골목상권,1000553,가로공원로80길,48,23,25
2017,4,A,골목상권,1000552,가로공원로76가길,24,10,14
2017,4,A,골목상권,1000551,화곡로4길,235,86,149
2017,4,A,골목상권,1000550,화곡로3길,163,57,106
2017,4,A,골목상권,1000549,지양로7길,223,73,150
2017,4,A,골목상권,1000548,중앙로55길,367,190,177
2017,4,A,골목상권,1000547,중앙로51길,141,86,55
2017,4,A,골목상권,1000546,중앙로47길,120,25,95
2017,4,A,골목상권,1000545,중앙로45길,155,53,102
2017,4,A,골목상권,1000544,중앙로36길,2,2,0
2017,4,A,골목상권,1000543,중앙로32길,607,294,313
2017,4,A,골목상권,1000542,중앙로25길,240,64,176
2017,4,A,골목상권,1000541,은행정로7길,495,169,326
2017,4,A,골목상권,1000539,오목로5길,311,185,126
2017,4,A,골목상권,1000538,오목로3길,401,377,24
2017,4,A,골목상권,1000537,오목로30길,140,73,67
2017,4,A,골목상권,1000536,오목로23길,790,464,326
2017,4,A,골목상권,1000535,신월로20길,215,78,137
2017,4,A,골목상권,1000534,신월로15길,767,357,410
2017,4,A,골목상권,1000533,신목로6길,240,132,108
2017,4,A,골목상권,1000532,신목로5길,871,333,538
2017,4,A,골목상권,1000531,신목로2길,104,47,57
2017,4,A,골목상권,1000530,목동중앙서로8가길,190,110,80
2017,4,A,골목상권,1000529,목동중앙서로7길,231,71,160
2017,4,A,골목상권,1000528,목동중앙북로8길,348,115,233
2017,4,A,골목상권,1000527,목동중앙북로16길,257,68,189
2017,4,A,골목상권,1000526,목동중앙본로7길,105,42,63
2017,4,A,골목상권,1000525,목동중앙로3길,119,66,53
2017,4,A,골목상권,1000524,목동중앙로13나길,284,207,77
2017,4,A,골목상권,1000523,목동중앙남로3가길,537,358,179
2017,4,A,골목상권,1000522,목동로9길,2315,1468,847
2017,4,A,골목상권,1000521,목동로19길,987,354,633
2017,4,A,골목상권,1000519,목동동로12길,389,140,249
2017,4,A,골목상권,1000518,목동남로4길,11,5,6
2017,4,A,골목상권,1000517,남부순환로88길,276,124,152
2017,4,A,골목상권,1000516,남부순환로79길,377,284,93
2017,4,A,골목상권,1000515,남부순환로70길,522,314,208
2017,4,A,골목상권,1000514,남부순환로58길,195,118,77
2017,4,A,골목상권,1000513,남부순환로40길,15,6,9
2017,4,A,골목상권,1000512,남부순환로33길,1183,976,207
2017,4,A,골목상권,1000511,곰달래로5길,59,35,24
2017,4,A,골목상권,1000510,곰달래로3길,381,203,178
2017,4,A,골목상권,1000509,곰달래로2길,305,167,138
2017,4,A,골목상권,1000508,곰달래로10길,334,236,98
2017,4,A,골목상권,1000507,가로공원로58길,76,15,61
2017,4,A,골목상권,1000506,효창원로93길,93,47,46
2017,4,A,골목상권,1000505,토정로37길,140,62,78
2017,4,A,골목상권,1000504,월드컵로8길,1788,913,875
2017,4,A,골목상권,1000503,월드컵로7길,4,2,2
2017,4,A,골목상권,1000502,월드컵로36길,144,59,85
2017,4,A,골목상권,1000501,월드컵로25길,278,162,116
2017,4,A,골목상권,1000500,월드컵로19길,568,300,268
2017,4,A,골목상권,1000499,월드컵로16길,4043,2077,1966
2017,4,A,골목상권,1000498,월드컵로11길,240,91,149
2017,4,A,골목상권,1000497,월드컵로10길,1716,908,808
2017,4,A,골목상권,1000496,와우산로3길,181,104,77
2017,4,A,골목상권,1000495,와우산로29길,178,94,84
2017,4,A,골목상권,1000494,와우산로29가길,18,9,9
2017,4,A,골목상권,1000493,양화진길,509,361,148
2017,4,A,골목상권,1000492,양화로1길,4158,1962,2196
2017,4,A,골목상권,1000491,양화로11길,440,292,148
2017,4,A,골목상권,1000490,신촌로30길,26,17,9
2017,4,A,골목상권,1000489,신촌로28가길,102,39,63
2017,4,A,골목상권,1000488,신촌로12길,1467,665,802
2017,4,A,골목상권,1000487,숭문길,5265,4008,1257
2017,4,A,골목상권,1000486,숭문8길,116,69,47
2017,4,A,골목상권,1000485,성지3길,485,232,253
2017,4,A,골목상권,1000484,성산로4길,1686,1028,658
2017,4,A,골목상권,1000483,성미산로32길,403,203,200
2017,4,A,골목상권,1000482,성미산로1길,638,462,176
2017,4,A,골목상권,1000481,성미산로11길,1042,709,333
2017,4,A,골목상권,1000480,백범로16길,745,375,370
2017,4,A,골목상권,1000479,방울내로9안길,323,196,127
2017,4,A,골목상권,1000478,모래내로7길,263,127,136
2017,4,A,골목상권,1000477,매봉산로2길,1597,970,627
2017,4,A,골목상권,1000476,망원로2길,242,145,97
2017,4,A,골목상권,1000475,망원로11길,1105,624,481
2017,4,A,골목상권,1000474,만리재옛길,1433,618,815
2017,4,A,골목상권,1000473,마포대로4길,176,93,83
2017,4,A,골목상권,1000472,마포대로20길,1147,601,546
2017,4,A,골목상권,1000471,마포대로12길,68,36,32
2017,4,A,골목상권,1000470,동교로38길,238,123,115
2017,4,A,골목상권,1000469,동교로27길,3408,1524,1884
2017,4,A,골목상권,1000468,동교로25길,545,252,293
2017,4,A,골목상권,1000467,동교로19길,4191,2771,1420
2017,4,A,골목상권,1000466,동교로17길,732,371,361
2017,4,A,골목상권,1000465,독막로8길,319,141,178
2017,4,A,골목상권,1000464,독막로32길,479,207,272
2017,4,A,골목상권,1000463,독막로22길,108,61,47
2017,4,A,골목상권,1000462,도화길,1004,502,502
2017,4,A,골목상권,1000461,도화4길,401,135,266
2017,4,A,골목상권,1000460,대흥로28길,48,41,7
2017,4,A,골목상권,1000459,대흥로21길,458,83,375
2017,4,A,골목상권,1000458,광성로6길,160,102,58
2017,4,A,골목상권,1000457,홍제내길,119,67,52
2017,4,A,골목상권,1000456,홍연길,85,49,36
2017,4,A,골목상권,1000455,통일로39길,5,5,0
2017,4,A,골목상권,1000454,통일로37길,352,129,223
2017,4,A,골목상권,1000453,통일로11길,10,8,2
2017,4,A,골목상권,1000452,충정로6길,13125,8089,5036
2017,4,A,골목상권,1000451,충정로4길,3103,2037,1066
2017,4,A,골목상권,1000450,증가로6길,215,104,111
2017,4,A,골목상권,1000449,증가로23나길,485,254,231
2017,4,A,골목상권,1000448,증가로20가길,253,93,160
2017,4,A,골목상권,1000447,증가로10길,160,80,80
2017,4,A,골목상권,1000446,응암로1길,384,277,107
2017,4,A,골목상권,1000445,연희로10길,114,75,39
2017,4,A,골목상권,1000444,신촌로37길,101,50,51
2017,4,A,골목상권,1000443,수색로8길,2820,2621,199
2017,4,A,골목상권,1000442,세무서길,328,110,218
2017,4,A,골목상권,1000440,세검정로1길,415,181,234
2017,4,A,골목상권,1000439,북아현로4길,430,93,337
2017,4,A,골목상권,1000438,모래내로15길,106,33,73
2017,4,A,골목상권,1000437,명지대길,402,289,113
2017,4,A,골목상권,1000436,독립문로8길,732,278,454
2017,4,A,골목상권,1000435,가재울로6길,20,12,8
2017,4,A,골목상권,1000434,통일로92길,86,35,51
2017,4,A,골목상권,1000433,통일로87길,203,90,113
2017,4,A,골목상권,1000432,통일로78길,224,65,159
2017,4,A,골목상권,1000430,진흥로1길,523,162,361
2017,4,A,골목상권,1000429,진흥로12길,502,208,294
2017,4,A,골목상권,1000428,증산서길,397,278,119
2017,4,A,골목상권,1000427,증산로9길,92,29,63
2017,4,A,골목상권,1000426,증산로5길,781,400,381
2017,4,A,골목상권,1000425,증산로21길,238,150,88
2017,4,A,골목상권,1000424,증산로17길,755,298,457
2017,4,A,골목상권,1000423,증산로15길,214,81,133
2017,4,A,골목상권,1000422,증산로13길,73,36,37
2017,4,A,골목상권,1000421,응암로34길,57,36,21
2017,4,A,골목상권,1000420,응암로22길,154,54,100
2017,4,A,골목상권,1000419,응암로14길,371,123,248
2017,4,A,골목상권,1000418,응암로13길,293,121,172
2017,4,A,골목상권,1000417,응암로12길,205,114,91
2017,4,A,골목상권,1000416,은평로8길,245,125,120
2017,4,A,골목상권,1000415,은평로3길,301,95,206
2017,4,A,골목상권,1000414,은평로20길,18,8,10
2017,4,A,골목상권,1000413,은평로13길,375,236,139
2017,4,A,골목상권,1000412,은평로10길,284,128,156
2017,4,A,골목상권,1000411,연서로5길,44,13,31
2017,4,A,골목상권,1000410,연서로41길,240,76,164
2017,4,A,골목상권,1000409,연서로3길,104,40,64
2017,4,A,골목상권,1000408,연서로34길,161,59,102
2017,4,A,골목상권,1000407,연서로33길,30,10,20
2017,4,A,골목상권,1000406,연서로29길,300,101,199
2017,4,A,골목상권,1000405,연서로28길,839,386,453
2017,4,A,골목상권,1000404,연서로27길,80,23,57
2017,4,A,골목상권,1000403,연서로21길,297,167,130
2017,4,A,골목상권,1000402,연서로17길,1188,353,835
2017,4,A,골목상권,1000401,연서로16길,265,98,167
2017,4,A,골목상권,1000400,연서로13길,730,217,513
2017,4,A,골목상권,1000399,연서로11길,234,110,124
2017,4,A,골목상권,1000398,역말로9길,22,15,7
2017,4,A,골목상권,1000397,수색로18길,24,12,12
2017,4,A,골목상권,1000396,서오릉로8길,12,0,12
2017,4,A,골목상권,1000395,서오릉로21길,418,100,318
2017,4,A,골목상권,1000394,불광천길,189,93,96
2017,4,A,골목상권,1000393,갈현로7길,930,257,673
2017,4,A,골목상권,1000392,갈현로41길,95,35,60
2017,4,A,골목상권,1000391,갈현로33길,36,8,28
2017,4,A,골목상권,1000390,갈현로1길,168,74,94
2017,4,A,골목상권,1000389,가좌로7길,68,35,33
2017,4,A,골목상권,1000388,한글비석로44길,405,222,183
2017,4,A,골목상권,1000387,한글비석로24길,407,159,248
2017,4,A,골목상권,1000386,한글비석로22길,706,326,380
2017,4,A,골목상권,1000385,석계로1길,100,61,39
2017,4,A,골목상권,1000384,상계로9가길,291,95,196
2017,4,A,골목상권,1000382,상계로12길,25,15,10
2017,4,A,골목상권,1000381,동일로242길,301,190,111
2017,4,A,골목상권,1000380,동일로192길,469,202,267
2017,4,A,골목상권,1000379,동일로173가길,2329,1258,1071
2017,4,A,골목상권,1000378,공릉로58길,148,45,103
2017,4,A,골목상권,1000377,해등로16길,69,55,14
2017,4,A,골목상권,1000376,우이천로4다길,181,109,72
2017,4,A,골목상권,1000375,우이천로32길,87,53,34
2017,4,A,골목상권,1000374,시루봉로23길,49,21,28
2017,4,A,골목상권,1000373,삼양로144길,80,57,23
2017,4,A,골목상권,1000372,방학로6가길,176,87,89
2017,4,A,골목상권,1000371,방학로5길,137,80,57
2017,4,A,골목상권,1000370,방학로15길,318,204,114
2017,4,A,골목상권,1000369,방학로10길,169,66,103
2017,4,A,골목상권,1000367,도봉산4길,316,277,39
2017,4,A,골목상권,1000366,도봉로181길,188,80,108
2017,4,A,골목상권,1000365,도봉로169나길,290,122,168
2017,4,A,골목상권,1000364,도봉로156길,281,142,139
2017,4,A,골목상권,1000363,도봉로152가길,416,365,51
2017,4,A,골목상권,1000362,도봉로147길,533,308,225
2017,4,A,골목상권,1000360,도봉로114길,514,175,339
2017,4,A,골목상권,1000359,도봉로109길,26,9,17
2017,4,A,골목상권,1000358,도당로29길,863,500,363
2017,4,A,골목상권,1000357,도당로19길,162,72,90
2017,4,A,골목상권,1000356,도당로13바길,188,74,114
2017,4,A,골목상권,1000355,도당로13가길,167,69,98
2017,4,A,골목상권,1000354,덕릉로60길,82,49,33
2017,4,A,골목상권,1000353,노해로63다길,612,258,354
2017,4,A,골목상권,1000352,노해로60길,325,141,184
2017,4,A,골목상권,1000351,한천로140길,103,50,53
2017,4,A,골목상권,1000350,한천로139가길,52,31,21
2017,4,A,골목상권,1000349,한천로132길,321,118,203
2017,4,A,골목상권,1000348,한천로130길,274,113,161
2017,4,A,골목상권,1000347,한천로124나길,111,66,45
2017,4,A,골목상권,1000346,한천로109길,605,259,346
2017,4,A,골목상권,1000345,인수봉로79길,171,44,127
2017,4,A,골목상권,1000344,인수봉로72길,85,40,45
2017,4,A,골목상권,1000342,오패산로67길,579,288,291
2017,4,A,골목상권,1000341,오패산로52길,97,34,63
2017,4,A,골목상권,1000339,수유로12길,250,164,86
2017,4,A,골목상권,1000338,솔샘로65길,506,240,266
2017,4,A,골목상권,1000337,솔매로50길,717,285,432
2017,4,A,골목상권,1000336,솔매로45길,171,84,87
2017,4,A,골목상권,1000335,솔매로41길,87,21,66
2017,4,A,골목상권,1000334,삼양로93길,18,4,14
2017,4,A,골목상권,1000333,삼양로77길,432,149,283
2017,4,A,골목상권,1000332,삼양로54길,8,4,4
2017,4,A,골목상권,1000331,삼양로41길,310,149,161
2017,4,A,골목상권,1000329,삼양로24길,82,39,43
2017,4,A,골목상권,1000328,삼양로20길,127,47,80
2017,4,A,골목상권,1000327,삼각산로28길,823,415,408
2017,4,A,골목상권,1000326,도봉로99길,220,104,116
2017,4,A,골목상권,1000325,도봉로8길,251,192,59
2017,4,A,골목상권,1000324,도봉로76길,397,210,187
2017,4,A,골목상권,1000323,도봉로67길,6,3,3
2017,4,A,골목상권,1000322,도봉로45길,115,70,45
2017,4,A,골목상권,1000321,도봉로18길,374,178,196
2017,4,A,골목상권,1000320,도봉로13길,35,9,26
2017,4,A,골목상권,1000319,덕릉로41길,792,625,167
2017,4,A,골목상권,1000318,덕릉로40길,895,692,203
2017,4,A,골목상권,1000317,노해로33길,34,13,21
2017,4,A,골목상권,1000315,노해로17길,239,69,170
2017,4,A,골목상권,1000314,화랑로40길,172,96,76
2017,4,A,골목상권,1000313,화랑로32길,471,349,122
2017,4,A,골목상권,1000312,화랑로1길,159,85,74
2017,4,A,골목상권,1000311,화랑로19길,498,267,231
2017,4,A,골목상권,1000310,화랑로14길,43,20,23
2017,4,A,골목상권,1000309,화랑로13길,86,44,42
2017,4,A,골목상권,1000308,한천로76길,129,73,56
2017,4,A,골목상권,1000307,한천로101가길,37,23,14
2017,4,A,골목상권,1000306,창경궁로43길,37,23,14
2017,4,A,골목상권,1000305,지봉로20길,98,58,40
2017,4,A,골목상권,1000304,종암로5길,117,80,37
2017,4,A,골목상권,1000303,종암로24가길,303,143,160
2017,4,A,골목상권,1000302,종암로21길,258,48,210
2017,4,A,골목상권,1000301,종암로19길,391,119,272
2017,4,A,골목상권,1000300,종암로16길,86,40,46
2017,4,A,골목상권,1000299,정릉로8길,189,112,77
2017,4,A,골목상권,1000298,정릉로27길,194,86,108
2017,4,A,골목상권,1000296,장위로50길,860,479,381
2017,4,A,골목상권,1000295,장월로1길,345,188,157
2017,4,A,골목상권,1000294,인촌로6길,2937,1680,1257
2017,4,A,골목상권,1000293,인촌로5길,24,2,22
2017,4,A,골목상권,1000292,인촌로24길,216,146,70
2017,4,A,골목상권,1000291,개운사길,3612,2193,1419
2017,4,A,골목상권,1000290,인촌로1길,154,105,49
2017,4,A,골목상권,1000289,인촌로17가길,3260,1162,2098
2017,4,A,골목상권,1000288,오패산로4길,651,204,447
2017,4,A,골목상권,1000287,오패산로3길,1230,713,517
2017,4,A,골목상권,1000286,오패산로19길,42,17,25
2017,4,A,골목상권,1000285,안암로5길,616,385,231
2017,4,A,골목상권,1000284,아리랑로4길,562,213,349
2017,4,A,골목상권,1000283,솔샘로6길,157,72,85
2017,4,A,골목상권,1000282,성북로8길,53,21,32
2017,4,A,골목상권,1000281,삼양로8길,77,51,26
2017,4,A,골목상권,1000280,삼선교로16가길,715,409,306
2017,4,A,골목상권,1000279,삼선교로10다길,100,44,56
2017,4,A,골목상권,1000278,삼선교로10길,280,126,154
2017,4,A,골목상권,1000277,보문로32길,1000,407,593
2017,4,A,골목상권,1000276,보문로31길,706,291,415
2017,4,A,골목상권,1000274,보문로13길,824,511,313
2017,4,A,골목상권,1000273,보국문로16길,371,247,124
2017,4,A,골목상권,1000270,동소문로26가길,217,99,118
2017,4,A,골목상권,1000269,동소문로15길,120,51,69
2017,4,A,골목상권,1000268,동소문로13길,432,224,208
2017,4,A,골목상권,1000267,돌곶이로8길,190,92,98
2017,4,A,골목상권,1000266,돌곶이로41길,47,22,25
2017,4,A,골목상권,1000265,돌곶이로28길,223,137,86
2017,4,A,골목상권,1000264,돌곶이로27길,75,40,35
2017,4,A,골목상권,1000263,돌곶이로22길,125,62,63
2017,4,A,골목상권,1000261,길음로7길,8,5,3
2017,4,A,골목상권,1000260,중랑천로10길,766,392,374
2017,4,A,골목상권,1000259,용마산로94길,441,270,171
2017,4,A,골목상권,1000258,용마산로118길,565,284,281
2017,4,A,골목상권,1000257,용마산로112길,326,132,194
2017,4,A,골목상권,1000256,용마산로100길,425,294,131
2017,4,A,골목상권,1000255,신내로7가길,266,66,200
2017,4,A,골목상권,1000254,사가정로54길,119,35,84
2017,4,A,골목상권,1000253,사가정로42길,86,24,62
2017,4,A,골목상권,1000252,봉화산로56길,578,155,423
2017,4,A,골목상권,1000251,봉화산로4길,386,135,251
2017,4,A,골목상권,1000250,봉화산로30길,326,196,130
2017,4,A,골목상권,1000249,봉우재로33길,96,37,59
2017,4,A,골목상권,1000248,면목로78길,270,151,119
2017,4,A,골목상권,1000247,면목로56길,213,162,51
2017,4,A,골목상권,1000246,면목로55길,354,107,247
2017,4,A,골목상권,1000245,면목로49길,530,173,357
2017,4,A,골목상권,1000244,면목로48길,114,54,60
2017,4,A,골목상권,1000243,면목로45길,60,26,34
2017,4,A,골목상권,1000242,면목로33길,379,149,230
2017,4,A,골목상권,1000241,면목로21길,31,25,6
2017,4,A,골목상권,1000240,망우로73길,8,4,4
2017,4,A,골목상권,1000239,망우로68길,86,32,54
2017,4,A,골목상권,1000238,동일로163길,93,60,33
2017,4,A,골목상권,1000237,동일로157길,221,120,101
2017,4,A,골목상권,1000236,동일로149길,1140,842,298
2017,4,A,골목상권,1000235,동일로140길,208,80,128
2017,4,A,골목상권,1000234,동일로139길,68,40,28
2017,4,A,골목상권,1000233,동일로139가길,1149,666,483
2017,4,A,골목상권,1000232,동일로130길,95,21,74
2017,4,A,골목상권,1000231,동일로123길,172,90,82
2017,4,A,골목상권,1000230,동일로112길,157,65,92
2017,4,A,골목상권,1000229,동일로101길,273,109,164
2017,4,A,골목상권,1000228,동일로100길,83,38,45
2017,4,A,골목상권,1000227,답십리로75길,96,47,49
2017,4,A,골목상권,1000226,공릉로2길,649,302,347
2017,4,A,골목상권,1000225,공릉로12가길,29,19,10
2017,4,A,골목상권,1000224,겸재로54길,122,53,69
2017,4,A,골목상권,1000223,겸재로36길,239,197,42
2017,4,A,골목상권,1000222,겸재로29길,424,171,253
2017,4,A,골목상권,1000221,휘경로3길,207,99,108
2017,4,A,골목상권,1000220,휘경로2길,7,2,5
2017,4,A,골목상권,1000219,휘경로23길,19,4,15
2017,4,A,골목상권,1000218,휘경로14길,103,42,61
2017,4,A,골목상권,1000217,한천로46길,363,110,253
2017,4,A,골목상권,1000216,한천로40길,305,151,154
2017,4,A,골목상권,1000215,한천로33길,80,36,44
2017,4,A,골목상권,1000214,한천로14길,580,348,232
2017,4,A,골목상권,1000213,천호대로97길,339,214,125
2017,4,A,골목상권,1000212,천호대로77길,1994,1050,944
2017,4,A,골목상권,1000211,천호대로45길,130,70,60
2017,4,A,골목상권,1000210,천호대로17길,2258,1465,793
2017,4,A,골목상권,1000209,천호대로12길,839,557,282
2017,4,A,골목상권,1000208,천장산로7길,1496,909,587
2017,4,A,골목상권,1000207,제기로5길,223,103,120
2017,4,A,골목상권,1000206,제기로21길,217,140,77
2017,4,A,골목상권,1000205,전농로4길,705,442,263
2017,4,A,골목상권,1000204,전농로3길,73,34,39
2017,4,A,골목상권,1000203,전농로29길,323,146,177
2017,4,A,골목상권,1000202,장한로8길,802,464,338
2017,4,A,골목상권,1000201,장한로5길,2968,2104,864
2017,4,A,골목상권,1000200,장한로27길,137,39,98
2017,4,A,골목상권,1000199,장한로27가길,435,199,236
2017,4,A,골목상권,1000198,장한로26길,552,255,297
2017,4,A,골목상권,1000197,장한로26가길,340,146,194
2017,4,A,골목상권,1000196,장한로25길,1015,450,565
2017,4,A,골목상권,1000195,장한로14길,182,151,31
2017,4,A,골목상권,1000194,이문로42길,240,100,140
2017,4,A,골목상권,1000193,왕산로43길,991,477,514
2017,4,A,골목상권,1000192,왕산로33길,150,99,51
2017,4,A,골목상권,1000191,왕산로32길,9,7,2
2017,4,A,골목상권,1000190,약령시로17길,295,130,165
2017,4,A,골목상권,1000189,서울시립대로4길,619,322,297
2017,4,A,골목상권,1000188,서울시립대로29길,237,128,109
2017,4,A,골목상권,1000187,서울시립대로16길,131,32,99
2017,4,A,골목상권,1000186,사가정로2길,83,67,16
2017,4,A,골목상권,1000185,사가정로23가길,97,60,37
2017,4,A,골목상권,1000184,사가정로13길,269,82,187
2017,4,A,골목상권,1000183,무학로45길,354,211,143
2017,4,A,골목상권,1000182,무학로16길,1175,1078,97
2017,4,A,골목상권,1000181,망우로21길,198,111,87
2017,4,A,골목상권,1000180,망우로18길,373,127,246
2017,4,A,골목상권,1000179,망우로18가길,70,26,44
2017,4,A,골목상권,1000178,답십리로72길,5,3,2
2017,4,A,골목상권,1000177,답십리로69길,917,390,527
2017,4,A,골목상권,1000176,답십리로68길,111,68,43
2017,4,A,골목상권,1000175,답십리로64길,361,213,148
2017,4,A,골목상권,1000174,답십리로63길,80,45,35
2017,4,A,골목상권,1000173,답십리로60길,12,6,6
2017,4,A,골목상권,1000172,답십리로56길,5,5,0
2017,4,A,골목상권,1000171,답십리로23길,3,2,1
2017,4,A,골목상권,1000170,난계로30길,126,89,37
2017,4,A,골목상권,1000168,경희대로3길,274,179,95
2017,4,A,골목상권,1000167,천호대로129길,251,85,166
2017,4,A,골목상권,1000166,천호대로123길,274,108,166
2017,4,A,골목상권,1000165,천호대로109길,1147,618,529
2017,4,A,골목상권,1000164,자양번영로3길,88,33,55
2017,4,A,골목상권,1000163,자양로53길,2,0,2
2017,4,A,골목상권,1000162,자양로50길,19,6,13
2017,4,A,골목상권,1000161,자양로45길,580,301,279
2017,4,A,골목상권,1000160,자양로26길,320,116,204
2017,4,A,골목상권,1000159,자양로15길,326,222,104
2017,4,A,골목상권,1000158,자양로11길,1400,684,716
2017,4,A,골목상권,1000157,용마산로3길,942,529,413
2017,4,A,골목상권,1000156,용마산로21길,156,64,92
2017,4,A,골목상권,1000155,아차산로78길,2703,1387,1316
2017,4,A,골목상권,1000154,아차산로65길,731,490,241
2017,4,A,골목상권,1000153,아차산로55길,340,191,149
2017,4,A,골목상권,1000152,아차산로51길,249,147,102
2017,4,A,골목상권,1000151,아차산로40길,544,296,248
2017,4,A,골목상권,1000150,면목로17길,256,162,94
2017,4,A,골목상권,1000149,뚝섬로64길,327,177,150
2017,4,A,골목상권,1000148,뚝섬로58길,193,63,130
2017,4,A,골목상권,1000147,뚝섬로54길,194,131,63
2017,4,A,골목상권,1000146,뚝섬로48길,864,396,468
2017,4,A,골목상권,1000145,뚝섬로24길,90,28,62
2017,4,A,골목상권,1000144,뚝섬로23길,122,71,51
2017,4,A,골목상권,1000143,동일로24길,14,4,10
2017,4,A,골목상권,1000142,동일로18길,194,76,118
2017,4,A,골목상권,1000141,능동로4길,239,104,135
2017,4,A,골목상권,1000140,능동로3길,202,92,110
2017,4,A,골목상권,1000139,능동로34길,978,522,456
2017,4,A,골목상권,1000138,능동로19길,312,196,116
2017,4,A,골목상권,1000137,능동로13길,374,123,251
2017,4,A,골목상권,1000136,긴고랑로9길,52,26,26
2017,4,A,골목상권,1000135,긴고랑로8길,223,179,44
2017,4,A,골목상권,1000134,긴고랑로7길,517,259,258
2017,4,A,골목상권,1000133,긴고랑로20길,566,273,293
2017,4,A,골목상권,1000132,광나루로52길,1975,977,998
2017,4,A,골목상권,1000131,광나루로40길,125,57,68
2017,4,A,골목상권,1000130,광나루로37길,259,142,117
2017,4,A,골목상권,1000129,광나루로36길,51,31,20
2017,4,A,골목상권,1000128,광나루로24길,61,37,24
2017,4,A,골목상권,1000127,광나루로12길,1001,552,449
2017,4,A,골목상권,1000126,한림말길,59,33,26
2017,4,A,골목상권,1000124,청계천로10나길,1805,1063,742
2017,4,A,골목상권,1000123,장터길,41,13,28
2017,4,A,골목상권,1000122,용답중앙길,97,51,46
2017,4,A,골목상권,1000121,용답29길,1699,905,794
2017,4,A,골목상권,1000120,왕십리로6길,1421,780,641
2017,4,A,골목상권,1000119,왕십리로31길,107,52,55
2017,4,A,골목상권,1000118,왕십리로26길,3861,2479,1382
2017,4,A,골목상권,1000117,왕십리로21길,172,56,116
2017,4,A,골목상권,1000116,왕십리로14길,2853,2023,830
2017,4,A,골목상권,1000115,아차산로5길,2228,1463,765
2017,4,A,골목상권,1000114,아차산로15길,4349,3090,1259
2017,4,A,골목상권,1000113,아차산로11길,3643,2378,1265
2017,4,A,골목상권,1000112,송정4가길,1069,469,600
2017,4,A,골목상권,1000111,송정12라길,298,186,112
2017,4,A,골목상권,1000110,성수일로6길,2718,1665,1053
2017,4,A,골목상권,1000109,성수이로7길,528,308,220
2017,4,A,골목상권,1000108,성수이로18길,2450,1749,701
2017,4,A,골목상권,1000107,성덕정길,879,484,395
2017,4,A,골목상권,1000106,성덕정17길,233,126,107
2017,4,A,골목상권,1000105,서울숲2길,1212,679,533
2017,4,A,골목상권,1000104,상원길,1491,966,525
2017,4,A,골목상권,1000103,상원12길,175,104,71
2017,4,A,골목상권,1000102,사근동길,28,17,11
2017,4,A,골목상권,1000101,무학봉길,9,6,3
2017,4,A,골목상권,1000100,무학봉28길,136,59,77
2017,4,A,골목상권,1000099,무학로6길,383,217,166
2017,4,A,골목상권,1000098,무수막길,134,55,79
2017,4,A,골목상권,1000097,매봉길,9,6,3
2017,4,A,골목상권,1000096,마조로1길,213,79,134
2017,4,A,골목상권,1000095,마조로16길,812,567,245
2017,4,A,골목상권,1000094,마장로39길,115,45,70
2017,4,A,골목상권,1000093,마장로27길,84,25,59
2017,4,A,골목상권,1000091,둘레9길,390,229,161
2017,4,A,골목상권,1000090,금호산길,427,156,271
2017,4,A,골목상권,1000089,금호산2길,33,12,21
2017,4,A,골목상권,1000088,고산자로6길,9672,3415,6257
2017,4,A,골목상권,1000087,후암로28길,201,89,112
2017,4,A,골목상권,1000086,효창원로39길,46,29,17
2017,4,A,골목상권,1000085,회나무로13길,71,33,38
2017,4,A,골목상권,1000084,한남대로20길,732,422,310
2017,4,A,골목상권,1000082,한강대로7길,529,357,172
2017,4,A,골목상권,1000081,한강대로62길,748,507,241
2017,4,A,골목상권,1000080,한강대로52길,1107,708,399
2017,4,A,골목상권,1000079,한강대로43길,5982,3756,2226
2017,4,A,골목상권,1000078,한강대로15길,1553,338,1215
2017,4,A,골목상권,1000077,한강대로104길,10716,3983,6733
2017,4,A,골목상권,1000076,청파로73길,1179,631,548
2017,4,A,골목상권,1000075,청파로71길,236,115,121
2017,4,A,골목상권,1000074,청파로47나길,174,100,74
2017,4,A,골목상권,1000073,청파로47길,929,415,514
2017,4,A,골목상권,1000072,장문로45길,49,9,40
2017,4,A,골목상권,1000071,이태원로54길,2379,1142,1237
2017,4,A,골목상권,1000070,이태원로27길,653,367,286
2017,4,A,골목상권,1000069,이촌로22길,222,131,91
2017,4,A,골목상권,1000068,원효로89길,913,746,167
2017,4,A,골목상권,1000067,원효로53길,818,496,322
2017,4,A,골목상권,1000066,원효로41길,1379,934,445
2017,4,A,골목상권,1000065,원효로19길,1000,697,303
2017,4,A,골목상권,1000064,우사단로4길,189,127,62
2017,4,A,골목상권,1000063,우사단로14길,1836,887,949
2017,4,A,골목상권,1000062,우사단로10길,88,42,46
2017,4,A,골목상권,1000061,신흥로20길,197,78,119
2017,4,A,골목상권,1000060,소월로20길,134,42,92
2017,4,A,골목상권,1000059,서빙고로71길,472,287,185
2017,4,A,골목상권,1000058,백범로90길,280,172,108
2017,4,A,골목상권,1000057,백범로79길,753,486,267
2017,4,A,골목상권,1000056,두텁바위로1길,2663,1432,1231
2017,4,A,골목상권,1000055,대사관로34길,271,144,127
2017,4,A,골목상권,1000054,녹사평대로46길,75,50,25
2017,4,A,골목상권,1000053,녹사평대로40나길,62,31,31
2017,4,A,골목상권,1000052,녹사평대로32길,293,154,139
2017,4,A,골목상권,1000051,녹사평대로26길,2231,1171,1060
2017,4,A,골목상권,1000050,녹사평대로11길,283,186,97
2017,4,A,골목상권,1000049,퇴계로90길,596,211,385
2017,4,A,골목상권,1000048,퇴계로8길,2348,1328,1020
2017,4,A,골목상권,1000047,퇴계로56길,1234,994,240
2017,4,A,골목상권,1000046,퇴계로46길,1943,844,1099
2017,4,A,골목상권,1000045,퇴계로18길,3016,1334,1682
2017,4,A,골목상권,1000044,퇴계로12길,1102,470,632
2017,4,A,골목상권,1000043,청구로1길,231,93,138
2017,4,A,골목상권,1000042,청구로17길,1696,785,911
2017,4,A,골목상권,1000041,장충단로8길,3378,1290,2088
2017,4,A,골목상권,1000040,삼일대로4길,1005,611,394
2017,4,A,골목상권,1000039,명동길,35854,17667,18187
2017,4,A,골목상권,1000037,동호로20길,812,313,499
2017,4,A,골목상권,1000036,동호로15길,4140,2165,1975
2017,4,A,골목상권,1000035,동호로11길,17,9,8
2017,4,A,골목상권,1000034,동호로10길,1533,661,872
2017,4,A,골목상권,1000033,다산로39길,1312,715,597
2017,4,A,골목상권,1000032,다산로38길,1556,741,815
2017,4,A,골목상권,1000031,다산로36길,74,44,30
2017,4,A,골목상권,1000030,다산로33길,376,197,179
2017,4,A,골목상권,1000029,난계로21길,253,168,85
2017,4,A,골목상권,1000028,난계로11길,1745,1054,691
2017,4,A,골목상권,1000027,필운대로1길,4,1,3
2017,4,A,골목상권,1000026,평창길,179,92,87
2017,4,A,골목상권,1000025,통일로12길,240,97,143
2017,4,A,골목상권,1000024,창신길,287,75,212
2017,4,A,골목상권,1000023,창신5길,8,3,5
2017,4,A,골목상권,1000022,창신2길,58,27,31
2017,4,A,골목상권,1000021,창경궁로35길,1277,365,912
2017,4,A,골목상권,1000020,지봉로8길,184,99,85
2017,4,A,골목상권,1000019,종로65길,575,256,319
2017,4,A,골목상권,1000016,자하문로7길,578,366,212
2017,4,A,골목상권,1000015,이화장길,1886,868,1018
2017,4,A,골목상권,1000014,율곡로16길,104,91,13
2017,4,A,골목상권,1000013,율곡로10길,2236,1625,611
2017,4,A,골목상권,1000012,옥인길,497,216,281
2017,4,A,골목상권,1000011,숭인동길,23,6,17
2017,4,A,골목상권,1000010,성균관로5길,146,91,55
2017,4,A,골목상권,1000009,삼청로5길,471,178,293
2017,4,A,골목상권,1000008,북촌로5나길,1643,1117,526
2017,4,A,골목상권,1000007,북촌로5길,61,27,34
2017,4,A,골목상권,1000006,북촌로11길,19,10,9
2017,4,A,골목상권,1000005,백석동길,128,69,59
2017,4,A,골목상권,1000004,명륜길,20,11,9
2017,4,A,골목상권,1000003,돈화문로11가길,1073,590,483
2017,4,A,골목상권,1000001,계동길,831,366,465
2017,3,U,관광특구,1001496,강남 마이스 관광특구,22266,12751,9515
2017,3,U,관광특구,1001495,잠실 관광특구,28736,16766,11970
2017,3,U,관광특구,1001494,종로?청계 관광특구,30736,18590,12146
2017,3,U,관광특구,1001493,동대문패션타운 관광특구,10063,5731,4332
2017,3,U,관광특구,1001492,명동 남대문 북창동 다동 무교동 관광특구,168048,85325,82723
2017,3,U,관광특구,1001491,이태원 관광특구,5614,3181,2433
2017,3,R,전통시장,1001490,길동복조리시장,475,297,178
2017,3,R,전통시장,1001489,둔촌역전통시장,163,82,81
2017,3,R,전통시장,1001488,성내골목시장,7,2,5
2017,3,R,전통시장,1001487,천호시장,24,12,12
2017,3,R,전통시장,1001483,암사종합시장,731,338,393
2017,3,R,전통시장,1001482,고덕전통시장,388,374,14
2017,3,R,전통시장,1001481,명일골목시장,441,162,279
2017,3,R,전통시장,1001480,새마을시장,382,213,169
2017,3,R,전통시장,1001479,석촌시장,195,126,69
2017,3,R,전통시장,1001478,방이시장,647,406,241
2017,3,R,전통시장,1001477,마천시장,258,70,188
2017,3,R,전통시장,1001476,풍납시장,17,5,12
2017,3,R,전통시장,1001475,강남개포시장,38,31,7
2017,3,R,전통시장,1001474,도곡시장,497,215,282
2017,3,R,전통시장,1001471,영동전통시장,3031,2212,819
2017,3,R,전통시장,1001466,미성동도깨비시장,411,176,235
2017,3,R,전통시장,1001465,신신림시장,2,2,0
2017,3,R,전통시장,1001464,삼성동시장,99,44,55
2017,3,R,전통시장,1001463,신림중앙시장,14,9,5
2017,3,R,전통시장,1001462,강남골목시장,282,129,153
2017,3,R,전통시장,1001460,관악신사시장,291,217,74
2017,3,R,전통시장,1001459,신원시장,354,144,210
2017,3,R,전통시장,1001458,인헌시장,205,90,115
2017,3,R,전통시장,1001456,봉천현대시장,7,4,3
2017,3,R,전통시장,1001454,봉천제일종합시장,47,24,23
2017,3,R,전통시장,1001453,낙성대시장,22,13,9
2017,3,R,전통시장,1001452,중부시장,193,60,133
2017,3,R,전통시장,1001450,남성역골목시장,541,249,292
2017,3,R,전통시장,1001449,남성사계시장,1933,865,1068
2017,3,R,전통시장,1001448,흑석시장,181,72,109
2017,3,R,전통시장,1001447,상도4동도깨비골목시장,322,78,244
2017,3,R,전통시장,1001445,영도시장,70,30,40
2017,3,R,전통시장,1001441,본동인정시장,110,55,55
2017,3,R,전통시장,1001439,대림중앙시장,22,10,12
2017,3,R,전통시장,1001438,우리시장,15,7,8
2017,3,R,전통시장,1001437,영진시장A동,55,44,11
2017,3,R,전통시장,1001436,사러가시장,27,7,20
2017,3,R,전통시장,1001431,영등포청과시장,190,128,62
2017,3,R,전통시장,1001430,영등포전통시장,3950,2016,1934
2017,3,R,전통시장,1001429,은행나무시장,42,9,33
2017,3,R,전통시장,1001427,현대시장,52,16,36
2017,3,R,전통시장,1001424,남문시장,258,103,155
2017,3,R,전통시장,1001423,독산동 우시장,153,57,96
2017,3,R,전통시장,1001421,개봉중앙시장,5,2,3
2017,3,R,전통시장,1001419,가리봉시장,25,18,7
2017,3,R,전통시장,1001418,남구로시장,12,2,10
2017,3,R,전통시장,1001417,구로시장,61,23,38
2017,3,R,전통시장,1001415,방신전통시장,134,115,19
2017,3,R,전통시장,1001414,송화골목시장,533,197,336
2017,3,R,전통시장,1001413,까치산시장,42,27,15
2017,3,R,전통시장,1001411,남부골목시장,204,88,116
2017,3,R,전통시장,1001409,화곡중앙골목시장,2,2,0
2017,3,R,전통시장,1001407,등마루시장,884,506,378
2017,3,R,전통시장,1001406,신정3동골목시장,202,99,103
2017,3,R,전통시장,1001405,신정2동골목시장,6,5,1
2017,3,R,전통시장,1001402,신월6동골목시장,234,112,122
2017,3,R,전통시장,1001401,신곡종합시장,9,7,2
2017,3,R,전통시장,1001400,신월3동골목시장,53,14,39
2017,3,R,전통시장,1001399,경창시장,207,94,113
2017,3,R,전통시장,1001398,월정로시장,118,65,53
2017,3,R,전통시장,1001397,신영시장,45,22,23
2017,3,R,전통시장,1001396,목4동시장,239,86,153
2017,3,R,전통시장,1001395,목3동시장,718,350,368
2017,3,R,전통시장,1001394,목2동시장,238,109,129
2017,3,R,전통시장,1001393,마포농수산물시장,490,314,176
2017,3,R,전통시장,1001391,망원월드컵시장,13,8,5
2017,3,R,전통시장,1001390,망원시장,38,19,19
2017,3,R,전통시장,1001386,신수시장,119,83,36
2017,3,R,전통시장,1001385,아현시장,25,4,21
2017,3,R,전통시장,1001374,대림골목시장,363,130,233
2017,3,R,전통시장,1001367,상계중앙시장,31,17,14
2017,3,R,전통시장,1001364,방학동도깨비시장,153,62,91
2017,3,R,전통시장,1001363,쌍문역골목시장,75,36,39
2017,3,R,전통시장,1001361,신도봉시장,28,17,11
2017,3,R,전통시장,1001359,창동신창시장,150,68,82
2017,3,R,전통시장,1001358,수유북부시장,11,5,6
2017,3,R,전통시장,1001357,장미원골목시장,68,44,24
2017,3,R,전통시장,1001356,수유중앙시장,124,68,56
2017,3,R,전통시장,1001355,강북종합시장,69,29,40
2017,3,R,전통시장,1001354,우이시장,158,62,96
2017,3,R,전통시장,1001353,수유전통시장,438,131,307
2017,3,R,전통시장,1001352,번동북부골목시장,82,46,36
2017,3,R,전통시장,1001351,솔샘시장,112,47,65
2017,3,R,전통시장,1001349,방천골목시장,71,27,44
2017,3,R,전통시장,1001347,석관황금시장,71,28,43
2017,3,R,전통시장,1001343,장위전통시장,182,73,109
2017,3,R,전통시장,1001340,정릉시장,33,12,21
2017,3,R,전통시장,1001339,정릉아리랑시장,2,1,1
2017,3,R,전통시장,1001338,돈암제일시장,59,21,38
2017,3,R,전통시장,1001336,우림골목시장,214,106,108
2017,3,R,전통시장,1001335,묵1동도깨비시장,264,115,149
2017,3,R,전통시장,1001334,태능시장,4,3,1
2017,3,R,전통시장,1001333,중화제일시장,24,1,23
2017,3,R,전통시장,1001332,사가정시장,248,185,63
2017,3,R,전통시장,1001330,동원시장,80,32,48
2017,3,R,전통시장,1001329,동부골목시장,92,34,58
2017,3,R,전통시장,1001326,회기시장,122,50,72
2017,3,R,전통시장,1001323,답십리시장,28,9,19
2017,3,R,전통시장,1001321,답십리현대시장,91,69,22
2017,3,R,전통시장,1001319,청량리종합시장,15,12,3
2017,3,R,전통시장,1001317,청량리농수산물시장,20,16,4
2017,3,R,전통시장,1001316,서울약령시장,1362,816,546
2017,3,R,전통시장,1001313,청량리수산시장,224,110,114
2017,3,R,전통시장,1001310,구의시장,99,57,42
2017,3,R,전통시장,1001309,조양시장,90,44,46
2017,3,R,전통시장,1001308,영동교골목시장,16,11,5
2017,3,R,전통시장,1001307,능동로골목시장,189,156,33
2017,3,R,전통시장,1001304,자양골목시장,95,50,45
2017,3,R,전통시장,1001301,중곡제일시장,118,70,48
2017,3,R,전통시장,1001299,한아름시장,137,80,57
2017,3,R,전통시장,1001298,성동용답상가시장,286,137,149
2017,3,R,전통시장,1001297,뚝도시장,36,13,23
2017,3,R,전통시장,1001296,금남시장,20,12,8
2017,3,R,전통시장,1001295,행당시장,226,118,108
2017,3,R,전통시장,1001294,마장축산물시장,1519,1028,491
2017,3,R,전통시장,1001289,용문전통시장,38,22,16
2017,3,R,전통시장,1001286,후암시장,51,20,31
2017,3,R,전통시장,1001285,합동(새벽)시장,2312,1324,988
2017,3,R,전통시장,1001284,서울중앙시장,252,172,80
2017,3,R,전통시장,1001283,백학시장,466,241,225
2017,3,R,전통시장,1001282,약수시장,1750,712,1038
2017,3,R,전통시장,1001281,청평화시장,3103,1906,1197
2017,3,R,전통시장,1001280,제일평화시장,538,320,218
2017,3,R,전통시장,1001278,남평화시장,185,111,74
2017,3,R,전통시장,1001277,방산종합시장,1856,1184,672
2017,3,R,전통시장,1001275,인현시장,1128,719,409
2017,3,R,전통시장,1001274,신중부시장,2430,1616,814
2017,3,R,전통시장,1001273,남대문시장,7180,3721,3459
2017,3,R,전통시장,1001271,동묘시장,937,588,349
2017,3,R,전통시장,1001270,창신골목시장,239,125,114
2017,3,R,전통시장,1001268,충신시장,329,203,126
2017,3,R,전통시장,1001267,종로신진시장,35,14,21
2017,3,R,전통시장,1001266,동대문종합시장,329,178,151
2017,3,R,전통시장,1001265,광장시장,193,143,50
2017,3,D,발달상권,1001263,서울 노원구 노원역_3,797,334,463
2017,3,D,발달상권,1001261,서울 노원구 노원역_1,988,302,686
2017,3,D,발달상권,1001260,창동역,2408,1553,855
2017,3,D,발달상권,1001259,서울 강북구 수유역_3,66,30,36
2017,3,D,발달상권,1001257,서울 강북구 수유역_2,4125,2117,2008
2017,3,D,발달상권,1001256,서울 강북구 수유역_1,117,96,21
2017,3,D,발달상권,1001255,서울 은평구 연신내역_3,638,191,447
2017,3,D,발달상권,1001254,서울 은평구 연신내역_2,413,176,237
2017,3,D,발달상권,1001253,서울 은평구 연신내역_1,87,35,52
2017,3,D,발달상권,1001252,서울 성북구 미아삼거리역_2,514,212,302
2017,3,D,발달상권,1001251,서울 강북구 미아삼거리역_1,520,189,331
2017,3,D,발달상권,1001250,서울 은평구 불광역_3,54,19,35
2017,3,D,발달상권,1001249,서울 은평구 불광역_2,73,29,44
2017,3,D,발달상권,1001248,서울 은평구 불광역_1,252,108,144
2017,3,D,발달상권,1001247,미아사거리_2,125,35,90
2017,3,D,발달상권,1001246,미아사거리_1,522,221,301
2017,3,D,발달상권,1001245,서울 성북구 성신여대입구역,5121,3134,1987
2017,3,D,발달상권,1001244,경희대학교,370,173,197
2017,3,D,발달상권,1001243,서울 성북구 안암역,97,57,40
2017,3,D,발달상권,1001242,혜화역 대학로_3,1658,790,868
2017,3,D,발달상권,1001241,혜화역 대학로_2,1491,830,661
2017,3,D,발달상권,1001240,혜화역 대학로_1,1191,611,580
2017,3,D,발달상권,1001239,디지털미디어시티,21758,12923,8835
2017,3,D,발달상권,1001238,서울 동대문구 청량리역,3046,1987,1059
2017,3,D,발달상권,1001236,서울 종로구 안국역_2,680,261,419
2017,3,D,발달상권,1001235,서울 종로구 안국역_1,12874,10672,2202
2017,3,D,발달상권,1001234,서울 종로구 경복궁역_1,219,90,129
2017,3,D,발달상권,1001233,서울 종로구 종로3가역_3,3298,1768,1530
2017,3,D,발달상권,1001232,서울 종로구 종로3가역_2,1907,1044,863
2017,3,D,발달상권,1001231,서울 동대문구 신설동역_2,4491,2160,2331
2017,3,D,발달상권,1001230,인사동,21235,13039,8196
2017,3,D,발달상권,1001229,서울 종로구 종로5가역_4,669,360,309
2017,3,D,발달상권,1001228,서울 종로구 종로5가역_3,5114,3472,1642
2017,3,D,발달상권,1001227,종로구청,18711,10381,8330
2017,3,D,발달상권,1001226,서울 종로구 종로5가역_2,18368,12155,6213
2017,3,D,발달상권,1001225,신설동역,772,435,337
2017,3,D,발달상권,1001224,서울 동대문구 신설동역_1,2,2,0
2017,3,D,발달상권,1001223,서울 종로구 광화문역_2,54025,32531,21494
2017,3,D,발달상권,1001222,동묘앞역,60,37,23
2017,3,D,발달상권,1001221,장안동사거리,526,269,257
2017,3,D,발달상권,1001220,서울 종로구 동대문역_2,1057,542,515
2017,3,D,발달상권,1001218,동대문시장_2,498,305,193
2017,3,D,발달상권,1001217,서울 종로구 종로5가역_1,49,36,13
2017,3,D,발달상권,1001216,서울 종로구 종로3가역_1,3495,1546,1949
2017,3,D,발달상권,1001215,서울 종로구 광화문역_1,2317,1511,806
2017,3,D,발달상권,1001214,종각역,20798,13447,7351
2017,3,D,발달상권,1001213,종각역 젊음의 거리,2297,997,1300
2017,3,D,발달상권,1001212,서대문구 서대문역_1,351,238,113
2017,3,D,발달상권,1001211,동대문시장_1,442,238,204
2017,3,D,발달상권,1001210,시청역_2,21995,13957,8038
2017,3,D,발달상권,1001209,서울시청,23931,11748,12183
2017,3,D,발달상권,1001208,서울 중구 을지로3가역_2,7819,5032,2787
2017,3,D,발달상권,1001207,서울 중구 신당역_2,1434,706,728
2017,3,D,발달상권,1001206,서대문구 서대문역_2,2045,1421,624
2017,3,D,발달상권,1001205,동대문역사문화공원역,4190,2992,1198
2017,3,D,발달상권,1001204,서울 중구 을지로3가역_1,14464,9605,4859
2017,3,D,발달상권,1001203,명동거리,23768,11122,12646
2017,3,D,발달상권,1001202,롯데백화점,39858,22204,17654
2017,3,D,발달상권,1001201,서울 중구 신당역_1,1076,694,382
2017,3,D,발달상권,1001200,북창동,7974,4771,3203
2017,3,D,발달상권,1001199,서울 중구 충무로역_2,14112,6234,7878
2017,3,D,발달상권,1001198,서울 강서구 송정역,615,408,207
2017,3,D,발달상권,1001197,장한평역_2,12289,9719,2570
2017,3,D,발달상권,1001196,시청역_1,55770,33686,22084
2017,3,D,발달상권,1001195,왕십리역_2,659,280,379
2017,3,D,발달상권,1001194,서울 강서구 발산역,822,488,334
2017,3,D,발달상권,1001193,장한평역_1,2304,1536,768
2017,3,D,발달상권,1001192,서울 중구 충무로역_1,3147,2188,959
2017,3,D,발달상권,1001190,장한평역,2210,1539,671
2017,3,D,발달상권,1001189,서울 중구 명동역,3784,1916,1868
2017,3,D,발달상권,1001188,장충동 족발거리,208,99,109
2017,3,D,발달상권,1001187,한양시장,285,142,143
2017,3,D,발달상권,1001186,서울 서대문구 이대역,1297,536,761
2017,3,D,발달상권,1001185,서울 서대문구 신촌역,3235,1340,1895
2017,3,D,발달상권,1001184,서울 마포구 홍대입구역_3,414,246,168
2017,3,D,발달상권,1001183,서울 마포구 홍대입구역_2,3258,1241,2017
2017,3,D,발달상권,1001182,홍익대학교 주변,16188,7954,8234
2017,3,D,발달상권,1001181,서울 광진구 군자역,176,103,73
2017,3,D,발달상권,1001180,신촌역,264,135,129
2017,3,D,발달상권,1001179,강서구청,3354,2224,1130
2017,3,D,발달상권,1001178,서울 마포구 홍대입구역_1,832,466,366
2017,3,D,발달상권,1001175,서울 강동구 고덕역,495,276,219
2017,3,D,발달상권,1001173,서울 강동구 명일역,852,353,499
2017,3,D,발달상권,1001172,어린이대공원역,88,52,36
2017,3,D,발달상권,1001171,서울 마포구 공덕역_2,4361,2534,1827
2017,3,D,발달상권,1001170,공덕역,7505,4485,3020
2017,3,D,발달상권,1001169,서울 용산구 숙대입구역,2960,2152,808
2017,3,D,발달상권,1001168,남영역,14028,6236,7792
2017,3,D,발달상권,1001167,서울 마포구 공덕역_1,4781,2344,2437
2017,3,D,발달상권,1001166,서울 마포구 마포역_2,990,548,442
2017,3,D,발달상권,1001165,서울 광진구 건대입구역_2,2881,980,1901
2017,3,D,발달상권,1001164,서울 마포구 마포역_1,11520,6886,4634
2017,3,D,발달상권,1001163,서울 강동구 천호역_2,3895,1927,1968
2017,3,D,발달상권,1001162,서울 광진구 건대입구역_1,902,425,477
2017,3,D,발달상권,1001161,건대입구역,730,388,342
2017,3,D,발달상권,1001160,서울 광진구 구의역,860,536,324
2017,3,D,발달상권,1001159,서울 강동구 천호역,1037,514,523
2017,3,D,발달상권,1001158,당산역_2,5064,3127,1937
2017,3,D,발달상권,1001156,서울 강동구 길동역,1192,657,535
2017,3,D,발달상권,1001155,용산 전자상가_5,2478,1833,645
2017,3,D,발달상권,1001153,당산역_1,1082,674,408
2017,3,D,발달상권,1001152,서울 광진구 강변역,1914,1545,369
2017,3,D,발달상권,1001151,용산 전자상가_3,2472,1797,675
2017,3,D,발달상권,1001150,서울 용산구 이태원역,674,408,266
2017,3,D,발달상권,1001149,한남오거리,632,334,298
2017,3,D,발달상권,1001147,용산 전자상가_2,444,357,87
2017,3,D,발달상권,1001146,용산구청,87,50,37
2017,3,D,발달상권,1001145,용산 전자상가_1,7830,5985,1845
2017,3,D,발달상권,1001144,국회의사당역_2,36337,21385,14952
2017,3,D,발달상권,1001143,서울 용산구 신용산역,508,240,268
2017,3,D,발달상권,1001142,국회의사당역_1,5614,4332,1282
2017,3,D,발달상권,1001141,압구정 로데오거리_2,16399,6816,9583
2017,3,D,발달상권,1001140,서울 강남구 압구정역,11035,5069,5966
2017,3,D,발달상권,1001139,서울 영등포구 영등포구청역,3719,1144,2575
2017,3,D,발달상권,1001138,압구정 로데오거리_1,7807,2538,5269
2017,3,D,발달상권,1001137,서울 강동구 둔촌동역,44,11,33
2017,3,D,발달상권,1001136,오목교역,220,92,128
2017,3,D,발달상권,1001135,신사동 가로수길,21727,10161,11566
2017,3,D,발달상권,1001134,서울 영등포구 여의도역_2,48522,32210,16312
2017,3,D,발달상권,1001133,청담사거리_3,1860,570,1290
2017,3,D,발달상권,1001132,영등포유통상가,2167,1343,824
2017,3,D,발달상권,1001131,청담역_2,1323,924,399
2017,3,D,발달상권,1001130,청담역_1,178,141,37
2017,3,D,발달상권,1001129,청담사거리_2,920,699,221
2017,3,D,발달상권,1001127,서울 영등포구 여의도역_1,51858,30910,20948
2017,3,D,발달상권,1001125,학동사거리_2,3056,1778,1278
2017,3,D,발달상권,1001124,서울 영등포구 영등포시장역,318,247,71
2017,3,D,발달상권,1001123,학동사거리_1,4134,2110,2024
2017,3,D,발달상권,1001122,여의도 시범아파트앞,2280,1530,750
2017,3,D,발달상권,1001121,영등포역_3,867,513,354
2017,3,D,발달상권,1001120,도산공원사거리_1,9962,5945,4017
2017,3,D,발달상권,1001119,영등포역_2,1244,676,568
2017,3,D,발달상권,1001118,문래동 주민센터,68,58,10
2017,3,D,발달상권,1001117,강남구 신사역_2,7963,5151,2812
2017,3,D,발달상권,1001115,서울 강남구 강남구청역_2,4496,2877,1619
2017,3,D,발달상권,1001114,강남구 신사역_1,2257,950,1307
2017,3,D,발달상권,1001113,서울 동작구 노량진1동_1,24,13,11
2017,3,D,발달상권,1001112,서울 강남구 학동역_3,8987,5262,3725
2017,3,D,발달상권,1001111,서울 강남구 강남구청역_1,3294,1905,1389
2017,3,D,발달상권,1001110,잠실역,5959,4476,1483
2017,3,D,발달상권,1001109,강남구 논현역_4,7301,3819,3482
2017,3,D,발달상권,1001108,학동역,1546,604,942
2017,3,D,발달상권,1001107,방이동 먹자골목,5213,3298,1915
2017,3,D,발달상권,1001106,서울 강남구 학동역_2,6034,3287,2747
2017,3,D,발달상권,1001105,서울 동작구 노량진역,3774,2164,1610
2017,3,D,발달상권,1001104,삼성역_3,8959,5180,3779
2017,3,D,발달상권,1001103,코엑스,22266,12751,9515
2017,3,D,발달상권,1001102,서울 강남구 학동역_1,5183,3320,1863
2017,3,D,발달상권,1001101,선정릉역_2,6702,4136,2566
2017,3,D,발달상권,1001100,강남구 논현역_3,1588,905,683
2017,3,D,발달상권,1001099,포스코사거리_2,7394,4769,2625
2017,3,D,발달상권,1001098,포스코사거리_1,48819,32850,15969
2017,3,D,발달상권,1001097,잠실역 롯데월드,4035,1991,2044
2017,3,D,발달상권,1001096,신도림역,3350,1784,1566
2017,3,D,발달상권,1001095,강남구 논현역_2,8354,4002,4352
2017,3,D,발달상권,1001094,선정릉역_1,1802,1285,517
2017,3,D,발달상권,1001093,신천역,6368,3421,2947
2017,3,D,발달상권,1001092,강남구 논현역_1,3706,2139,1567
2017,3,D,발달상권,1001091,삼성역_2,18475,11019,7456
2017,3,D,발달상권,1001090,삼정역_2,2594,1323,1271
2017,3,D,발달상권,1001089,삼정역_1,3102,1642,1460
2017,3,D,발달상권,1001088,삼성역_1,32772,21159,11613
2017,3,D,발달상권,1001087,서울 강남구 선릉역_2,7211,4645,2566
2017,3,D,발달상권,1001086,고속터미널역,15974,4718,11256
2017,3,D,발달상권,1001085,서울 서초구 강남역,33286,19156,14130
2017,3,D,발달상권,1001084,서울 강남구 선릉역_1,20161,8283,11878
2017,3,D,발달상권,1001082,선릉역_2,20939,10618,10321
2017,3,D,발달상권,1001081,서울 강남구 역삼역_2,26873,21117,5756
2017,3,D,발달상권,1001080,서울 송파구 석촌역_1,39,26,13
2017,3,D,발달상권,1001078,서울 강남구 강남역_2,5736,3376,2360
2017,3,D,발달상권,1001077,선릉역_1,54646,29517,25129
2017,3,D,발달상권,1001076,구로역,161,94,67
2017,3,D,발달상권,1001075,역삼역_2,4713,2639,2074
2017,3,D,발달상권,1001074,대림역_2,7435,5577,1858
2017,3,D,발달상권,1001073,서울 강남구 역삼역_1,25643,15789,9854
2017,3,D,발달상권,1001072,신대방삼거리역,256,131,125
2017,3,D,발달상권,1001071,서울 강남구 한티역,1071,418,653
2017,3,D,발달상권,1001070,은마아파트입구사거리_4,100,54,46
2017,3,D,발달상권,1001067,오류동역,1566,765,801
2017,3,D,발달상권,1001066,서울 강남구 강남역,39725,18922,20803
2017,3,D,발달상권,1001063,교대역_4,5213,2844,2369
2017,3,D,발달상권,1001062,서울 강남구 강남역_1,131121,96380,34741
2017,3,D,발달상권,1001061,방배동카페골목,110,48,62
2017,3,D,발달상권,1001060,가락시장,16680,10479,6201
2017,3,D,발달상권,1001059,교대역_3,4302,2619,1683
2017,3,D,발달상권,1001058,역삼역_1,1678,1030,648
2017,3,D,발달상권,1001057,교대역_2,3511,2245,1266
2017,3,D,발달상권,1001056,서울 송파구 가락시장역,5025,3225,1800
2017,3,D,발달상권,1001055,서울 서초구 서초역,12861,5297,7564
2017,3,D,발달상권,1001054,서울 강남구 대치역_2,1474,890,584
2017,3,D,발달상권,1001052,뱅뱅사거리_2,25423,16323,9100
2017,3,D,발달상권,1001051,보라매공원,14368,8190,6178
2017,3,D,발달상권,1001050,교대역_1,12799,7644,5155
2017,3,D,발달상권,1001049,개봉동 현대아파트 인근,148,64,84
2017,3,D,발달상권,1001048,뱅뱅사거리,7337,4872,2465
2017,3,D,발달상권,1001047,뱅뱅사거리_1,10917,7743,3174
2017,3,D,발달상권,1001046,서울 관악구 신림역_4,941,437,504
2017,3,D,발달상권,1001045,동작구 총신대입구역_1,238,108,130
2017,3,D,발달상권,1001044,양재역_3,3523,2357,1166
2017,3,D,발달상권,1001043,동작구 총신대입구역_2,825,348,477
2017,3,D,발달상권,1001042,서울 서초구 남부터미널역_3,1514,845,669
2017,3,D,발달상권,1001041,서울 강남구 수서역,19761,11577,8184
2017,3,D,발달상권,1001039,서울 서초구 남부터미널역_2,10990,5420,5570
2017,3,D,발달상권,1001038,구로디지탈1단지,66086,41917,24169
2017,3,D,발달상권,1001037,양재역,116,52,64
2017,3,D,발달상권,1001035,매봉역,568,214,354
2017,3,D,발달상권,1001034,서울 서초구 방배역,3441,2008,1433
2017,3,D,발달상권,1001033,서울 서초구 남부터미널역_1,529,380,149
2017,3,D,발달상권,1001032,서울 관악구 신림역_2,35,16,19
2017,3,D,발달상권,1001031,서울 관악구 신림역_1,1955,929,1026
2017,3,D,발달상권,1001030,양재역_2,9074,5070,4004
2017,3,D,발달상권,1001029,양재역_1,894,626,268
2017,3,D,발달상권,1001028,서울 관악구 서울대입구역_2,44,4,40
2017,3,D,발달상권,1001027,가산디지털단지역_3,30766,18326,12440
2017,3,D,발달상권,1001026,구로디지털단지역,2181,1409,772
2017,3,D,발달상권,1001025,서울 관악구 서울대입구역_1,1997,855,1142
2017,3,D,발달상권,1001024,관악구 사당역_1,3768,1429,2339
2017,3,D,발달상권,1001023,가산디지털단지역_2,62801,37619,25182
2017,3,D,발달상권,1001022,관악구 사당역_2,424,201,223
2017,3,D,발달상권,1001021,가산디지털단지역_1,27122,18365,8757
2017,3,D,발달상권,1001020,장지역,4370,2728,1642
2017,3,D,발달상권,1001019,포이사거리_1,5637,3027,2610
2017,3,D,발달상권,1001018,포이사거리_2,8948,6241,2707
2017,3,D,발달상권,1001016,서울 관악구 대학동_1,90,52,38
2017,3,D,발달상권,1001015,서울 금천구 독산1동_1,2873,1889,984
2017,3,D,발달상권,1001013,양재 화물트럭터미널앞_2,159,70,89
2017,3,D,발달상권,1001012,양재 화물트럭터미널앞_1,4552,3662,890
2017,3,D,발달상권,1001011,서울 금천구 시흥1동_4,933,446,487
2017,3,A,골목상권,1001010,풍성로37가길,42,20,22
2017,3,A,골목상권,1001009,천호옛길,526,343,183
2017,3,A,골목상권,1001008,천호옛14길,594,290,304
2017,3,A,골목상권,1001007,천호대로219길,918,559,359
2017,3,A,골목상권,1001006,천호대로197길,23,8,15
2017,3,A,골목상권,1001005,천호대로187길,915,531,384
2017,3,A,골목상권,1001004,천호대로170길,394,159,235
2017,3,A,골목상권,1001003,천호대로162길,1166,807,359
2017,3,A,골목상권,1001002,천중로51길,424,226,198
2017,3,A,골목상권,1001001,천중로39길,612,226,386
2017,3,A,골목상권,1001000,진황도로47길,1370,685,685
2017,3,A,골목상권,1000999,진황도로27길,598,337,261
2017,3,A,골목상권,1000998,올림픽로98길,33,14,19
2017,3,A,골목상권,1000995,올림픽로77길,16,8,8
2017,3,A,골목상권,1000994,올림픽로71길,353,264,89
2017,3,A,골목상권,1000993,올림픽로48길,6006,3602,2404
2017,3,A,골목상권,1000992,양재대로96길,1393,843,550
2017,3,A,골목상권,1000991,양재대로95길,688,359,329
2017,3,A,골목상권,1000990,양재대로91길,1211,655,556
2017,3,A,골목상권,1000989,양재대로133길,311,112,199
2017,3,A,골목상권,1000988,양재대로124길,616,381,235
2017,3,A,골목상권,1000987,양재대로116길,215,84,131
2017,3,A,골목상권,1000986,양재대로101길,1173,666,507
2017,3,A,골목상권,1000985,암사길,374,174,200
2017,3,A,골목상권,1000984,성안로3길,1501,929,572
2017,3,A,골목상권,1000983,성내로5길,1112,560,552
2017,3,A,골목상권,1000982,상일로5길,42,24,18
2017,3,A,골목상권,1000981,상암로5길,599,265,334
2017,3,A,골목상권,1000980,상암로51길,751,326,425
2017,3,A,골목상권,1000979,상암로4길,350,263,87
2017,3,A,골목상권,1000978,상암로14길,482,316,166
2017,3,A,골목상권,1000977,명일로13길,111,47,64
2017,3,A,골목상권,1000976,동남로85길,125,63,62
2017,3,A,골목상권,1000975,동남로82길,9,3,6
2017,3,A,골목상권,1000974,동남로65길,80,22,58
2017,3,A,골목상권,1000973,구천면로42길,383,181,202
2017,3,A,골목상권,1000972,구천면로41길,596,246,350
2017,3,A,골목상권,1000971,구천면로36길,48,26,22
2017,3,A,골목상권,1000969,고덕로25길,22,13,9
2017,3,A,골목상권,1000968,고덕로10길,163,70,93
2017,3,A,골목상권,1000967,강동대로53길,926,513,413
2017,3,A,골목상권,1000966,풍성로25길,751,269,482
2017,3,A,골목상권,1000965,오금로46길,1453,740,713
2017,3,A,골목상권,1000964,오금로36길,1209,902,307
2017,3,A,골목상권,1000963,오금로11길,2156,1424,732
2017,3,A,골목상권,1000962,양재대로72길,655,344,311
2017,3,A,골목상권,1000961,양재대로71길,1348,828,520
2017,3,A,골목상권,1000960,양재대로64길,1497,618,879
2017,3,A,골목상권,1000959,양재대로62길,6189,3659,2530
2017,3,A,골목상권,1000958,송파대로30길,1706,1061,645
2017,3,A,골목상권,1000957,송이로36길,2107,1508,599
2017,3,A,골목상권,1000956,송이로32길,774,418,356
2017,3,A,골목상권,1000955,송이로23길,1343,833,510
2017,3,A,골목상권,1000954,삼전로13길,1606,770,836
2017,3,A,골목상권,1000953,백제고분로50길,3615,1731,1884
2017,3,A,골목상권,1000952,백제고분로46길,1624,986,638
2017,3,A,골목상권,1000951,백제고분로45길,436,283,153
2017,3,A,골목상권,1000950,백제고분로42길,134,82,52
2017,3,A,골목상권,1000949,백제고분로39길,1711,1173,538
2017,3,A,골목상권,1000948,백제고분로34길,1548,1014,534
2017,3,A,골목상권,1000947,백제고분로33길,989,610,379
2017,3,A,골목상권,1000946,백제고분로32길,1112,494,618
2017,3,A,골목상권,1000945,백제고분로31길,339,197,142
2017,3,A,골목상권,1000944,백제고분로22길,1215,705,510
2017,3,A,골목상권,1000943,백제고분로21길,205,147,58
2017,3,A,골목상권,1000942,마천로51길,145,61,84
2017,3,A,골목상권,1000941,동남로20길,144,82,62
2017,3,A,골목상권,1000940,거마로20길,533,219,314
2017,3,A,골목상권,1000939,학동로77길,2962,1529,1433
2017,3,A,골목상권,1000938,학동로6길,1847,888,959
2017,3,A,골목상권,1000937,학동로56길,878,454,424
2017,3,A,골목상권,1000936,학동로38길,7213,4115,3098
2017,3,A,골목상권,1000935,테헤란로81길,574,218,356
2017,3,A,골목상권,1000934,일원로9길,539,298,241
2017,3,A,골목상권,1000933,일원로3길,223,103,120
2017,3,A,골목상권,1000932,영동대로65길,3272,1938,1334
2017,3,A,골목상권,1000931,영동대로112길,637,401,236
2017,3,A,골목상권,1000930,언주로81길,9628,5444,4184
2017,3,A,골목상권,1000929,압구정로2길,2692,1459,1233
2017,3,A,골목상권,1000928,선릉로18길,421,235,186
2017,3,A,골목상권,1000927,선릉로146길,1878,983,895
2017,3,A,골목상권,1000926,선릉로133길,222,124,98
2017,3,A,골목상권,1000925,선릉로132길,1000,561,439
2017,3,A,골목상권,1000924,선릉로121길,1634,851,783
2017,3,A,골목상권,1000923,삼성로75길,2789,1533,1256
2017,3,A,골목상권,1000922,삼성로69길,297,145,152
2017,3,A,골목상권,1000921,삼성로64길,498,245,253
2017,3,A,골목상권,1000920,삼성로63길,182,83,99
2017,3,A,골목상권,1000919,삼성로57길,905,277,628
2017,3,A,골목상권,1000918,삼성로147길,890,366,524
2017,3,A,골목상권,1000917,삼성로115길,268,161,107
2017,3,A,골목상권,1000916,봉은사로68길,228,114,114
2017,3,A,골목상권,1000915,봉은사로57길,831,508,323
2017,3,A,골목상권,1000914,봉은사로43길,1113,733,380
2017,3,A,골목상권,1000913,봉은사로29길,128,81,47
2017,3,A,골목상권,1000912,봉은사로109길,331,171,160
2017,3,A,골목상권,1000911,도산대로89길,2604,956,1648
2017,3,A,골목상권,1000910,도산대로81길,4254,1366,2888
2017,3,A,골목상권,1000909,도산대로50길,2646,1846,800
2017,3,A,골목상권,1000908,도산대로38길,146,82,64
2017,3,A,골목상권,1000907,도산대로30길,3171,1560,1611
2017,3,A,골목상권,1000906,도산대로23길,1306,787,519
2017,3,A,골목상권,1000905,도산대로15길,1695,772,923
2017,3,A,골목상권,1000904,도곡로37길,3774,2232,1542
2017,3,A,골목상권,1000903,논현로8길,764,433,331
2017,3,A,골목상권,1000902,논현로63길,11837,3186,8651
2017,3,A,골목상권,1000901,논현로28길,10547,7193,3354
2017,3,A,골목상권,1000900,논현로26길,7582,4894,2688
2017,3,A,골목상권,1000898,논현로139길,2715,1319,1396
2017,3,A,골목상권,1000897,논현로123길,102,57,45
2017,3,A,골목상권,1000896,논현로115길,2811,1451,1360
2017,3,A,골목상권,1000895,논현로10길,2594,1654,940
2017,3,A,골목상권,1000894,논현로106길,2765,1597,1168
2017,3,A,골목상권,1000893,남부순환로365길,173,119,54
2017,3,A,골목상권,1000891,개포로28길,311,221,90
2017,3,A,골목상권,1000890,개포로20길,4283,2358,1925
2017,3,A,골목상권,1000889,개포로17길,2724,1757,967
2017,3,A,골목상권,1000888,강남대로140길,4278,2173,2105
2017,3,A,골목상권,1000887,강남대로136길,1127,590,537
2017,3,A,골목상권,1000886,강남대로118길,682,394,288
2017,3,A,골목상권,1000885,서초중앙로8길,7405,5543,1862
2017,3,A,골목상권,1000884,방배중앙로21길,1223,611,612
2017,3,A,골목상권,1000883,효령로72길,205,117,88
2017,3,A,골목상권,1000882,효령로34길,33,27,6
2017,3,A,골목상권,1000881,효령로31길,1338,735,603
2017,3,A,골목상권,1000880,효령로23길,739,444,295
2017,3,A,골목상권,1000879,청두곶길,2023,1303,720
2017,3,A,골목상권,1000878,주흥길,319,202,117
2017,3,A,골목상권,1000877,주흥15길,1463,948,515
2017,3,A,골목상권,1000876,언남길,1631,1124,507
2017,3,A,골목상권,1000875,신반포로45길,403,253,150
2017,3,A,골목상권,1000874,서초대로8길,287,176,111
2017,3,A,골목상권,1000873,서초대로64길,523,357,166
2017,3,A,골목상권,1000872,서초대로4길,665,473,192
2017,3,A,골목상권,1000871,서초대로25길,3387,2025,1362
2017,3,A,골목상권,1000870,서초대로23길,574,343,231
2017,3,A,골목상권,1000869,서초대로15길,1493,691,802
2017,3,A,골목상권,1000868,사평대로57길,170,66,104
2017,3,A,골목상권,1000867,사평대로26길,15,9,6
2017,3,A,골목상권,1000866,사평대로22길,1597,981,616
2017,3,A,골목상권,1000865,사임당로17길,1839,1080,759
2017,3,A,골목상권,1000864,방배로42길,154,82,72
2017,3,A,골목상권,1000863,방배로35길,2338,1442,896
2017,3,A,골목상권,1000862,방배로18길,87,46,41
2017,3,A,골목상권,1000861,반포대로9길,672,410,262
2017,3,A,골목상권,1000860,바우뫼로39길,2221,1376,845
2017,3,A,골목상권,1000859,마방로2길,3755,2373,1382
2017,3,A,골목상권,1000858,방배천로4안길,1259,807,452
2017,3,A,골목상권,1000857,동산로19길,1304,875,429
2017,3,A,골목상권,1000856,동산로10길,2845,1517,1328
2017,3,A,골목상권,1000855,동광로39길,46,29,17
2017,3,A,골목상권,1000854,동광로1길,1225,716,509
2017,3,A,골목상권,1000853,동광로12길,779,503,276
2017,3,A,골목상권,1000852,논현로27길,3646,2529,1117
2017,3,A,골목상권,1000851,논현로1길,551,361,190
2017,3,A,골목상권,1000850,남부순환로339길,12919,5417,7502
2017,3,A,골목상권,1000849,남부순환로325길,7991,3914,4077
2017,3,A,골목상권,1000848,남부순환로317길,1737,1223,514
2017,3,A,골목상권,1000847,고무래로8길,6587,3414,3173
2017,3,A,골목상권,1000846,강남대로8길,2525,1583,942
2017,3,A,골목상권,1000845,강남대로34길,1038,671,367
2017,3,A,골목상권,1000844,강남대로23길,7090,5042,2048
2017,3,A,골목상권,1000843,소담길,23,5,18
2017,3,A,골목상권,1000842,원신길,293,115,178
2017,3,A,골목상권,1000840,양산길,350,257,93
2017,3,A,골목상권,1000839,호암로24길,649,250,399
2017,3,A,골목상권,1000838,호암로20길,39,25,14
2017,3,A,골목상권,1000837,행운길,20,4,16
2017,3,A,골목상권,1000836,행운1길,99,66,33
2017,3,A,골목상권,1000835,청림3길,81,36,45
2017,3,A,골목상권,1000834,청룡길,92,47,45
2017,3,A,골목상권,1000833,청룡8길,10,5,5
2017,3,A,골목상권,1000832,중앙길,279,113,166
2017,3,A,골목상권,1000831,조원중앙로2길,1136,817,319
2017,3,A,골목상권,1000830,조원로18길,1020,561,459
2017,3,A,골목상권,1000829,조원로10길,275,126,149
2017,3,A,골목상권,1000828,장군봉2길,212,111,101
2017,3,A,골목상권,1000827,장군봉1길,84,14,70
2017,3,A,골목상권,1000826,인헌길,86,47,39
2017,3,A,골목상권,1000825,은천로25길,285,93,192
2017,3,A,골목상권,1000824,양녕로6길,805,483,322
2017,3,A,골목상권,1000823,신원로3길,21,15,6
2017,3,A,골목상권,1000822,신사로20길,54,24,30
2017,3,A,골목상권,1000820,신림로64길,251,116,135
2017,3,A,골목상권,1000819,신림로48길,73,33,40
2017,3,A,골목상권,1000818,신림로38길,63,32,31
2017,3,A,골목상권,1000817,신림로28길,317,217,100
2017,3,A,골목상권,1000816,신림로11길,445,409,36
2017,3,A,골목상권,1000815,신림동길,364,221,143
2017,3,A,골목상권,1000814,승방길,570,369,201
2017,3,A,골목상권,1000813,서림7길,277,103,174
2017,3,A,골목상권,1000812,봉천로33길,349,225,124
2017,3,A,골목상권,1000811,봉천로13길,321,98,223
2017,3,A,골목상권,1000810,복은길,175,58,117
2017,3,A,골목상권,1000809,법원단지길,2,1,1
2017,3,A,골목상권,1000808,법원단지9길,89,39,50
2017,3,A,골목상권,1000807,미성5길,66,34,32
2017,3,A,골목상권,1000806,대학길,86,31,55
2017,3,A,골목상권,1000805,대학14길,12,3,9
2017,3,A,골목상권,1000804,당곡길,380,196,184
2017,3,A,골목상권,1000803,남현길,242,97,145
2017,3,A,골목상권,1000802,남현3길,401,242,159
2017,3,A,골목상권,1000800,남부순환로248길,249,122,127
2017,3,A,골목상권,1000799,남부순환로234길,118,81,37
2017,3,A,골목상권,1000798,남부순환로172길,1354,779,575
2017,3,A,골목상권,1000797,남부순환로161길,21,6,15
2017,3,A,골목상권,1000796,남부순환로151길,190,134,56
2017,3,A,골목상권,1000795,남부순환로142길,74,34,40
2017,3,A,골목상권,1000794,난향길,160,39,121
2017,3,A,골목상권,1000793,난우길,406,160,246
2017,3,A,골목상권,1000792,난곡로74길,134,60,74
2017,3,A,골목상권,1000791,난곡로34길,25,8,17
2017,3,A,골목상권,1000790,난곡로26길,121,46,75
2017,3,A,골목상권,1000789,난곡로24길,37,18,19
2017,3,A,골목상권,1000788,낙성대역길,716,455,261
2017,3,A,골목상권,1000787,국회단지길,539,246,293
2017,3,A,골목상권,1000786,구암길,74,26,48
2017,3,A,골목상권,1000785,관천로22길,28,12,16
2017,3,A,골목상권,1000784,관천로15길,145,78,67
2017,3,A,골목상권,1000783,관악로30길,195,66,129
2017,3,A,골목상권,1000782,관악로28길,146,73,73
2017,3,A,골목상권,1000781,관악로14길,448,257,191
2017,3,A,골목상권,1000780,관악로10길,224,163,61
2017,3,A,골목상권,1000779,흑석로9길,195,88,107
2017,3,A,골목상권,1000778,흑석로13길,122,9,113
2017,3,A,골목상권,1000777,장승배기로27길,39,20,19
2017,3,A,골목상권,1000776,장승배기로19길,8,5,3
2017,3,A,골목상권,1000774,여의대방로46길,445,149,296
2017,3,A,골목상권,1000773,여의대방로24길,16849,8087,8762
2017,3,A,골목상권,1000772,여의대방로22카길,279,115,164
2017,3,A,골목상권,1000771,여의대방로22나길,131,50,81
2017,3,A,골목상권,1000770,여의대방로22길,207,121,86
2017,3,A,골목상권,1000769,양녕로26길,132,64,68
2017,3,A,골목상권,1000768,신대방길,109,71,38
2017,3,A,골목상권,1000767,성대로29길,3,3,0
2017,3,A,골목상권,1000766,성대로1길,312,124,188
2017,3,A,골목상권,1000765,서달로8가길,242,105,137
2017,3,A,골목상권,1000763,서달로14길,32,13,19
2017,3,A,골목상권,1000762,서달로10길,78,30,48
2017,3,A,골목상권,1000761,상도로62길,220,85,135
2017,3,A,골목상권,1000760,상도로61길,43,19,24
2017,3,A,골목상권,1000759,상도로47길,59,43,16
2017,3,A,골목상권,1000758,상도로37길,1945,952,993
2017,3,A,골목상권,1000757,상도로15길,321,137,184
2017,3,A,골목상권,1000756,사당로8길,121,69,52
2017,3,A,골목상권,1000755,사당로30길,298,201,97
2017,3,A,골목상권,1000754,사당로2차길,134,86,48
2017,3,A,골목상권,1000753,사당로29길,16,13,3
2017,3,A,골목상권,1000752,사당로26길,262,149,113
2017,3,A,골목상권,1000751,사당로23나길,127,36,91
2017,3,A,골목상권,1000750,사당로23길,16,13,3
2017,3,A,골목상권,1000749,사당로20길,186,142,44
2017,3,A,골목상권,1000748,사당로16길,136,36,100
2017,3,A,골목상권,1000747,사당로16가길,793,469,324
2017,3,A,골목상권,1000746,만양로8길,88,39,49
2017,3,A,골목상권,1000745,만양로14길,353,149,204
2017,3,A,골목상권,1000744,등용로14길,643,443,200
2017,3,A,골목상권,1000743,동작대로7길,1955,742,1213
2017,3,A,골목상권,1000742,동작대로35길,841,123,718
2017,3,A,골목상권,1000741,동작대로33길,116,63,53
2017,3,A,골목상권,1000740,동작대로29길,30,17,13
2017,3,A,골목상권,1000739,동작대로17길,1344,718,626
2017,3,A,골목상권,1000738,대방동2길,449,213,236
2017,3,A,골목상권,1000737,대방동27길,95,53,42
2017,3,A,골목상권,1000736,노량진로6길,110,28,82
2017,3,A,골목상권,1000735,국사봉길,39,7,32
2017,3,A,골목상권,1000734,국사봉2길,72,38,34
2017,3,A,골목상권,1000733,국사봉1길,7,3,4
2017,3,A,골목상권,1000732,영신로9길,340,188,152
2017,3,A,골목상권,1000731,영등포로84길,426,97,329
2017,3,A,골목상권,1000730,영등포로80길,49,23,26
2017,3,A,골목상권,1000729,영등포로62길,2,2,0
2017,3,A,골목상권,1000728,영등포로35길,88,60,28
2017,3,A,골목상권,1000727,영등포로27길,366,233,133
2017,3,A,골목상권,1000724,여의대방로43나길,2219,1798,421
2017,3,A,골목상권,1000723,여의대방로39길,14,11,3
2017,3,A,골목상권,1000722,여의대방로35길,798,418,380
2017,3,A,골목상권,1000721,양평로28길,613,489,124
2017,3,A,골목상권,1000720,양평로22라길,28,15,13
2017,3,A,골목상권,1000719,양평로19길,4473,3506,967
2017,3,A,골목상권,1000718,신길로60길,502,194,308
2017,3,A,골목상권,1000717,신길로42길,380,190,190
2017,3,A,골목상권,1000716,신길로42가길,101,33,68
2017,3,A,골목상권,1000715,신길로39길,107,46,61
2017,3,A,골목상권,1000714,신길로17길,56,38,18
2017,3,A,골목상권,1000713,선유서로28길,572,276,296
2017,3,A,골목상권,1000712,선유서로25길,2259,1620,639
2017,3,A,골목상권,1000711,선유서로24길,161,86,75
2017,3,A,골목상권,1000710,선유로55길,2389,1421,968
2017,3,A,골목상권,1000709,디지털로74길,49,30,19
2017,3,A,골목상권,1000708,디지털로57길,8,4,4
2017,3,A,골목상권,1000707,디지털로37길,219,93,126
2017,3,A,골목상권,1000706,도신로62길,181,55,126
2017,3,A,골목상권,1000705,도신로60길,67,12,55
2017,3,A,골목상권,1000704,도신로29길,83,37,46
2017,3,A,골목상권,1000703,도신로15길,83,32,51
2017,3,A,골목상권,1000702,도림천로21길,77,30,47
2017,3,A,골목상권,1000701,도림로63길,38,26,12
2017,3,A,골목상권,1000700,도림로147길,1718,1225,493
2017,3,A,골목상권,1000699,도림로112길,14,6,8
2017,3,A,골목상권,1000698,대림로8길,1840,588,1252
2017,3,A,골목상권,1000697,대림로7길,9,5,4
2017,3,A,골목상권,1000696,대림로44길,33,22,11
2017,3,A,골목상권,1000695,대림로34길,200,81,119
2017,3,A,골목상권,1000694,대림로31길,796,441,355
2017,3,A,골목상권,1000693,대림로29길,1644,761,883
2017,3,A,골목상권,1000692,대림로22길,365,204,161
2017,3,A,골목상권,1000691,당산로46길,4216,2534,1682
2017,3,A,골목상권,1000690,당산로38길,195,129,66
2017,3,A,골목상권,1000689,당산로37길,3855,2553,1302
2017,3,A,골목상권,1000688,당산로31길,4268,2309,1959
2017,3,A,골목상권,1000687,국회대로56길,1702,1110,592
2017,3,A,골목상권,1000686,경인로90길,302,183,119
2017,3,A,골목상권,1000685,경인로80길,1549,1117,432
2017,3,A,골목상권,1000684,경인로77길,673,443,230
2017,3,A,골목상권,1000683,가마산로61길,190,70,120
2017,3,A,골목상권,1000682,시흥대로94길,687,342,345
2017,3,A,골목상권,1000681,시흥대로84길,179,73,106
2017,3,A,골목상권,1000680,시흥대로68길,682,177,505
2017,3,A,골목상권,1000679,시흥대로63길,2805,1456,1349
2017,3,A,골목상권,1000678,시흥대로62가길,430,115,315
2017,3,A,골목상권,1000677,시흥대로36길,367,211,156
2017,3,A,골목상권,1000676,시흥대로22길,502,351,151
2017,3,A,골목상권,1000675,시흥대로153길,676,384,292
2017,3,A,골목상권,1000674,시흥대로150길,537,244,293
2017,3,A,골목상권,1000673,시흥대로141길,661,392,269
2017,3,A,골목상권,1000672,시흥대로138길,15,7,8
2017,3,A,골목상권,1000671,시흥대로120길,510,332,178
2017,3,A,골목상권,1000670,벚꽃로56길,1901,1322,579
2017,3,A,골목상권,1000669,범안로17길,139,86,53
2017,3,A,골목상권,1000668,범안로11길,1108,875,233
2017,3,A,골목상권,1000667,문성로5길,156,49,107
2017,3,A,골목상권,1000666,독산로85길,100,28,72
2017,3,A,골목상권,1000665,독산로78다길,227,102,125
2017,3,A,골목상권,1000664,독산로70길,4,3,1
2017,3,A,골목상권,1000663,독산로64길,121,33,88
2017,3,A,골목상권,1000662,독산로50길,93,38,55
2017,3,A,골목상권,1000661,독산로40길,62,23,39
2017,3,A,골목상권,1000660,독산로108길,737,349,388
2017,3,A,골목상권,1000659,남부순환로112길,12,6,6
2017,3,A,골목상권,1000658,금하로24길,175,57,118
2017,3,A,골목상권,1000657,금하로1길,66,30,36
2017,3,A,골목상권,1000656,금하로14길,16,8,8
2017,3,A,골목상권,1000655,가산로5길,566,444,122
2017,3,A,골목상권,1000654,가산로3길,2425,1831,594
2017,3,A,골목상권,1000653,중앙로1길,1513,1052,461
2017,3,A,골목상권,1000652,중앙로15길,90,45,45
2017,3,A,골목상권,1000651,우마길,33,22,11
2017,3,A,골목상권,1000650,오류로8길,241,108,133
2017,3,A,골목상권,1000649,신도림로13길,783,593,190
2017,3,A,골목상권,1000648,새말로18길,1070,452,618
2017,3,A,골목상권,1000647,부일로1길,752,612,140
2017,3,A,골목상권,1000646,부일로15길,178,153,25
2017,3,A,골목상권,1000645,부일로11길,23,5,18
2017,3,A,골목상권,1000644,디지털로32길,1122,583,539
2017,3,A,골목상권,1000643,디지털로32가길,7325,5079,2246
2017,3,A,골목상권,1000642,디지털로27길,385,251,134
2017,3,A,골목상권,1000641,도림로6길,100,45,55
2017,3,A,골목상권,1000640,도림로12길,106,46,60
2017,3,A,골목상권,1000639,남부순환로97길,259,89,170
2017,3,A,골목상권,1000638,구로중앙로8길,207,73,134
2017,3,A,골목상권,1000637,구로중앙로7길,181,59,122
2017,3,A,골목상권,1000636,구로중앙로42길,805,608,197
2017,3,A,골목상권,1000635,구로중앙로34길,627,367,260
2017,3,A,골목상권,1000634,구로중앙로28길,3021,1453,1568
2017,3,A,골목상권,1000633,구로중앙로19길,12,6,6
2017,3,A,골목상권,1000632,구로동로8길,148,44,104
2017,3,A,골목상권,1000631,구로동로7길,166,65,101
2017,3,A,골목상권,1000630,구로동로42길,22,14,8
2017,3,A,골목상권,1000629,구로동로41길,463,292,171
2017,3,A,골목상권,1000628,구로동로38길,37,14,23
2017,3,A,골목상권,1000627,구로동로28길,202,93,109
2017,3,A,골목상권,1000626,구로동로15길,21,2,19
2017,3,A,골목상권,1000625,공원로6가길,303,213,90
2017,3,A,골목상권,1000624,고척로52길,234,65,169
2017,3,A,골목상권,1000623,고척로27다길,212,82,130
2017,3,A,골목상권,1000622,고척로27길,244,113,131
2017,3,A,골목상권,1000621,고척로21나길,229,63,166
2017,3,A,골목상권,1000620,경인로47길,889,497,392
2017,3,A,골목상권,1000619,경인로35길,292,118,174
2017,3,A,골목상권,1000618,경인로31길,58,20,38
2017,3,A,골목상권,1000617,경인로15길,134,58,76
2017,3,A,골목상권,1000616,개봉로3길,244,150,94
2017,3,A,골목상권,1000615,개봉로2길,481,137,344
2017,3,A,골목상권,1000614,개봉로23가길,937,556,381
2017,3,A,골목상권,1000613,개봉로20길,124,72,52
2017,3,A,골목상권,1000612,개봉로1길,51,26,25
2017,3,A,골목상권,1000611,개봉로17다길,168,79,89
2017,3,A,골목상권,1000610,개봉로17길,872,356,516
2017,3,A,골목상권,1000609,개봉로11길,49,10,39
2017,3,A,골목상권,1000608,화곡로64길,2966,1641,1325
2017,3,A,골목상권,1000607,화곡로59길,476,195,281
2017,3,A,골목상권,1000606,화곡로44나길,830,710,120
2017,3,A,골목상권,1000605,화곡로31길,1142,416,726
2017,3,A,골목상권,1000604,화곡로20길,520,334,186
2017,3,A,골목상권,1000603,화곡로13길,264,88,176
2017,3,A,골목상권,1000602,초원로16길,690,318,372
2017,3,A,골목상권,1000601,초록마을로8길,174,35,139
2017,3,A,골목상권,1000600,초록마을로3길,50,25,25
2017,3,A,골목상권,1000599,월정로20길,4,2,2
2017,3,A,골목상권,1000598,우장산로6길,306,168,138
2017,3,A,골목상권,1000597,양천로73가길,1321,838,483
2017,3,A,골목상권,1000596,양천로71길,203,132,71
2017,3,A,골목상권,1000595,양천로49길,709,575,134
2017,3,A,골목상권,1000594,양천로26길,144,58,86
2017,3,A,골목상권,1000593,양천로24길,350,141,209
2017,3,A,골목상권,1000592,양천로24가길,696,316,380
2017,3,A,골목상권,1000591,양천로14길,232,143,89
2017,3,A,골목상권,1000590,방화대로6라길,762,481,281
2017,3,A,골목상권,1000589,방화대로21길,845,512,333
2017,3,A,골목상권,1000588,등촌로5길,10,3,7
2017,3,A,골목상권,1000587,등촌로55길,509,347,162
2017,3,A,골목상권,1000586,등촌로51길,19,11,8
2017,3,A,골목상권,1000585,등촌로39길,66,24,42
2017,3,A,골목상권,1000584,등촌로13길,196,105,91
2017,3,A,골목상권,1000583,남부순환로11길,413,289,124
2017,3,A,골목상권,1000582,까치산로4길,144,57,87
2017,3,A,골목상권,1000581,국회대로7길,376,223,153
2017,3,A,골목상권,1000580,공항대로8길,200,81,119
2017,3,A,골목상권,1000579,공항대로61길,223,145,78
2017,3,A,골목상권,1000578,공항대로59다길,890,646,244
2017,3,A,골목상권,1000577,공항대로59길,1182,774,408
2017,3,A,골목상권,1000576,공항대로55길,1076,736,340
2017,3,A,골목상권,1000575,공항대로42길,6,3,3
2017,3,A,골목상권,1000574,공항대로38길,270,146,124
2017,3,A,골목상권,1000573,곰달래로60길,560,296,264
2017,3,A,골목상권,1000572,곰달래로53길,61,19,42
2017,3,A,골목상권,1000571,곰달래로47길,38,14,24
2017,3,A,골목상권,1000570,곰달래로31길,12,10,2
2017,3,A,골목상권,1000569,곰달래로25길,617,251,366
2017,3,A,골목상권,1000568,개화동로25길,670,430,240
2017,3,A,골목상권,1000567,개화동로23길,128,87,41
2017,3,A,골목상권,1000566,강서로8길,148,83,65
2017,3,A,골목상권,1000565,강서로5라길,297,175,122
2017,3,A,골목상권,1000564,강서로5나길,116,66,50
2017,3,A,골목상권,1000563,강서로5가길,48,25,23
2017,3,A,골목상권,1000562,강서로47라길,107,57,50
2017,3,A,골목상권,1000561,강서로47길,392,201,191
2017,3,A,골목상권,1000560,강서로45다길,789,396,393
2017,3,A,골목상권,1000559,강서로45길,141,63,78
2017,3,A,골목상권,1000558,강서로35길,176,99,77
2017,3,A,골목상권,1000557,강서로29길,316,160,156
2017,3,A,골목상권,1000556,강서로18길,26,13,13
2017,3,A,골목상권,1000555,강서로17가길,118,50,68
2017,3,A,골목상권,1000554,강서로15길,266,129,137
2017,3,A,골목상권,1000553,가로공원로80길,57,30,27
2017,3,A,골목상권,1000552,가로공원로76가길,28,13,15
2017,3,A,골목상권,1000551,화곡로4길,244,92,152
2017,3,A,골목상권,1000550,화곡로3길,179,64,115
2017,3,A,골목상권,1000549,지양로7길,227,76,151
2017,3,A,골목상권,1000548,중앙로55길,362,190,172
2017,3,A,골목상권,1000547,중앙로51길,142,90,52
2017,3,A,골목상권,1000546,중앙로47길,127,34,93
2017,3,A,골목상권,1000545,중앙로45길,155,50,105
2017,3,A,골목상권,1000544,중앙로36길,2,2,0
2017,3,A,골목상권,1000543,중앙로32길,623,292,331
2017,3,A,골목상권,1000542,중앙로25길,245,65,180
2017,3,A,골목상권,1000541,은행정로7길,498,163,335
2017,3,A,골목상권,1000539,오목로5길,285,168,117
2017,3,A,골목상권,1000538,오목로3길,418,393,25
2017,3,A,골목상권,1000537,오목로30길,150,76,74
2017,3,A,골목상권,1000536,오목로23길,801,456,345
2017,3,A,골목상권,1000535,신월로20길,209,78,131
2017,3,A,골목상권,1000534,신월로15길,793,359,434
2017,3,A,골목상권,1000533,신목로6길,253,141,112
2017,3,A,골목상권,1000532,신목로5길,870,328,542
2017,3,A,골목상권,1000531,신목로2길,99,48,51
2017,3,A,골목상권,1000530,목동중앙서로8가길,175,103,72
2017,3,A,골목상권,1000529,목동중앙서로7길,235,72,163
2017,3,A,골목상권,1000528,목동중앙북로8길,334,115,219
2017,3,A,골목상권,1000527,목동중앙북로16길,281,91,190
2017,3,A,골목상권,1000526,목동중앙본로7길,113,46,67
2017,3,A,골목상권,1000525,목동중앙로3길,108,58,50
2017,3,A,골목상권,1000524,목동중앙로13나길,291,213,78
2017,3,A,골목상권,1000523,목동중앙남로3가길,544,353,191
2017,3,A,골목상권,1000522,목동로9길,2381,1501,880
2017,3,A,골목상권,1000521,목동로19길,987,337,650
2017,3,A,골목상권,1000519,목동동로12길,416,149,267
2017,3,A,골목상권,1000518,목동남로4길,10,4,6
2017,3,A,골목상권,1000517,남부순환로88길,294,122,172
2017,3,A,골목상권,1000516,남부순환로79길,415,314,101
2017,3,A,골목상권,1000515,남부순환로70길,525,323,202
2017,3,A,골목상권,1000514,남부순환로58길,187,110,77
2017,3,A,골목상권,1000513,남부순환로40길,15,5,10
2017,3,A,골목상권,1000512,남부순환로33길,1214,978,236
2017,3,A,골목상권,1000511,곰달래로5길,53,31,22
2017,3,A,골목상권,1000510,곰달래로3길,375,203,172
2017,3,A,골목상권,1000509,곰달래로2길,267,148,119
2017,3,A,골목상권,1000508,곰달래로10길,327,232,95
2017,3,A,골목상권,1000507,가로공원로58길,75,15,60
2017,3,A,골목상권,1000506,효창원로93길,94,46,48
2017,3,A,골목상권,1000505,토정로37길,130,58,72
2017,3,A,골목상권,1000504,월드컵로8길,1843,947,896
2017,3,A,골목상권,1000503,월드컵로7길,4,2,2
2017,3,A,골목상권,1000502,월드컵로36길,145,63,82
2017,3,A,골목상권,1000501,월드컵로25길,279,157,122
2017,3,A,골목상권,1000500,월드컵로19길,764,312,452
2017,3,A,골목상권,1000499,월드컵로16길,3995,2036,1959
2017,3,A,골목상권,1000498,월드컵로11길,272,120,152
2017,3,A,골목상권,1000497,월드컵로10길,1644,857,787
2017,3,A,골목상권,1000496,와우산로3길,148,84,64
2017,3,A,골목상권,1000495,와우산로29길,186,96,90
2017,3,A,골목상권,1000494,와우산로29가길,21,10,11
2017,3,A,골목상권,1000493,양화진길,439,304,135
2017,3,A,골목상권,1000492,양화로1길,4120,1917,2203
2017,3,A,골목상권,1000491,양화로11길,380,250,130
2017,3,A,골목상권,1000490,신촌로30길,24,17,7
2017,3,A,골목상권,1000489,신촌로28가길,109,41,68
2017,3,A,골목상권,1000488,신촌로12길,1404,646,758
2017,3,A,골목상권,1000487,숭문길,3330,2289,1041
2017,3,A,골목상권,1000486,숭문8길,116,69,47
2017,3,A,골목상권,1000485,성지3길,454,231,223
2017,3,A,골목상권,1000484,성산로4길,1687,1082,605
2017,3,A,골목상권,1000483,성미산로32길,409,189,220
2017,3,A,골목상권,1000482,성미산로1길,636,440,196
2017,3,A,골목상권,1000481,성미산로11길,1088,742,346
2017,3,A,골목상권,1000480,백범로16길,604,306,298
2017,3,A,골목상권,1000479,방울내로9안길,313,193,120
2017,3,A,골목상권,1000478,모래내로7길,264,135,129
2017,3,A,골목상권,1000477,매봉산로2길,1815,1138,677
2017,3,A,골목상권,1000476,망원로2길,190,110,80
2017,3,A,골목상권,1000475,망원로11길,1098,624,474
2017,3,A,골목상권,1000474,만리재옛길,1421,615,806
2017,3,A,골목상권,1000473,마포대로4길,171,93,78
2017,3,A,골목상권,1000472,마포대로20길,1161,597,564
2017,3,A,골목상권,1000471,마포대로12길,68,37,31
2017,3,A,골목상권,1000470,동교로38길,248,119,129
2017,3,A,골목상권,1000469,동교로27길,3538,1602,1936
2017,3,A,골목상권,1000468,동교로25길,547,271,276
2017,3,A,골목상권,1000467,동교로19길,4557,3104,1453
2017,3,A,골목상권,1000466,동교로17길,844,435,409
2017,3,A,골목상권,1000465,독막로8길,295,131,164
2017,3,A,골목상권,1000464,독막로32길,460,200,260
2017,3,A,골목상권,1000463,독막로22길,116,67,49
2017,3,A,골목상권,1000462,도화길,1059,531,528
2017,3,A,골목상권,1000461,도화4길,380,130,250
2017,3,A,골목상권,1000460,대흥로28길,53,41,12
2017,3,A,골목상권,1000459,대흥로21길,458,82,376
2017,3,A,골목상권,1000458,광성로6길,135,86,49
2017,3,A,골목상권,1000457,홍제내길,116,64,52
2017,3,A,골목상권,1000456,홍연길,76,44,32
2017,3,A,골목상권,1000455,통일로39길,11,9,2
2017,3,A,골목상권,1000454,통일로37길,367,141,226
2017,3,A,골목상권,1000453,통일로11길,9,8,1
2017,3,A,골목상권,1000452,충정로6길,13745,7837,5908
2017,3,A,골목상권,1000451,충정로4길,3043,2022,1021
2017,3,A,골목상권,1000450,증가로6길,213,91,122
2017,3,A,골목상권,1000449,증가로23나길,459,239,220
2017,3,A,골목상권,1000448,증가로20가길,246,85,161
2017,3,A,골목상권,1000447,증가로10길,160,85,75
2017,3,A,골목상권,1000446,응암로1길,395,283,112
2017,3,A,골목상권,1000445,연희로10길,115,78,37
2017,3,A,골목상권,1000444,신촌로37길,108,48,60
2017,3,A,골목상권,1000443,수색로8길,3051,2834,217
2017,3,A,골목상권,1000442,세무서길,334,118,216
2017,3,A,골목상권,1000440,세검정로1길,325,182,143
2017,3,A,골목상권,1000439,북아현로4길,416,92,324
2017,3,A,골목상권,1000438,모래내로15길,93,25,68
2017,3,A,골목상권,1000437,명지대길,386,286,100
2017,3,A,골목상권,1000436,독립문로8길,726,276,450
2017,3,A,골목상권,1000435,가재울로6길,20,10,10
2017,3,A,골목상권,1000434,통일로92길,78,36,42
2017,3,A,골목상권,1000433,통일로87길,216,102,114
2017,3,A,골목상권,1000432,통일로78길,209,61,148
2017,3,A,골목상권,1000430,진흥로1길,526,165,361
2017,3,A,골목상권,1000429,진흥로12길,485,195,290
2017,3,A,골목상권,1000428,증산서길,568,288,280
2017,3,A,골목상권,1000427,증산로9길,89,25,64
2017,3,A,골목상권,1000426,증산로5길,779,395,384
2017,3,A,골목상권,1000425,증산로21길,241,159,82
2017,3,A,골목상권,1000424,증산로17길,751,335,416
2017,3,A,골목상권,1000423,증산로15길,202,79,123
2017,3,A,골목상권,1000422,증산로13길,72,35,37
2017,3,A,골목상권,1000421,응암로34길,64,42,22
2017,3,A,골목상권,1000420,응암로22길,151,52,99
2017,3,A,골목상권,1000419,응암로14길,379,129,250
2017,3,A,골목상권,1000418,응암로13길,281,116,165
2017,3,A,골목상권,1000417,응암로12길,203,111,92
2017,3,A,골목상권,1000416,은평로8길,276,146,130
2017,3,A,골목상권,1000415,은평로3길,308,95,213
2017,3,A,골목상권,1000414,은평로20길,23,10,13
2017,3,A,골목상권,1000413,은평로13길,385,255,130
2017,3,A,골목상권,1000412,은평로10길,341,176,165
2017,3,A,골목상권,1000411,연서로5길,42,12,30
2017,3,A,골목상권,1000410,연서로41길,245,74,171
2017,3,A,골목상권,1000409,연서로3길,109,42,67
2017,3,A,골목상권,1000408,연서로34길,167,52,115
2017,3,A,골목상권,1000407,연서로33길,25,8,17
2017,3,A,골목상권,1000406,연서로29길,330,120,210
2017,3,A,골목상권,1000405,연서로28길,815,359,456
2017,3,A,골목상권,1000404,연서로27길,73,28,45
2017,3,A,골목상권,1000403,연서로21길,343,212,131
2017,3,A,골목상권,1000402,연서로17길,1189,357,832
2017,3,A,골목상권,1000401,연서로16길,259,98,161
2017,3,A,골목상권,1000400,연서로13길,729,223,506
2017,3,A,골목상권,1000399,연서로11길,239,111,128
2017,3,A,골목상권,1000398,역말로9길,19,13,6
2017,3,A,골목상권,1000397,수색로18길,21,9,12
2017,3,A,골목상권,1000396,서오릉로8길,15,0,15
2017,3,A,골목상권,1000395,서오릉로21길,409,103,306
2017,3,A,골목상권,1000394,불광천길,191,99,92
2017,3,A,골목상권,1000393,갈현로7길,914,259,655
2017,3,A,골목상권,1000392,갈현로41길,96,41,55
2017,3,A,골목상권,1000391,갈현로33길,37,9,28
2017,3,A,골목상권,1000390,갈현로1길,165,73,92
2017,3,A,골목상권,1000389,가좌로7길,58,28,30
2017,3,A,골목상권,1000388,한글비석로44길,421,231,190
2017,3,A,골목상권,1000387,한글비석로24길,403,165,238
2017,3,A,골목상권,1000386,한글비석로22길,671,309,362
2017,3,A,골목상권,1000385,석계로1길,105,67,38
2017,3,A,골목상권,1000384,상계로9가길,301,113,188
2017,3,A,골목상권,1000382,상계로12길,28,19,9
2017,3,A,골목상권,1000381,동일로242길,296,185,111
2017,3,A,골목상권,1000380,동일로192길,450,200,250
2017,3,A,골목상권,1000379,동일로173가길,2262,1201,1061
2017,3,A,골목상권,1000378,공릉로58길,134,48,86
2017,3,A,골목상권,1000377,해등로16길,88,69,19
2017,3,A,골목상권,1000376,우이천로4다길,181,106,75
2017,3,A,골목상권,1000375,우이천로32길,100,59,41
2017,3,A,골목상권,1000374,시루봉로23길,47,22,25
2017,3,A,골목상권,1000373,삼양로144길,80,58,22
2017,3,A,골목상권,1000372,방학로6가길,172,91,81
2017,3,A,골목상권,1000371,방학로5길,113,70,43
2017,3,A,골목상권,1000370,방학로15길,326,208,118
2017,3,A,골목상권,1000369,방학로10길,172,74,98
2017,3,A,골목상권,1000367,도봉산4길,322,280,42
2017,3,A,골목상권,1000366,도봉로181길,188,81,107
2017,3,A,골목상권,1000365,도봉로169나길,297,127,170
2017,3,A,골목상권,1000364,도봉로156길,256,132,124
2017,3,A,골목상권,1000363,도봉로152가길,417,365,52
2017,3,A,골목상권,1000362,도봉로147길,576,320,256
2017,3,A,골목상권,1000360,도봉로114길,506,182,324
2017,3,A,골목상권,1000359,도봉로109길,20,7,13
2017,3,A,골목상권,1000358,도당로29길,868,495,373
2017,3,A,골목상권,1000357,도당로19길,192,79,113
2017,3,A,골목상권,1000356,도당로13바길,194,85,109
2017,3,A,골목상권,1000355,도당로13가길,159,64,95
2017,3,A,골목상권,1000354,덕릉로60길,83,48,35
2017,3,A,골목상권,1000353,노해로63다길,596,261,335
2017,3,A,골목상권,1000352,노해로60길,325,145,180
2017,3,A,골목상권,1000351,한천로140길,97,49,48
2017,3,A,골목상권,1000350,한천로139가길,54,32,22
2017,3,A,골목상권,1000349,한천로132길,333,133,200
2017,3,A,골목상권,1000348,한천로130길,276,124,152
2017,3,A,골목상권,1000347,한천로124나길,85,47,38
2017,3,A,골목상권,1000346,한천로109길,591,261,330
2017,3,A,골목상권,1000345,인수봉로79길,173,46,127
2017,3,A,골목상권,1000344,인수봉로72길,75,36,39
2017,3,A,골목상권,1000342,오패산로67길,592,293,299
2017,3,A,골목상권,1000341,오패산로52길,110,42,68
2017,3,A,골목상권,1000339,수유로12길,264,170,94
2017,3,A,골목상권,1000338,솔샘로65길,506,233,273
2017,3,A,골목상권,1000337,솔매로50길,682,273,409
2017,3,A,골목상권,1000336,솔매로45길,175,87,88
2017,3,A,골목상권,1000335,솔매로41길,87,24,63
2017,3,A,골목상권,1000334,삼양로93길,18,4,14
2017,3,A,골목상권,1000333,삼양로77길,434,151,283
2017,3,A,골목상권,1000332,삼양로54길,8,4,4
2017,3,A,골목상권,1000331,삼양로41길,299,134,165
2017,3,A,골목상권,1000329,삼양로24길,81,38,43
2017,3,A,골목상권,1000328,삼양로20길,127,48,79
2017,3,A,골목상권,1000327,삼각산로28길,834,422,412
2017,3,A,골목상권,1000326,도봉로99길,206,99,107
2017,3,A,골목상권,1000325,도봉로8길,244,182,62
2017,3,A,골목상권,1000324,도봉로76길,402,217,185
2017,3,A,골목상권,1000323,도봉로67길,6,3,3
2017,3,A,골목상권,1000322,도봉로45길,113,70,43
2017,3,A,골목상권,1000321,도봉로18길,390,174,216
2017,3,A,골목상권,1000320,도봉로13길,36,11,25
2017,3,A,골목상권,1000319,덕릉로41길,776,622,154
2017,3,A,골목상권,1000318,덕릉로40길,902,698,204
2017,3,A,골목상권,1000317,노해로33길,35,12,23
2017,3,A,골목상권,1000315,노해로17길,225,69,156
2017,3,A,골목상권,1000314,화랑로40길,184,94,90
2017,3,A,골목상권,1000313,화랑로32길,466,348,118
2017,3,A,골목상권,1000312,화랑로1길,162,87,75
2017,3,A,골목상권,1000311,화랑로19길,510,269,241
2017,3,A,골목상권,1000310,화랑로14길,50,22,28
2017,3,A,골목상권,1000309,화랑로13길,93,46,47
2017,3,A,골목상권,1000308,한천로76길,130,75,55
2017,3,A,골목상권,1000307,한천로101가길,51,29,22
2017,3,A,골목상권,1000306,창경궁로43길,26,15,11
2017,3,A,골목상권,1000305,지봉로20길,95,60,35
2017,3,A,골목상권,1000304,종암로5길,123,86,37
2017,3,A,골목상권,1000303,종암로24가길,288,136,152
2017,3,A,골목상권,1000302,종암로21길,240,49,191
2017,3,A,골목상권,1000301,종암로19길,375,114,261
2017,3,A,골목상권,1000300,종암로16길,78,34,44
2017,3,A,골목상권,1000299,정릉로8길,185,106,79
2017,3,A,골목상권,1000298,정릉로27길,199,80,119
2017,3,A,골목상권,1000296,장위로50길,885,489,396
2017,3,A,골목상권,1000295,장월로1길,398,182,216
2017,3,A,골목상권,1000294,인촌로6길,2823,1608,1215
2017,3,A,골목상권,1000293,인촌로5길,28,3,25
2017,3,A,골목상권,1000292,인촌로24길,221,157,64
2017,3,A,골목상권,1000291,개운사길,3408,2109,1299
2017,3,A,골목상권,1000290,인촌로1길,159,106,53
2017,3,A,골목상권,1000289,인촌로17가길,3174,1150,2024
2017,3,A,골목상권,1000288,오패산로4길,605,195,410
2017,3,A,골목상권,1000287,오패산로3길,1250,723,527
2017,3,A,골목상권,1000286,오패산로19길,43,17,26
2017,3,A,골목상권,1000285,안암로5길,609,380,229
2017,3,A,골목상권,1000284,아리랑로4길,587,215,372
2017,3,A,골목상권,1000283,솔샘로6길,152,75,77
2017,3,A,골목상권,1000282,성북로8길,54,27,27
2017,3,A,골목상권,1000281,삼양로8길,97,62,35
2017,3,A,골목상권,1000280,삼선교로16가길,719,416,303
2017,3,A,골목상권,1000279,삼선교로10다길,101,48,53
2017,3,A,골목상권,1000278,삼선교로10길,254,125,129
2017,3,A,골목상권,1000277,보문로32길,983,396,587
2017,3,A,골목상권,1000276,보문로31길,710,294,416
2017,3,A,골목상권,1000274,보문로13길,782,471,311
2017,3,A,골목상권,1000273,보국문로16길,349,235,114
2017,3,A,골목상권,1000270,동소문로26가길,290,165,125
2017,3,A,골목상권,1000269,동소문로15길,94,44,50
2017,3,A,골목상권,1000268,동소문로13길,414,213,201
2017,3,A,골목상권,1000267,돌곶이로8길,207,107,100
2017,3,A,골목상권,1000266,돌곶이로41길,43,20,23
2017,3,A,골목상권,1000265,돌곶이로28길,236,155,81
2017,3,A,골목상권,1000264,돌곶이로27길,74,39,35
2017,3,A,골목상권,1000263,돌곶이로22길,134,73,61
2017,3,A,골목상권,1000262,돌곶이로14길,3,3,0
2017,3,A,골목상권,1000261,길음로7길,8,5,3
2017,3,A,골목상권,1000260,중랑천로10길,748,404,344
2017,3,A,골목상권,1000259,용마산로94길,436,266,170
2017,3,A,골목상권,1000258,용마산로118길,693,396,297
2017,3,A,골목상권,1000257,용마산로112길,348,152,196
2017,3,A,골목상권,1000256,용마산로100길,407,281,126
2017,3,A,골목상권,1000255,신내로7가길,272,67,205
2017,3,A,골목상권,1000254,사가정로54길,111,33,78
2017,3,A,골목상권,1000253,사가정로42길,78,19,59
2017,3,A,골목상권,1000252,봉화산로56길,590,152,438
2017,3,A,골목상권,1000251,봉화산로4길,402,143,259
2017,3,A,골목상권,1000250,봉화산로30길,358,221,137
2017,3,A,골목상권,1000249,봉우재로33길,114,46,68
2017,3,A,골목상권,1000248,면목로78길,289,155,134
2017,3,A,골목상권,1000247,면목로56길,209,156,53
2017,3,A,골목상권,1000246,면목로55길,439,136,303
2017,3,A,골목상권,1000245,면목로49길,550,176,374
2017,3,A,골목상권,1000244,면목로48길,125,64,61
2017,3,A,골목상권,1000243,면목로45길,68,31,37
2017,3,A,골목상권,1000242,면목로33길,374,147,227
2017,3,A,골목상권,1000241,면목로21길,47,38,9
2017,3,A,골목상권,1000240,망우로73길,8,4,4
2017,3,A,골목상권,1000239,망우로68길,85,35,50
2017,3,A,골목상권,1000238,동일로163길,104,70,34
2017,3,A,골목상권,1000237,동일로157길,196,105,91
2017,3,A,골목상권,1000236,동일로149길,1131,842,289
2017,3,A,골목상권,1000235,동일로140길,216,85,131
2017,3,A,골목상권,1000234,동일로139길,65,42,23
2017,3,A,골목상권,1000233,동일로139가길,1122,667,455
2017,3,A,골목상권,1000232,동일로130길,98,23,75
2017,3,A,골목상권,1000231,동일로123길,179,86,93
2017,3,A,골목상권,1000230,동일로112길,159,68,91
2017,3,A,골목상권,1000229,동일로101길,303,121,182
2017,3,A,골목상권,1000228,동일로100길,31,15,16
2017,3,A,골목상권,1000227,답십리로75길,95,53,42
2017,3,A,골목상권,1000226,공릉로2길,661,309,352
2017,3,A,골목상권,1000225,공릉로12가길,34,24,10
2017,3,A,골목상권,1000224,겸재로54길,114,54,60
2017,3,A,골목상권,1000223,겸재로36길,229,197,32
2017,3,A,골목상권,1000222,겸재로29길,442,191,251
2017,3,A,골목상권,1000221,휘경로3길,215,98,117
2017,3,A,골목상권,1000220,휘경로2길,6,2,4
2017,3,A,골목상권,1000219,휘경로23길,20,5,15
2017,3,A,골목상권,1000218,휘경로14길,107,44,63
2017,3,A,골목상권,1000217,한천로46길,391,129,262
2017,3,A,골목상권,1000216,한천로40길,325,174,151
2017,3,A,골목상권,1000215,한천로33길,76,34,42
2017,3,A,골목상권,1000214,한천로14길,630,370,260
2017,3,A,골목상권,1000213,천호대로97길,341,211,130
2017,3,A,골목상권,1000212,천호대로77길,2215,1222,993
2017,3,A,골목상권,1000211,천호대로45길,135,80,55
2017,3,A,골목상권,1000210,천호대로17길,2318,1488,830
2017,3,A,골목상권,1000209,천호대로12길,848,565,283
2017,3,A,골목상권,1000208,천장산로7길,1474,897,577
2017,3,A,골목상권,1000207,제기로5길,208,101,107
2017,3,A,골목상권,1000206,제기로21길,218,146,72
2017,3,A,골목상권,1000205,전농로4길,712,449,263
2017,3,A,골목상권,1000204,전농로3길,74,35,39
2017,3,A,골목상권,1000203,전농로29길,312,139,173
2017,3,A,골목상권,1000202,장한로8길,825,493,332
2017,3,A,골목상권,1000201,장한로5길,3001,2113,888
2017,3,A,골목상권,1000200,장한로27길,158,40,118
2017,3,A,골목상권,1000199,장한로27가길,400,187,213
2017,3,A,골목상권,1000198,장한로26길,566,275,291
2017,3,A,골목상권,1000197,장한로26가길,338,141,197
2017,3,A,골목상권,1000196,장한로25길,1077,482,595
2017,3,A,골목상권,1000195,장한로14길,185,150,35
2017,3,A,골목상권,1000194,이문로42길,241,90,151
2017,3,A,골목상권,1000193,왕산로43길,979,465,514
2017,3,A,골목상권,1000192,왕산로33길,147,99,48
2017,3,A,골목상권,1000191,왕산로32길,10,7,3
2017,3,A,골목상권,1000190,약령시로17길,300,130,170
2017,3,A,골목상권,1000189,서울시립대로4길,648,336,312
2017,3,A,골목상권,1000188,서울시립대로29길,243,135,108
2017,3,A,골목상권,1000187,서울시립대로16길,130,33,97
2017,3,A,골목상권,1000186,사가정로2길,91,72,19
2017,3,A,골목상권,1000185,사가정로23가길,96,58,38
2017,3,A,골목상권,1000184,사가정로13길,266,83,183
2017,3,A,골목상권,1000183,무학로45길,372,215,157
2017,3,A,골목상권,1000182,무학로16길,1163,1061,102
2017,3,A,골목상권,1000181,망우로21길,188,108,80
2017,3,A,골목상권,1000180,망우로18길,374,134,240
2017,3,A,골목상권,1000179,망우로18가길,68,27,41
2017,3,A,골목상권,1000178,답십리로72길,3,2,1
2017,3,A,골목상권,1000177,답십리로69길,925,397,528
2017,3,A,골목상권,1000176,답십리로68길,114,76,38
2017,3,A,골목상권,1000175,답십리로64길,337,193,144
2017,3,A,골목상권,1000174,답십리로63길,99,57,42
2017,3,A,골목상권,1000173,답십리로60길,12,7,5
2017,3,A,골목상권,1000172,답십리로56길,4,4,0
2017,3,A,골목상권,1000171,답십리로23길,9,8,1
2017,3,A,골목상권,1000170,난계로30길,121,87,34
2017,3,A,골목상권,1000168,경희대로3길,276,177,99
2017,3,A,골목상권,1000167,천호대로129길,249,86,163
2017,3,A,골목상권,1000166,천호대로123길,268,105,163
2017,3,A,골목상권,1000165,천호대로109길,1139,628,511
2017,3,A,골목상권,1000164,자양번영로3길,97,44,53
2017,3,A,골목상권,1000163,자양로53길,3,0,3
2017,3,A,골목상권,1000162,자양로50길,18,5,13
2017,3,A,골목상권,1000161,자양로45길,572,304,268
2017,3,A,골목상권,1000160,자양로26길,325,113,212
2017,3,A,골목상권,1000159,자양로15길,389,245,144
2017,3,A,골목상권,1000158,자양로11길,1423,701,722
2017,3,A,골목상권,1000157,용마산로3길,886,503,383
2017,3,A,골목상권,1000156,용마산로21길,146,63,83
2017,3,A,골목상권,1000155,아차산로78길,2596,1383,1213
2017,3,A,골목상권,1000154,아차산로65길,740,506,234
2017,3,A,골목상권,1000153,아차산로55길,331,187,144
2017,3,A,골목상권,1000152,아차산로51길,270,151,119
2017,3,A,골목상권,1000151,아차산로40길,558,321,237
2017,3,A,골목상권,1000150,면목로17길,247,160,87
2017,3,A,골목상권,1000149,뚝섬로64길,335,178,157
2017,3,A,골목상권,1000148,뚝섬로58길,184,58,126
2017,3,A,골목상권,1000147,뚝섬로54길,222,152,70
2017,3,A,골목상권,1000146,뚝섬로48길,822,356,466
2017,3,A,골목상권,1000145,뚝섬로24길,88,26,62
2017,3,A,골목상권,1000144,뚝섬로23길,120,70,50
2017,3,A,골목상권,1000143,동일로24길,8,2,6
2017,3,A,골목상권,1000142,동일로18길,172,69,103
2017,3,A,골목상권,1000141,능동로4길,239,97,142
2017,3,A,골목상권,1000140,능동로3길,233,113,120
2017,3,A,골목상권,1000139,능동로34길,948,507,441
2017,3,A,골목상권,1000138,능동로19길,326,197,129
2017,3,A,골목상권,1000137,능동로13길,369,124,245
2017,3,A,골목상권,1000136,긴고랑로9길,48,25,23
2017,3,A,골목상권,1000135,긴고랑로8길,206,182,24
2017,3,A,골목상권,1000134,긴고랑로7길,525,255,270
2017,3,A,골목상권,1000133,긴고랑로20길,531,248,283
2017,3,A,골목상권,1000132,광나루로52길,1980,995,985
2017,3,A,골목상권,1000131,광나루로40길,100,50,50
2017,3,A,골목상권,1000130,광나루로37길,281,169,112
2017,3,A,골목상권,1000129,광나루로36길,44,26,18
2017,3,A,골목상권,1000128,광나루로24길,57,30,27
2017,3,A,골목상권,1000127,광나루로12길,1017,565,452
2017,3,A,골목상권,1000126,한림말길,61,33,28
2017,3,A,골목상권,1000124,청계천로10나길,1802,1075,727
2017,3,A,골목상권,1000123,장터길,44,13,31
2017,3,A,골목상권,1000122,용답중앙길,89,49,40
2017,3,A,골목상권,1000121,용답29길,1788,921,867
2017,3,A,골목상권,1000120,왕십리로6길,1411,768,643
2017,3,A,골목상권,1000119,왕십리로31길,100,47,53
2017,3,A,골목상권,1000118,왕십리로26길,3994,2614,1380
2017,3,A,골목상권,1000117,왕십리로21길,169,53,116
2017,3,A,골목상권,1000116,왕십리로14길,2712,1949,763
2017,3,A,골목상권,1000115,아차산로5길,2268,1508,760
2017,3,A,골목상권,1000114,아차산로15길,4290,3038,1252
2017,3,A,골목상권,1000113,아차산로11길,3653,2344,1309
2017,3,A,골목상권,1000112,송정4가길,1103,483,620
2017,3,A,골목상권,1000111,송정12라길,293,182,111
2017,3,A,골목상권,1000110,성수일로6길,2636,1647,989
2017,3,A,골목상권,1000109,성수이로7길,491,290,201
2017,3,A,골목상권,1000108,성수이로18길,2242,1539,703
2017,3,A,골목상권,1000107,성덕정길,902,498,404
2017,3,A,골목상권,1000106,성덕정17길,234,130,104
2017,3,A,골목상권,1000105,서울숲2길,1277,726,551
2017,3,A,골목상권,1000104,상원길,1698,1102,596
2017,3,A,골목상권,1000103,상원12길,181,109,72
2017,3,A,골목상권,1000102,사근동길,30,16,14
2017,3,A,골목상권,1000101,무학봉길,4,2,2
2017,3,A,골목상권,1000100,무학봉28길,152,70,82
2017,3,A,골목상권,1000099,무학로6길,378,224,154
2017,3,A,골목상권,1000098,무수막길,128,59,69
2017,3,A,골목상권,1000097,매봉길,8,5,3
2017,3,A,골목상권,1000096,마조로1길,203,74,129
2017,3,A,골목상권,1000095,마조로16길,822,573,249
2017,3,A,골목상권,1000094,마장로39길,86,37,49
2017,3,A,골목상권,1000093,마장로27길,87,28,59
2017,3,A,골목상권,1000091,둘레9길,409,240,169
2017,3,A,골목상권,1000090,금호산길,431,153,278
2017,3,A,골목상권,1000089,금호산2길,38,16,22
2017,3,A,골목상권,1000088,고산자로6길,14354,5859,8495
2017,3,A,골목상권,1000087,후암로28길,202,91,111
2017,3,A,골목상권,1000086,효창원로39길,51,27,24
2017,3,A,골목상권,1000085,회나무로13길,54,30,24
2017,3,A,골목상권,1000084,한남대로20길,758,419,339
2017,3,A,골목상권,1000082,한강대로7길,536,351,185
2017,3,A,골목상권,1000081,한강대로62길,728,498,230
2017,3,A,골목상권,1000080,한강대로52길,1095,697,398
2017,3,A,골목상권,1000079,한강대로43길,5963,3777,2186
2017,3,A,골목상권,1000078,한강대로15길,1745,351,1394
2017,3,A,골목상권,1000077,한강대로104길,5661,3923,1738
2017,3,A,골목상권,1000076,청파로73길,1163,639,524
2017,3,A,골목상권,1000075,청파로71길,234,116,118
2017,3,A,골목상권,1000074,청파로47나길,173,96,77
2017,3,A,골목상권,1000073,청파로47길,937,430,507
2017,3,A,골목상권,1000072,장문로45길,44,9,35
2017,3,A,골목상권,1000071,이태원로54길,2194,1083,1111
2017,3,A,골목상권,1000070,이태원로27길,603,348,255
2017,3,A,골목상권,1000069,이촌로22길,219,132,87
2017,3,A,골목상권,1000068,원효로89길,907,735,172
2017,3,A,골목상권,1000067,원효로53길,732,444,288
2017,3,A,골목상권,1000066,원효로41길,1524,1059,465
2017,3,A,골목상권,1000065,원효로19길,995,689,306
2017,3,A,골목상권,1000064,우사단로4길,180,128,52
2017,3,A,골목상권,1000063,우사단로14길,1768,874,894
2017,3,A,골목상권,1000062,우사단로10길,80,35,45
2017,3,A,골목상권,1000061,신흥로20길,142,78,64
2017,3,A,골목상권,1000060,소월로20길,127,38,89
2017,3,A,골목상권,1000059,서빙고로71길,468,293,175
2017,3,A,골목상권,1000058,백범로90길,284,175,109
2017,3,A,골목상권,1000057,백범로79길,1045,643,402
2017,3,A,골목상권,1000056,두텁바위로1길,2325,1307,1018
2017,3,A,골목상권,1000055,대사관로34길,278,144,134
2017,3,A,골목상권,1000054,녹사평대로46길,65,41,24
2017,3,A,골목상권,1000053,녹사평대로40나길,54,29,25
2017,3,A,골목상권,1000052,녹사평대로32길,285,153,132
2017,3,A,골목상권,1000051,녹사평대로26길,2050,1124,926
2017,3,A,골목상권,1000050,녹사평대로11길,300,203,97
2017,3,A,골목상권,1000049,퇴계로90길,588,220,368
2017,3,A,골목상권,1000048,퇴계로8길,2402,1277,1125
2017,3,A,골목상권,1000047,퇴계로56길,1049,830,219
2017,3,A,골목상권,1000046,퇴계로46길,1988,834,1154
2017,3,A,골목상권,1000045,퇴계로18길,2984,1327,1657
2017,3,A,골목상권,1000044,퇴계로12길,950,439,511
2017,3,A,골목상권,1000043,청구로1길,228,92,136
2017,3,A,골목상권,1000042,청구로17길,1671,761,910
2017,3,A,골목상권,1000041,장충단로8길,3477,1225,2252
2017,3,A,골목상권,1000040,삼일대로4길,1013,602,411
2017,3,A,골목상권,1000039,명동길,36746,18217,18529
2017,3,A,골목상권,1000037,동호로20길,805,305,500
2017,3,A,골목상권,1000036,동호로15길,4224,2196,2028
2017,3,A,골목상권,1000035,동호로11길,15,9,6
2017,3,A,골목상권,1000034,동호로10길,1536,670,866
2017,3,A,골목상권,1000033,다산로39길,1230,680,550
2017,3,A,골목상권,1000032,다산로38길,1583,763,820
2017,3,A,골목상권,1000031,다산로36길,76,45,31
2017,3,A,골목상권,1000030,다산로33길,446,207,239
2017,3,A,골목상권,1000029,난계로21길,240,166,74
2017,3,A,골목상권,1000028,난계로11길,1679,1034,645
2017,3,A,골목상권,1000027,필운대로1길,5,1,4
2017,3,A,골목상권,1000026,평창길,183,93,90
2017,3,A,골목상권,1000025,통일로12길,244,100,144
2017,3,A,골목상권,1000024,창신길,264,70,194
2017,3,A,골목상권,1000023,창신5길,8,3,5
2017,3,A,골목상권,1000022,창신2길,63,31,32
2017,3,A,골목상권,1000021,창경궁로35길,1338,358,980
2017,3,A,골목상권,1000020,지봉로8길,175,94,81
2017,3,A,골목상권,1000019,종로65길,577,260,317
2017,3,A,골목상권,1000016,자하문로7길,531,326,205
2017,3,A,골목상권,1000015,이화장길,1887,915,972
2017,3,A,골목상권,1000014,율곡로16길,99,87,12
2017,3,A,골목상권,1000013,율곡로10길,2269,1674,595
2017,3,A,골목상권,1000012,옥인길,460,195,265
2017,3,A,골목상권,1000011,숭인동길,17,7,10
2017,3,A,골목상권,1000010,성균관로5길,138,83,55
2017,3,A,골목상권,1000009,삼청로5길,407,132,275
2017,3,A,골목상권,1000008,북촌로5나길,1639,1129,510
2017,3,A,골목상권,1000007,북촌로5길,61,31,30
2017,3,A,골목상권,1000006,북촌로11길,19,10,9
2017,3,A,골목상권,1000005,백석동길,122,68,54
2017,3,A,골목상권,1000004,명륜길,16,9,7
2017,3,A,골목상권,1000003,돈화문로11가길,1100,606,494
2017,3,A,골목상권,1000001,계동길,840,360,480
2017,2,U,관광특구,1001496,강남 마이스 관광특구,22266,12751,9515
2017,2,U,관광특구,1001495,잠실 관광특구,28736,16766,11970
2017,2,U,관광특구,1001494,종로?청계 관광특구,30736,18590,12146
2017,2,U,관광특구,1001493,동대문패션타운 관광특구,10063,5731,4332
2017,2,U,관광특구,1001492,명동 남대문 북창동 다동 무교동 관광특구,168048,85325,82723
2017,2,U,관광특구,1001491,이태원 관광특구,5614,3181,2433
2017,2,R,전통시장,1001490,길동복조리시장,475,297,178
2017,2,R,전통시장,1001489,둔촌역전통시장,163,82,81
2017,2,R,전통시장,1001488,성내골목시장,7,2,5
2017,2,R,전통시장,1001487,천호시장,24,12,12
2017,2,R,전통시장,1001483,암사종합시장,731,338,393
2017,2,R,전통시장,1001482,고덕전통시장,388,374,14
2017,2,R,전통시장,1001481,명일골목시장,441,162,279
2017,2,R,전통시장,1001480,새마을시장,382,213,169
2017,2,R,전통시장,1001479,석촌시장,195,126,69
2017,2,R,전통시장,1001478,방이시장,647,406,241
2017,2,R,전통시장,1001477,마천시장,258,70,188
2017,2,R,전통시장,1001476,풍납시장,17,5,12
2017,2,R,전통시장,1001475,강남개포시장,38,31,7
2017,2,R,전통시장,1001474,도곡시장,497,215,282
2017,2,R,전통시장,1001471,영동전통시장,3031,2212,819
2017,2,R,전통시장,1001466,미성동도깨비시장,411,176,235
2017,2,R,전통시장,1001465,신신림시장,2,2,0
2017,2,R,전통시장,1001464,삼성동시장,99,44,55
2017,2,R,전통시장,1001463,신림중앙시장,14,9,5
2017,2,R,전통시장,1001462,강남골목시장,282,129,153
2017,2,R,전통시장,1001460,관악신사시장,291,217,74
2017,2,R,전통시장,1001459,신원시장,354,144,210
2017,2,R,전통시장,1001458,인헌시장,205,90,115
2017,2,R,전통시장,1001456,봉천현대시장,7,4,3
2017,2,R,전통시장,1001454,봉천제일종합시장,47,24,23
2017,2,R,전통시장,1001453,낙성대시장,22,13,9
2017,2,R,전통시장,1001452,중부시장,193,60,133
2017,2,R,전통시장,1001450,남성역골목시장,541,249,292
2017,2,R,전통시장,1001449,남성사계시장,1933,865,1068
2017,2,R,전통시장,1001448,흑석시장,181,72,109
2017,2,R,전통시장,1001447,상도4동도깨비골목시장,322,78,244
2017,2,R,전통시장,1001445,영도시장,70,30,40
2017,2,R,전통시장,1001441,본동인정시장,110,55,55
2017,2,R,전통시장,1001439,대림중앙시장,22,10,12
2017,2,R,전통시장,1001438,우리시장,15,7,8
2017,2,R,전통시장,1001437,영진시장A동,55,44,11
2017,2,R,전통시장,1001436,사러가시장,27,7,20
2017,2,R,전통시장,1001431,영등포청과시장,190,128,62
2017,2,R,전통시장,1001430,영등포전통시장,3950,2016,1934
2017,2,R,전통시장,1001429,은행나무시장,42,9,33
2017,2,R,전통시장,1001427,현대시장,52,16,36
2017,2,R,전통시장,1001424,남문시장,258,103,155
2017,2,R,전통시장,1001423,독산동 우시장,153,57,96
2017,2,R,전통시장,1001421,개봉중앙시장,5,2,3
2017,2,R,전통시장,1001419,가리봉시장,25,18,7
2017,2,R,전통시장,1001418,남구로시장,12,2,10
2017,2,R,전통시장,1001417,구로시장,61,23,38
2017,2,R,전통시장,1001415,방신전통시장,134,115,19
2017,2,R,전통시장,1001414,송화골목시장,533,197,336
2017,2,R,전통시장,1001413,까치산시장,42,27,15
2017,2,R,전통시장,1001411,남부골목시장,204,88,116
2017,2,R,전통시장,1001409,화곡중앙골목시장,2,2,0
2017,2,R,전통시장,1001407,등마루시장,884,506,378
2017,2,R,전통시장,1001406,신정3동골목시장,202,99,103
2017,2,R,전통시장,1001405,신정2동골목시장,6,5,1
2017,2,R,전통시장,1001402,신월6동골목시장,234,112,122
2017,2,R,전통시장,1001401,신곡종합시장,9,7,2
2017,2,R,전통시장,1001400,신월3동골목시장,53,14,39
2017,2,R,전통시장,1001399,경창시장,207,94,113
2017,2,R,전통시장,1001398,월정로시장,118,65,53
2017,2,R,전통시장,1001397,신영시장,45,22,23
2017,2,R,전통시장,1001396,목4동시장,239,86,153
2017,2,R,전통시장,1001395,목3동시장,718,350,368
2017,2,R,전통시장,1001394,목2동시장,238,109,129
2017,2,R,전통시장,1001393,마포농수산물시장,490,314,176
2017,2,R,전통시장,1001391,망원월드컵시장,13,8,5
2017,2,R,전통시장,1001390,망원시장,38,19,19
2017,2,R,전통시장,1001386,신수시장,119,83,36
2017,2,R,전통시장,1001385,아현시장,25,4,21
2017,2,R,전통시장,1001374,대림골목시장,363,130,233
2017,2,R,전통시장,1001367,상계중앙시장,31,17,14
2017,2,R,전통시장,1001364,방학동도깨비시장,153,62,91
2017,2,R,전통시장,1001363,쌍문역골목시장,75,36,39
2017,2,R,전통시장,1001361,신도봉시장,28,17,11
2017,2,R,전통시장,1001359,창동신창시장,150,68,82
2017,2,R,전통시장,1001358,수유북부시장,11,5,6
2017,2,R,전통시장,1001357,장미원골목시장,68,44,24
2017,2,R,전통시장,1001356,수유중앙시장,124,68,56
2017,2,R,전통시장,1001355,강북종합시장,69,29,40
2017,2,R,전통시장,1001354,우이시장,158,62,96
2017,2,R,전통시장,1001353,수유전통시장,438,131,307
2017,2,R,전통시장,1001352,번동북부골목시장,82,46,36
2017,2,R,전통시장,1001351,솔샘시장,112,47,65
2017,2,R,전통시장,1001349,방천골목시장,71,27,44
2017,2,R,전통시장,1001347,석관황금시장,71,28,43
2017,2,R,전통시장,1001343,장위전통시장,182,73,109
2017,2,R,전통시장,1001340,정릉시장,33,12,21
2017,2,R,전통시장,1001339,정릉아리랑시장,2,1,1
2017,2,R,전통시장,1001338,돈암제일시장,59,21,38
2017,2,R,전통시장,1001336,우림골목시장,214,106,108
2017,2,R,전통시장,1001335,묵1동도깨비시장,264,115,149
2017,2,R,전통시장,1001334,태능시장,4,3,1
2017,2,R,전통시장,1001333,중화제일시장,24,1,23
2017,2,R,전통시장,1001332,사가정시장,248,185,63
2017,2,R,전통시장,1001330,동원시장,80,32,48
2017,2,R,전통시장,1001329,동부골목시장,92,34,58
2017,2,R,전통시장,1001326,회기시장,122,50,72
2017,2,R,전통시장,1001323,답십리시장,28,9,19
2017,2,R,전통시장,1001321,답십리현대시장,91,69,22
2017,2,R,전통시장,1001319,청량리종합시장,15,12,3
2017,2,R,전통시장,1001317,청량리농수산물시장,20,16,4
2017,2,R,전통시장,1001316,서울약령시장,1362,816,546
2017,2,R,전통시장,1001313,청량리수산시장,224,110,114
2017,2,R,전통시장,1001310,구의시장,99,57,42
2017,2,R,전통시장,1001309,조양시장,90,44,46
2017,2,R,전통시장,1001308,영동교골목시장,16,11,5
2017,2,R,전통시장,1001307,능동로골목시장,189,156,33
2017,2,R,전통시장,1001304,자양골목시장,95,50,45
2017,2,R,전통시장,1001301,중곡제일시장,118,70,48
2017,2,R,전통시장,1001299,한아름시장,137,80,57
2017,2,R,전통시장,1001298,성동용답상가시장,286,137,149
2017,2,R,전통시장,1001297,뚝도시장,36,13,23
2017,2,R,전통시장,1001296,금남시장,20,12,8
2017,2,R,전통시장,1001295,행당시장,226,118,108
2017,2,R,전통시장,1001294,마장축산물시장,1519,1028,491
2017,2,R,전통시장,1001289,용문전통시장,38,22,16
2017,2,R,전통시장,1001286,후암시장,51,20,31
2017,2,R,전통시장,1001285,합동(새벽)시장,2312,1324,988
2017,2,R,전통시장,1001284,서울중앙시장,252,172,80
2017,2,R,전통시장,1001283,백학시장,466,241,225
2017,2,R,전통시장,1001282,약수시장,1750,712,1038
2017,2,R,전통시장,1001281,청평화시장,3103,1906,1197
2017,2,R,전통시장,1001280,제일평화시장,538,320,218
2017,2,R,전통시장,1001278,남평화시장,185,111,74
2017,2,R,전통시장,1001277,방산종합시장,1856,1184,672
2017,2,R,전통시장,1001275,인현시장,1128,719,409
2017,2,R,전통시장,1001274,신중부시장,2430,1616,814
2017,2,R,전통시장,1001273,남대문시장,7180,3721,3459
2017,2,R,전통시장,1001271,동묘시장,937,588,349
2017,2,R,전통시장,1001270,창신골목시장,239,125,114
2017,2,R,전통시장,1001268,충신시장,329,203,126
2017,2,R,전통시장,1001267,종로신진시장,35,14,21
2017,2,R,전통시장,1001266,동대문종합시장,329,178,151
2017,2,R,전통시장,1001265,광장시장,193,143,50
2017,2,D,발달상권,1001263,서울 노원구 노원역_3,797,334,463
2017,2,D,발달상권,1001261,서울 노원구 노원역_1,988,302,686
2017,2,D,발달상권,1001260,창동역,2408,1553,855
2017,2,D,발달상권,1001259,서울 강북구 수유역_3,66,30,36
2017,2,D,발달상권,1001257,서울 강북구 수유역_2,4125,2117,2008
2017,2,D,발달상권,1001256,서울 강북구 수유역_1,117,96,21
2017,2,D,발달상권,1001255,서울 은평구 연신내역_3,638,191,447
2017,2,D,발달상권,1001254,서울 은평구 연신내역_2,413,176,237
2017,2,D,발달상권,1001253,서울 은평구 연신내역_1,87,35,52
2017,2,D,발달상권,1001252,서울 성북구 미아삼거리역_2,514,212,302
2017,2,D,발달상권,1001251,서울 강북구 미아삼거리역_1,520,189,331
2017,2,D,발달상권,1001250,서울 은평구 불광역_3,54,19,35
2017,2,D,발달상권,1001249,서울 은평구 불광역_2,73,29,44
2017,2,D,발달상권,1001248,서울 은평구 불광역_1,252,108,144
2017,2,D,발달상권,1001247,미아사거리_2,125,35,90
2017,2,D,발달상권,1001246,미아사거리_1,522,221,301
2017,2,D,발달상권,1001245,서울 성북구 성신여대입구역,5121,3134,1987
2017,2,D,발달상권,1001244,경희대학교,370,173,197
2017,2,D,발달상권,1001243,서울 성북구 안암역,97,57,40
2017,2,D,발달상권,1001242,혜화역 대학로_3,1658,790,868
2017,2,D,발달상권,1001241,혜화역 대학로_2,1491,830,661
2017,2,D,발달상권,1001240,혜화역 대학로_1,1191,611,580
2017,2,D,발달상권,1001239,디지털미디어시티,21758,12923,8835
2017,2,D,발달상권,1001238,서울 동대문구 청량리역,3046,1987,1059
2017,2,D,발달상권,1001236,서울 종로구 안국역_2,680,261,419
2017,2,D,발달상권,1001235,서울 종로구 안국역_1,12874,10672,2202
2017,2,D,발달상권,1001234,서울 종로구 경복궁역_1,219,90,129
2017,2,D,발달상권,1001233,서울 종로구 종로3가역_3,3298,1768,1530
2017,2,D,발달상권,1001232,서울 종로구 종로3가역_2,1907,1044,863
2017,2,D,발달상권,1001231,서울 동대문구 신설동역_2,4491,2160,2331
2017,2,D,발달상권,1001230,인사동,21235,13039,8196
2017,2,D,발달상권,1001229,서울 종로구 종로5가역_4,669,360,309
2017,2,D,발달상권,1001228,서울 종로구 종로5가역_3,5114,3472,1642
2017,2,D,발달상권,1001227,종로구청,18711,10381,8330
2017,2,D,발달상권,1001226,서울 종로구 종로5가역_2,18368,12155,6213
2017,2,D,발달상권,1001225,신설동역,772,435,337
2017,2,D,발달상권,1001224,서울 동대문구 신설동역_1,2,2,0
2017,2,D,발달상권,1001223,서울 종로구 광화문역_2,54025,32531,21494
2017,2,D,발달상권,1001222,동묘앞역,60,37,23
2017,2,D,발달상권,1001221,장안동사거리,526,269,257
2017,2,D,발달상권,1001220,서울 종로구 동대문역_2,1057,542,515
2017,2,D,발달상권,1001218,동대문시장_2,498,305,193
2017,2,D,발달상권,1001217,서울 종로구 종로5가역_1,49,36,13
2017,2,D,발달상권,1001216,서울 종로구 종로3가역_1,3495,1546,1949
2017,2,D,발달상권,1001215,서울 종로구 광화문역_1,2317,1511,806
2017,2,D,발달상권,1001214,종각역,20798,13447,7351
2017,2,D,발달상권,1001213,종각역 젊음의 거리,2297,997,1300
2017,2,D,발달상권,1001212,서대문구 서대문역_1,351,238,113
2017,2,D,발달상권,1001211,동대문시장_1,442,238,204
2017,2,D,발달상권,1001210,시청역_2,21995,13957,8038
2017,2,D,발달상권,1001209,서울시청,23931,11748,12183
2017,2,D,발달상권,1001208,서울 중구 을지로3가역_2,7819,5032,2787
2017,2,D,발달상권,1001207,서울 중구 신당역_2,1434,706,728
2017,2,D,발달상권,1001206,서대문구 서대문역_2,2045,1421,624
2017,2,D,발달상권,1001205,동대문역사문화공원역,4190,2992,1198
2017,2,D,발달상권,1001204,서울 중구 을지로3가역_1,14464,9605,4859
2017,2,D,발달상권,1001203,명동거리,23768,11122,12646
2017,2,D,발달상권,1001202,롯데백화점,39858,22204,17654
2017,2,D,발달상권,1001201,서울 중구 신당역_1,1076,694,382
2017,2,D,발달상권,1001200,북창동,7974,4771,3203
2017,2,D,발달상권,1001199,서울 중구 충무로역_2,14112,6234,7878
2017,2,D,발달상권,1001198,서울 강서구 송정역,615,408,207
2017,2,D,발달상권,1001197,장한평역_2,12289,9719,2570
2017,2,D,발달상권,1001196,시청역_1,55770,33686,22084
2017,2,D,발달상권,1001195,왕십리역_2,659,280,379
2017,2,D,발달상권,1001194,서울 강서구 발산역,822,488,334
2017,2,D,발달상권,1001193,장한평역_1,2304,1536,768
2017,2,D,발달상권,1001192,서울 중구 충무로역_1,3147,2188,959
2017,2,D,발달상권,1001190,장한평역,2210,1539,671
2017,2,D,발달상권,1001189,서울 중구 명동역,3784,1916,1868
2017,2,D,발달상권,1001188,장충동 족발거리,208,99,109
2017,2,D,발달상권,1001187,한양시장,285,142,143
2017,2,D,발달상권,1001186,서울 서대문구 이대역,1297,536,761
2017,2,D,발달상권,1001185,서울 서대문구 신촌역,3235,1340,1895
2017,2,D,발달상권,1001184,서울 마포구 홍대입구역_3,414,246,168
2017,2,D,발달상권,1001183,서울 마포구 홍대입구역_2,3258,1241,2017
2017,2,D,발달상권,1001182,홍익대학교 주변,16188,7954,8234
2017,2,D,발달상권,1001181,서울 광진구 군자역,176,103,73
2017,2,D,발달상권,1001180,신촌역,264,135,129
2017,2,D,발달상권,1001179,강서구청,3354,2224,1130
2017,2,D,발달상권,1001178,서울 마포구 홍대입구역_1,832,466,366
2017,2,D,발달상권,1001175,서울 강동구 고덕역,495,276,219
2017,2,D,발달상권,1001173,서울 강동구 명일역,852,353,499
2017,2,D,발달상권,1001172,어린이대공원역,88,52,36
2017,2,D,발달상권,1001171,서울 마포구 공덕역_2,4361,2534,1827
2017,2,D,발달상권,1001170,공덕역,7505,4485,3020
2017,2,D,발달상권,1001169,서울 용산구 숙대입구역,2960,2152,808
2017,2,D,발달상권,1001168,남영역,14028,6236,7792
2017,2,D,발달상권,1001167,서울 마포구 공덕역_1,4781,2344,2437
2017,2,D,발달상권,1001166,서울 마포구 마포역_2,990,548,442
2017,2,D,발달상권,1001165,서울 광진구 건대입구역_2,2881,980,1901
2017,2,D,발달상권,1001164,서울 마포구 마포역_1,11520,6886,4634
2017,2,D,발달상권,1001163,서울 강동구 천호역_2,3895,1927,1968
2017,2,D,발달상권,1001162,서울 광진구 건대입구역_1,902,425,477
2017,2,D,발달상권,1001161,건대입구역,730,388,342
2017,2,D,발달상권,1001160,서울 광진구 구의역,860,536,324
2017,2,D,발달상권,1001159,서울 강동구 천호역,1037,514,523
2017,2,D,발달상권,1001158,당산역_2,5064,3127,1937
2017,2,D,발달상권,1001156,서울 강동구 길동역,1192,657,535
2017,2,D,발달상권,1001155,용산 전자상가_5,2478,1833,645
2017,2,D,발달상권,1001153,당산역_1,1082,674,408
2017,2,D,발달상권,1001152,서울 광진구 강변역,1914,1545,369
2017,2,D,발달상권,1001151,용산 전자상가_3,2472,1797,675
2017,2,D,발달상권,1001150,서울 용산구 이태원역,674,408,266
2017,2,D,발달상권,1001149,한남오거리,632,334,298
2017,2,D,발달상권,1001147,용산 전자상가_2,444,357,87
2017,2,D,발달상권,1001146,용산구청,87,50,37
2017,2,D,발달상권,1001145,용산 전자상가_1,7830,5985,1845
2017,2,D,발달상권,1001144,국회의사당역_2,36337,21385,14952
2017,2,D,발달상권,1001143,서울 용산구 신용산역,508,240,268
2017,2,D,발달상권,1001142,국회의사당역_1,5614,4332,1282
2017,2,D,발달상권,1001141,압구정 로데오거리_2,16399,6816,9583
2017,2,D,발달상권,1001140,서울 강남구 압구정역,11035,5069,5966
2017,2,D,발달상권,1001139,서울 영등포구 영등포구청역,3719,1144,2575
2017,2,D,발달상권,1001138,압구정 로데오거리_1,7807,2538,5269
2017,2,D,발달상권,1001137,서울 강동구 둔촌동역,44,11,33
2017,2,D,발달상권,1001136,오목교역,220,92,128
2017,2,D,발달상권,1001135,신사동 가로수길,21727,10161,11566
2017,2,D,발달상권,1001134,서울 영등포구 여의도역_2,48522,32210,16312
2017,2,D,발달상권,1001133,청담사거리_3,1860,570,1290
2017,2,D,발달상권,1001132,영등포유통상가,2167,1343,824
2017,2,D,발달상권,1001131,청담역_2,1323,924,399
2017,2,D,발달상권,1001130,청담역_1,178,141,37
2017,2,D,발달상권,1001129,청담사거리_2,920,699,221
2017,2,D,발달상권,1001127,서울 영등포구 여의도역_1,51858,30910,20948
2017,2,D,발달상권,1001125,학동사거리_2,3056,1778,1278
2017,2,D,발달상권,1001124,서울 영등포구 영등포시장역,318,247,71
2017,2,D,발달상권,1001123,학동사거리_1,4134,2110,2024
2017,2,D,발달상권,1001122,여의도 시범아파트앞,2280,1530,750
2017,2,D,발달상권,1001121,영등포역_3,867,513,354
2017,2,D,발달상권,1001120,도산공원사거리_1,9962,5945,4017
2017,2,D,발달상권,1001119,영등포역_2,1244,676,568
2017,2,D,발달상권,1001118,문래동 주민센터,68,58,10
2017,2,D,발달상권,1001117,강남구 신사역_2,7963,5151,2812
2017,2,D,발달상권,1001115,서울 강남구 강남구청역_2,4496,2877,1619
2017,2,D,발달상권,1001114,강남구 신사역_1,2257,950,1307
2017,2,D,발달상권,1001113,서울 동작구 노량진1동_1,24,13,11
2017,2,D,발달상권,1001112,서울 강남구 학동역_3,8987,5262,3725
2017,2,D,발달상권,1001111,서울 강남구 강남구청역_1,3294,1905,1389
2017,2,D,발달상권,1001110,잠실역,5959,4476,1483
2017,2,D,발달상권,1001109,강남구 논현역_4,7301,3819,3482
2017,2,D,발달상권,1001108,학동역,1546,604,942
2017,2,D,발달상권,1001107,방이동 먹자골목,5213,3298,1915
2017,2,D,발달상권,1001106,서울 강남구 학동역_2,6034,3287,2747
2017,2,D,발달상권,1001105,서울 동작구 노량진역,3774,2164,1610
2017,2,D,발달상권,1001104,삼성역_3,8959,5180,3779
2017,2,D,발달상권,1001103,코엑스,22266,12751,9515
2017,2,D,발달상권,1001102,서울 강남구 학동역_1,5183,3320,1863
2017,2,D,발달상권,1001101,선정릉역_2,6702,4136,2566
2017,2,D,발달상권,1001100,강남구 논현역_3,1588,905,683
2017,2,D,발달상권,1001099,포스코사거리_2,7394,4769,2625
2017,2,D,발달상권,1001098,포스코사거리_1,48819,32850,15969
2017,2,D,발달상권,1001097,잠실역 롯데월드,4035,1991,2044
2017,2,D,발달상권,1001096,신도림역,3350,1784,1566
2017,2,D,발달상권,1001095,강남구 논현역_2,8354,4002,4352
2017,2,D,발달상권,1001094,선정릉역_1,1802,1285,517
2017,2,D,발달상권,1001093,신천역,6368,3421,2947
2017,2,D,발달상권,1001092,강남구 논현역_1,3706,2139,1567
2017,2,D,발달상권,1001091,삼성역_2,18475,11019,7456
2017,2,D,발달상권,1001090,삼정역_2,2594,1323,1271
2017,2,D,발달상권,1001089,삼정역_1,3102,1642,1460
2017,2,D,발달상권,1001088,삼성역_1,32772,21159,11613
2017,2,D,발달상권,1001087,서울 강남구 선릉역_2,7211,4645,2566
2017,2,D,발달상권,1001086,고속터미널역,15974,4718,11256
2017,2,D,발달상권,1001085,서울 서초구 강남역,33286,19156,14130
2017,2,D,발달상권,1001084,서울 강남구 선릉역_1,20161,8283,11878
2017,2,D,발달상권,1001082,선릉역_2,20939,10618,10321
2017,2,D,발달상권,1001081,서울 강남구 역삼역_2,26873,21117,5756
2017,2,D,발달상권,1001080,서울 송파구 석촌역_1,39,26,13
2017,2,D,발달상권,1001078,서울 강남구 강남역_2,5736,3376,2360
2017,2,D,발달상권,1001077,선릉역_1,54646,29517,25129
2017,2,D,발달상권,1001076,구로역,161,94,67
2017,2,D,발달상권,1001075,역삼역_2,4713,2639,2074
2017,2,D,발달상권,1001074,대림역_2,7435,5577,1858
2017,2,D,발달상권,1001073,서울 강남구 역삼역_1,25643,15789,9854
2017,2,D,발달상권,1001072,신대방삼거리역,256,131,125
2017,2,D,발달상권,1001071,서울 강남구 한티역,1071,418,653
2017,2,D,발달상권,1001070,은마아파트입구사거리_4,100,54,46
2017,2,D,발달상권,1001067,오류동역,1566,765,801
2017,2,D,발달상권,1001066,서울 강남구 강남역,39725,18922,20803
2017,2,D,발달상권,1001063,교대역_4,5213,2844,2369
2017,2,D,발달상권,1001062,서울 강남구 강남역_1,131121,96380,34741
2017,2,D,발달상권,1001061,방배동카페골목,110,48,62
2017,2,D,발달상권,1001060,가락시장,16680,10479,6201
2017,2,D,발달상권,1001059,교대역_3,4302,2619,1683
2017,2,D,발달상권,1001058,역삼역_1,1678,1030,648
2017,2,D,발달상권,1001057,교대역_2,3511,2245,1266
2017,2,D,발달상권,1001056,서울 송파구 가락시장역,5025,3225,1800
2017,2,D,발달상권,1001055,서울 서초구 서초역,12861,5297,7564
2017,2,D,발달상권,1001054,서울 강남구 대치역_2,1474,890,584
2017,2,D,발달상권,1001052,뱅뱅사거리_2,25423,16323,9100
2017,2,D,발달상권,1001051,보라매공원,14368,8190,6178
2017,2,D,발달상권,1001050,교대역_1,12799,7644,5155
2017,2,D,발달상권,1001049,개봉동 현대아파트 인근,148,64,84
2017,2,D,발달상권,1001048,뱅뱅사거리,7337,4872,2465
2017,2,D,발달상권,1001047,뱅뱅사거리_1,10917,7743,3174
2017,2,D,발달상권,1001046,서울 관악구 신림역_4,941,437,504
2017,2,D,발달상권,1001045,동작구 총신대입구역_1,238,108,130
2017,2,D,발달상권,1001044,양재역_3,3523,2357,1166
2017,2,D,발달상권,1001043,동작구 총신대입구역_2,825,348,477
2017,2,D,발달상권,1001042,서울 서초구 남부터미널역_3,1514,845,669
2017,2,D,발달상권,1001041,서울 강남구 수서역,19761,11577,8184
2017,2,D,발달상권,1001039,서울 서초구 남부터미널역_2,10990,5420,5570
2017,2,D,발달상권,1001038,구로디지탈1단지,66086,41917,24169
2017,2,D,발달상권,1001037,양재역,116,52,64
2017,2,D,발달상권,1001035,매봉역,568,214,354
2017,2,D,발달상권,1001034,서울 서초구 방배역,3441,2008,1433
2017,2,D,발달상권,1001033,서울 서초구 남부터미널역_1,529,380,149
2017,2,D,발달상권,1001032,서울 관악구 신림역_2,35,16,19
2017,2,D,발달상권,1001031,서울 관악구 신림역_1,1955,929,1026
2017,2,D,발달상권,1001030,양재역_2,9074,5070,4004
2017,2,D,발달상권,1001029,양재역_1,894,626,268
2017,2,D,발달상권,1001028,서울 관악구 서울대입구역_2,44,4,40
2017,2,D,발달상권,1001027,가산디지털단지역_3,30766,18326,12440
2017,2,D,발달상권,1001026,구로디지털단지역,2181,1409,772
2017,2,D,발달상권,1001025,서울 관악구 서울대입구역_1,1997,855,1142
2017,2,D,발달상권,1001024,관악구 사당역_1,3768,1429,2339
2017,2,D,발달상권,1001023,가산디지털단지역_2,62801,37619,25182
2017,2,D,발달상권,1001022,관악구 사당역_2,424,201,223
2017,2,D,발달상권,1001021,가산디지털단지역_1,27122,18365,8757
2017,2,D,발달상권,1001020,장지역,4370,2728,1642
2017,2,D,발달상권,1001019,포이사거리_1,5637,3027,2610
2017,2,D,발달상권,1001018,포이사거리_2,8948,6241,2707
2017,2,D,발달상권,1001016,서울 관악구 대학동_1,90,52,38
2017,2,D,발달상권,1001015,서울 금천구 독산1동_1,2873,1889,984
2017,2,D,발달상권,1001013,양재 화물트럭터미널앞_2,159,70,89
2017,2,D,발달상권,1001012,양재 화물트럭터미널앞_1,4552,3662,890
2017,2,D,발달상권,1001011,서울 금천구 시흥1동_4,933,446,487
2017,2,A,골목상권,1001010,풍성로37가길,42,20,22
2017,2,A,골목상권,1001009,천호옛길,526,343,183
2017,2,A,골목상권,1001008,천호옛14길,594,290,304
2017,2,A,골목상권,1001007,천호대로219길,918,559,359
2017,2,A,골목상권,1001006,천호대로197길,23,8,15
2017,2,A,골목상권,1001005,천호대로187길,915,531,384
2017,2,A,골목상권,1001004,천호대로170길,394,159,235
2017,2,A,골목상권,1001003,천호대로162길,1166,807,359
2017,2,A,골목상권,1001002,천중로51길,424,226,198
2017,2,A,골목상권,1001001,천중로39길,612,226,386
2017,2,A,골목상권,1001000,진황도로47길,1370,685,685
2017,2,A,골목상권,1000999,진황도로27길,598,337,261
2017,2,A,골목상권,1000998,올림픽로98길,33,14,19
2017,2,A,골목상권,1000995,올림픽로77길,16,8,8
2017,2,A,골목상권,1000994,올림픽로71길,353,264,89
2017,2,A,골목상권,1000993,올림픽로48길,6006,3602,2404
2017,2,A,골목상권,1000992,양재대로96길,1393,843,550
2017,2,A,골목상권,1000991,양재대로95길,688,359,329
2017,2,A,골목상권,1000990,양재대로91길,1211,655,556
2017,2,A,골목상권,1000989,양재대로133길,311,112,199
2017,2,A,골목상권,1000988,양재대로124길,616,381,235
2017,2,A,골목상권,1000987,양재대로116길,215,84,131
2017,2,A,골목상권,1000986,양재대로101길,1173,666,507
2017,2,A,골목상권,1000985,암사길,374,174,200
2017,2,A,골목상권,1000984,성안로3길,1501,929,572
2017,2,A,골목상권,1000983,성내로5길,1112,560,552
2017,2,A,골목상권,1000982,상일로5길,42,24,18
2017,2,A,골목상권,1000981,상암로5길,599,265,334
2017,2,A,골목상권,1000980,상암로51길,751,326,425
2017,2,A,골목상권,1000979,상암로4길,350,263,87
2017,2,A,골목상권,1000978,상암로14길,482,316,166
2017,2,A,골목상권,1000977,명일로13길,111,47,64
2017,2,A,골목상권,1000976,동남로85길,125,63,62
2017,2,A,골목상권,1000975,동남로82길,9,3,6
2017,2,A,골목상권,1000974,동남로65길,80,22,58
2017,2,A,골목상권,1000973,구천면로42길,383,181,202
2017,2,A,골목상권,1000972,구천면로41길,596,246,350
2017,2,A,골목상권,1000971,구천면로36길,48,26,22
2017,2,A,골목상권,1000969,고덕로25길,22,13,9
2017,2,A,골목상권,1000968,고덕로10길,163,70,93
2017,2,A,골목상권,1000967,강동대로53길,926,513,413
2017,2,A,골목상권,1000966,풍성로25길,751,269,482
2017,2,A,골목상권,1000965,오금로46길,1453,740,713
2017,2,A,골목상권,1000964,오금로36길,1209,902,307
2017,2,A,골목상권,1000963,오금로11길,2156,1424,732
2017,2,A,골목상권,1000962,양재대로72길,655,344,311
2017,2,A,골목상권,1000961,양재대로71길,1348,828,520
2017,2,A,골목상권,1000960,양재대로64길,1497,618,879
2017,2,A,골목상권,1000959,양재대로62길,6189,3659,2530
2017,2,A,골목상권,1000958,송파대로30길,1706,1061,645
2017,2,A,골목상권,1000957,송이로36길,2107,1508,599
2017,2,A,골목상권,1000956,송이로32길,774,418,356
2017,2,A,골목상권,1000955,송이로23길,1343,833,510
2017,2,A,골목상권,1000954,삼전로13길,1606,770,836
2017,2,A,골목상권,1000953,백제고분로50길,3615,1731,1884
2017,2,A,골목상권,1000952,백제고분로46길,1624,986,638
2017,2,A,골목상권,1000951,백제고분로45길,436,283,153
2017,2,A,골목상권,1000950,백제고분로42길,134,82,52
2017,2,A,골목상권,1000949,백제고분로39길,1711,1173,538
2017,2,A,골목상권,1000948,백제고분로34길,1548,1014,534
2017,2,A,골목상권,1000947,백제고분로33길,989,610,379
2017,2,A,골목상권,1000946,백제고분로32길,1112,494,618
2017,2,A,골목상권,1000945,백제고분로31길,339,197,142
2017,2,A,골목상권,1000944,백제고분로22길,1215,705,510
2017,2,A,골목상권,1000943,백제고분로21길,205,147,58
2017,2,A,골목상권,1000942,마천로51길,145,61,84
2017,2,A,골목상권,1000941,동남로20길,144,82,62
2017,2,A,골목상권,1000940,거마로20길,533,219,314
2017,2,A,골목상권,1000939,학동로77길,2962,1529,1433
2017,2,A,골목상권,1000938,학동로6길,1847,888,959
2017,2,A,골목상권,1000937,학동로56길,878,454,424
2017,2,A,골목상권,1000936,학동로38길,7213,4115,3098
2017,2,A,골목상권,1000935,테헤란로81길,574,218,356
2017,2,A,골목상권,1000934,일원로9길,539,298,241
2017,2,A,골목상권,1000933,일원로3길,223,103,120
2017,2,A,골목상권,1000932,영동대로65길,3272,1938,1334
2017,2,A,골목상권,1000931,영동대로112길,637,401,236
2017,2,A,골목상권,1000930,언주로81길,9628,5444,4184
2017,2,A,골목상권,1000929,압구정로2길,2692,1459,1233
2017,2,A,골목상권,1000928,선릉로18길,421,235,186
2017,2,A,골목상권,1000927,선릉로146길,1878,983,895
2017,2,A,골목상권,1000926,선릉로133길,222,124,98
2017,2,A,골목상권,1000925,선릉로132길,1000,561,439
2017,2,A,골목상권,1000924,선릉로121길,1634,851,783
2017,2,A,골목상권,1000923,삼성로75길,2789,1533,1256
2017,2,A,골목상권,1000922,삼성로69길,297,145,152
2017,2,A,골목상권,1000921,삼성로64길,498,245,253
2017,2,A,골목상권,1000920,삼성로63길,182,83,99
2017,2,A,골목상권,1000919,삼성로57길,905,277,628
2017,2,A,골목상권,1000918,삼성로147길,890,366,524
2017,2,A,골목상권,1000917,삼성로115길,268,161,107
2017,2,A,골목상권,1000916,봉은사로68길,228,114,114
2017,2,A,골목상권,1000915,봉은사로57길,831,508,323
2017,2,A,골목상권,1000914,봉은사로43길,1113,733,380
2017,2,A,골목상권,1000913,봉은사로29길,128,81,47
2017,2,A,골목상권,1000912,봉은사로109길,331,171,160
2017,2,A,골목상권,1000911,도산대로89길,2604,956,1648
2017,2,A,골목상권,1000910,도산대로81길,4254,1366,2888
2017,2,A,골목상권,1000909,도산대로50길,2646,1846,800
2017,2,A,골목상권,1000908,도산대로38길,146,82,64
2017,2,A,골목상권,1000907,도산대로30길,3171,1560,1611
2017,2,A,골목상권,1000906,도산대로23길,1306,787,519
2017,2,A,골목상권,1000905,도산대로15길,1695,772,923
2017,2,A,골목상권,1000904,도곡로37길,3774,2232,1542
2017,2,A,골목상권,1000903,논현로8길,764,433,331
2017,2,A,골목상권,1000902,논현로63길,11837,3186,8651
2017,2,A,골목상권,1000901,논현로28길,10547,7193,3354
2017,2,A,골목상권,1000900,논현로26길,7582,4894,2688
2017,2,A,골목상권,1000898,논현로139길,2715,1319,1396
2017,2,A,골목상권,1000897,논현로123길,102,57,45
2017,2,A,골목상권,1000896,논현로115길,2811,1451,1360
2017,2,A,골목상권,1000895,논현로10길,2594,1654,940
2017,2,A,골목상권,1000894,논현로106길,2765,1597,1168
2017,2,A,골목상권,1000893,남부순환로365길,173,119,54
2017,2,A,골목상권,1000891,개포로28길,311,221,90
2017,2,A,골목상권,1000890,개포로20길,4283,2358,1925
2017,2,A,골목상권,1000889,개포로17길,2724,1757,967
2017,2,A,골목상권,1000888,강남대로140길,4278,2173,2105
2017,2,A,골목상권,1000887,강남대로136길,1127,590,537
2017,2,A,골목상권,1000886,강남대로118길,682,394,288
2017,2,A,골목상권,1000885,서초중앙로8길,7405,5543,1862
2017,2,A,골목상권,1000884,방배중앙로21길,1223,611,612
2017,2,A,골목상권,1000883,효령로72길,205,117,88
2017,2,A,골목상권,1000882,효령로34길,33,27,6
2017,2,A,골목상권,1000881,효령로31길,1338,735,603
2017,2,A,골목상권,1000880,효령로23길,739,444,295
2017,2,A,골목상권,1000879,청두곶길,2023,1303,720
2017,2,A,골목상권,1000878,주흥길,319,202,117
2017,2,A,골목상권,1000877,주흥15길,1463,948,515
2017,2,A,골목상권,1000876,언남길,1631,1124,507
2017,2,A,골목상권,1000875,신반포로45길,403,253,150
2017,2,A,골목상권,1000874,서초대로8길,287,176,111
2017,2,A,골목상권,1000873,서초대로64길,523,357,166
2017,2,A,골목상권,1000872,서초대로4길,665,473,192
2017,2,A,골목상권,1000871,서초대로25길,3387,2025,1362
2017,2,A,골목상권,1000870,서초대로23길,574,343,231
2017,2,A,골목상권,1000869,서초대로15길,1493,691,802
2017,2,A,골목상권,1000868,사평대로57길,170,66,104
2017,2,A,골목상권,1000867,사평대로26길,15,9,6
2017,2,A,골목상권,1000866,사평대로22길,1597,981,616
2017,2,A,골목상권,1000865,사임당로17길,1839,1080,759
2017,2,A,골목상권,1000864,방배로42길,154,82,72
2017,2,A,골목상권,1000863,방배로35길,2338,1442,896
2017,2,A,골목상권,1000862,방배로18길,87,46,41
2017,2,A,골목상권,1000861,반포대로9길,672,410,262
2017,2,A,골목상권,1000860,바우뫼로39길,2221,1376,845
2017,2,A,골목상권,1000859,마방로2길,3755,2373,1382
2017,2,A,골목상권,1000858,방배천로4안길,1259,807,452
2017,2,A,골목상권,1000857,동산로19길,1304,875,429
2017,2,A,골목상권,1000856,동산로10길,2845,1517,1328
2017,2,A,골목상권,1000855,동광로39길,46,29,17
2017,2,A,골목상권,1000854,동광로1길,1225,716,509
2017,2,A,골목상권,1000853,동광로12길,779,503,276
2017,2,A,골목상권,1000852,논현로27길,3646,2529,1117
2017,2,A,골목상권,1000851,논현로1길,551,361,190
2017,2,A,골목상권,1000850,남부순환로339길,12919,5417,7502
2017,2,A,골목상권,1000849,남부순환로325길,7991,3914,4077
2017,2,A,골목상권,1000848,남부순환로317길,1737,1223,514
2017,2,A,골목상권,1000847,고무래로8길,6587,3414,3173
2017,2,A,골목상권,1000846,강남대로8길,2525,1583,942
2017,2,A,골목상권,1000845,강남대로34길,1038,671,367
2017,2,A,골목상권,1000844,강남대로23길,7090,5042,2048
2017,2,A,골목상권,1000843,소담길,23,5,18
2017,2,A,골목상권,1000842,원신길,293,115,178
2017,2,A,골목상권,1000840,양산길,350,257,93
2017,2,A,골목상권,1000839,호암로24길,649,250,399
2017,2,A,골목상권,1000838,호암로20길,39,25,14
2017,2,A,골목상권,1000837,행운길,20,4,16
2017,2,A,골목상권,1000836,행운1길,99,66,33
2017,2,A,골목상권,1000835,청림3길,81,36,45
2017,2,A,골목상권,1000834,청룡길,92,47,45
2017,2,A,골목상권,1000833,청룡8길,10,5,5
2017,2,A,골목상권,1000832,중앙길,279,113,166
2017,2,A,골목상권,1000831,조원중앙로2길,1136,817,319
2017,2,A,골목상권,1000830,조원로18길,1020,561,459
2017,2,A,골목상권,1000829,조원로10길,275,126,149
2017,2,A,골목상권,1000828,장군봉2길,212,111,101
2017,2,A,골목상권,1000827,장군봉1길,84,14,70
2017,2,A,골목상권,1000826,인헌길,86,47,39
2017,2,A,골목상권,1000825,은천로25길,285,93,192
2017,2,A,골목상권,1000824,양녕로6길,805,483,322
2017,2,A,골목상권,1000823,신원로3길,21,15,6
2017,2,A,골목상권,1000822,신사로20길,54,24,30
2017,2,A,골목상권,1000820,신림로64길,251,116,135
2017,2,A,골목상권,1000819,신림로48길,73,33,40
2017,2,A,골목상권,1000818,신림로38길,63,32,31
2017,2,A,골목상권,1000817,신림로28길,317,217,100
2017,2,A,골목상권,1000816,신림로11길,445,409,36
2017,2,A,골목상권,1000815,신림동길,364,221,143
2017,2,A,골목상권,1000814,승방길,570,369,201
2017,2,A,골목상권,1000813,서림7길,277,103,174
2017,2,A,골목상권,1000812,봉천로33길,349,225,124
2017,2,A,골목상권,1000811,봉천로13길,321,98,223
2017,2,A,골목상권,1000810,복은길,175,58,117
2017,2,A,골목상권,1000809,법원단지길,2,1,1
2017,2,A,골목상권,1000808,법원단지9길,89,39,50
2017,2,A,골목상권,1000807,미성5길,66,34,32
2017,2,A,골목상권,1000806,대학길,86,31,55
2017,2,A,골목상권,1000805,대학14길,12,3,9
2017,2,A,골목상권,1000804,당곡길,380,196,184
2017,2,A,골목상권,1000803,남현길,242,97,145
2017,2,A,골목상권,1000802,남현3길,401,242,159
2017,2,A,골목상권,1000800,남부순환로248길,249,122,127
2017,2,A,골목상권,1000799,남부순환로234길,118,81,37
2017,2,A,골목상권,1000798,남부순환로172길,1354,779,575
2017,2,A,골목상권,1000797,남부순환로161길,21,6,15
2017,2,A,골목상권,1000796,남부순환로151길,190,134,56
2017,2,A,골목상권,1000795,남부순환로142길,74,34,40
2017,2,A,골목상권,1000794,난향길,160,39,121
2017,2,A,골목상권,1000793,난우길,406,160,246
2017,2,A,골목상권,1000792,난곡로74길,134,60,74
2017,2,A,골목상권,1000791,난곡로34길,25,8,17
2017,2,A,골목상권,1000790,난곡로26길,121,46,75
2017,2,A,골목상권,1000789,난곡로24길,37,18,19
2017,2,A,골목상권,1000788,낙성대역길,716,455,261
2017,2,A,골목상권,1000787,국회단지길,539,246,293
2017,2,A,골목상권,1000786,구암길,74,26,48
2017,2,A,골목상권,1000785,관천로22길,28,12,16
2017,2,A,골목상권,1000784,관천로15길,145,78,67
2017,2,A,골목상권,1000783,관악로30길,195,66,129
2017,2,A,골목상권,1000782,관악로28길,146,73,73
2017,2,A,골목상권,1000781,관악로14길,448,257,191
2017,2,A,골목상권,1000780,관악로10길,224,163,61
2017,2,A,골목상권,1000779,흑석로9길,195,88,107
2017,2,A,골목상권,1000778,흑석로13길,122,9,113
2017,2,A,골목상권,1000777,장승배기로27길,39,20,19
2017,2,A,골목상권,1000776,장승배기로19길,8,5,3
2017,2,A,골목상권,1000774,여의대방로46길,445,149,296
2017,2,A,골목상권,1000773,여의대방로24길,16849,8087,8762
2017,2,A,골목상권,1000772,여의대방로22카길,279,115,164
2017,2,A,골목상권,1000771,여의대방로22나길,131,50,81
2017,2,A,골목상권,1000770,여의대방로22길,207,121,86
2017,2,A,골목상권,1000769,양녕로26길,132,64,68
2017,2,A,골목상권,1000768,신대방길,109,71,38
2017,2,A,골목상권,1000767,성대로29길,3,3,0
2017,2,A,골목상권,1000766,성대로1길,312,124,188
2017,2,A,골목상권,1000765,서달로8가길,242,105,137
2017,2,A,골목상권,1000763,서달로14길,32,13,19
2017,2,A,골목상권,1000762,서달로10길,78,30,48
2017,2,A,골목상권,1000761,상도로62길,220,85,135
2017,2,A,골목상권,1000760,상도로61길,43,19,24
2017,2,A,골목상권,1000759,상도로47길,59,43,16
2017,2,A,골목상권,1000758,상도로37길,1945,952,993
2017,2,A,골목상권,1000757,상도로15길,321,137,184
2017,2,A,골목상권,1000756,사당로8길,121,69,52
2017,2,A,골목상권,1000755,사당로30길,298,201,97
2017,2,A,골목상권,1000754,사당로2차길,134,86,48
2017,2,A,골목상권,1000753,사당로29길,16,13,3
2017,2,A,골목상권,1000752,사당로26길,262,149,113
2017,2,A,골목상권,1000751,사당로23나길,127,36,91
2017,2,A,골목상권,1000750,사당로23길,16,13,3
2017,2,A,골목상권,1000749,사당로20길,186,142,44
2017,2,A,골목상권,1000748,사당로16길,136,36,100
2017,2,A,골목상권,1000747,사당로16가길,793,469,324
2017,2,A,골목상권,1000746,만양로8길,88,39,49
2017,2,A,골목상권,1000745,만양로14길,353,149,204
2017,2,A,골목상권,1000744,등용로14길,643,443,200
2017,2,A,골목상권,1000743,동작대로7길,1955,742,1213
2017,2,A,골목상권,1000742,동작대로35길,841,123,718
2017,2,A,골목상권,1000741,동작대로33길,116,63,53
2017,2,A,골목상권,1000740,동작대로29길,30,17,13
2017,2,A,골목상권,1000739,동작대로17길,1344,718,626
2017,2,A,골목상권,1000738,대방동2길,449,213,236
2017,2,A,골목상권,1000737,대방동27길,95,53,42
2017,2,A,골목상권,1000736,노량진로6길,110,28,82
2017,2,A,골목상권,1000735,국사봉길,39,7,32
2017,2,A,골목상권,1000734,국사봉2길,72,38,34
2017,2,A,골목상권,1000733,국사봉1길,7,3,4
2017,2,A,골목상권,1000732,영신로9길,340,188,152
2017,2,A,골목상권,1000731,영등포로84길,426,97,329
2017,2,A,골목상권,1000730,영등포로80길,49,23,26
2017,2,A,골목상권,1000729,영등포로62길,2,2,0
2017,2,A,골목상권,1000728,영등포로35길,88,60,28
2017,2,A,골목상권,1000727,영등포로27길,366,233,133
2017,2,A,골목상권,1000724,여의대방로43나길,2219,1798,421
2017,2,A,골목상권,1000723,여의대방로39길,14,11,3
2017,2,A,골목상권,1000722,여의대방로35길,798,418,380
2017,2,A,골목상권,1000721,양평로28길,613,489,124
2017,2,A,골목상권,1000720,양평로22라길,28,15,13
2017,2,A,골목상권,1000719,양평로19길,4473,3506,967
2017,2,A,골목상권,1000718,신길로60길,502,194,308
2017,2,A,골목상권,1000717,신길로42길,380,190,190
2017,2,A,골목상권,1000716,신길로42가길,101,33,68
2017,2,A,골목상권,1000715,신길로39길,107,46,61
2017,2,A,골목상권,1000714,신길로17길,56,38,18
2017,2,A,골목상권,1000713,선유서로28길,572,276,296
2017,2,A,골목상권,1000712,선유서로25길,2259,1620,639
2017,2,A,골목상권,1000711,선유서로24길,161,86,75
2017,2,A,골목상권,1000710,선유로55길,2389,1421,968
2017,2,A,골목상권,1000709,디지털로74길,49,30,19
2017,2,A,골목상권,1000708,디지털로57길,8,4,4
2017,2,A,골목상권,1000707,디지털로37길,219,93,126
2017,2,A,골목상권,1000706,도신로62길,181,55,126
2017,2,A,골목상권,1000705,도신로60길,67,12,55
2017,2,A,골목상권,1000704,도신로29길,83,37,46
2017,2,A,골목상권,1000703,도신로15길,83,32,51
2017,2,A,골목상권,1000702,도림천로21길,77,30,47
2017,2,A,골목상권,1000701,도림로63길,38,26,12
2017,2,A,골목상권,1000700,도림로147길,1718,1225,493
2017,2,A,골목상권,1000699,도림로112길,14,6,8
2017,2,A,골목상권,1000698,대림로8길,1840,588,1252
2017,2,A,골목상권,1000697,대림로7길,9,5,4
2017,2,A,골목상권,1000696,대림로44길,33,22,11
2017,2,A,골목상권,1000695,대림로34길,200,81,119
2017,2,A,골목상권,1000694,대림로31길,796,441,355
2017,2,A,골목상권,1000693,대림로29길,1644,761,883
2017,2,A,골목상권,1000692,대림로22길,365,204,161
2017,2,A,골목상권,1000691,당산로46길,4216,2534,1682
2017,2,A,골목상권,1000690,당산로38길,195,129,66
2017,2,A,골목상권,1000689,당산로37길,3855,2553,1302
2017,2,A,골목상권,1000688,당산로31길,4268,2309,1959
2017,2,A,골목상권,1000687,국회대로56길,1702,1110,592
2017,2,A,골목상권,1000686,경인로90길,302,183,119
2017,2,A,골목상권,1000685,경인로80길,1549,1117,432
2017,2,A,골목상권,1000684,경인로77길,673,443,230
2017,2,A,골목상권,1000683,가마산로61길,190,70,120
2017,2,A,골목상권,1000682,시흥대로94길,687,342,345
2017,2,A,골목상권,1000681,시흥대로84길,179,73,106
2017,2,A,골목상권,1000680,시흥대로68길,682,177,505
2017,2,A,골목상권,1000679,시흥대로63길,2805,1456,1349
2017,2,A,골목상권,1000678,시흥대로62가길,430,115,315
2017,2,A,골목상권,1000677,시흥대로36길,367,211,156
2017,2,A,골목상권,1000676,시흥대로22길,502,351,151
2017,2,A,골목상권,1000675,시흥대로153길,676,384,292
2017,2,A,골목상권,1000674,시흥대로150길,537,244,293
2017,2,A,골목상권,1000673,시흥대로141길,661,392,269
2017,2,A,골목상권,1000672,시흥대로138길,15,7,8
2017,2,A,골목상권,1000671,시흥대로120길,510,332,178
2017,2,A,골목상권,1000670,벚꽃로56길,1901,1322,579
2017,2,A,골목상권,1000669,범안로17길,139,86,53
2017,2,A,골목상권,1000668,범안로11길,1108,875,233
2017,2,A,골목상권,1000667,문성로5길,156,49,107
2017,2,A,골목상권,1000666,독산로85길,100,28,72
2017,2,A,골목상권,1000665,독산로78다길,227,102,125
2017,2,A,골목상권,1000664,독산로70길,4,3,1
2017,2,A,골목상권,1000663,독산로64길,121,33,88
2017,2,A,골목상권,1000662,독산로50길,93,38,55
2017,2,A,골목상권,1000661,독산로40길,62,23,39
2017,2,A,골목상권,1000660,독산로108길,737,349,388
2017,2,A,골목상권,1000659,남부순환로112길,12,6,6
2017,2,A,골목상권,1000658,금하로24길,175,57,118
2017,2,A,골목상권,1000657,금하로1길,66,30,36
2017,2,A,골목상권,1000656,금하로14길,16,8,8
2017,2,A,골목상권,1000655,가산로5길,566,444,122
2017,2,A,골목상권,1000654,가산로3길,2425,1831,594
2017,2,A,골목상권,1000653,중앙로1길,1513,1052,461
2017,2,A,골목상권,1000652,중앙로15길,90,45,45
2017,2,A,골목상권,1000651,우마길,33,22,11
2017,2,A,골목상권,1000650,오류로8길,241,108,133
2017,2,A,골목상권,1000649,신도림로13길,783,593,190
2017,2,A,골목상권,1000648,새말로18길,1070,452,618
2017,2,A,골목상권,1000647,부일로1길,752,612,140
2017,2,A,골목상권,1000646,부일로15길,178,153,25
2017,2,A,골목상권,1000645,부일로11길,23,5,18
2017,2,A,골목상권,1000644,디지털로32길,1122,583,539
2017,2,A,골목상권,1000643,디지털로32가길,7325,5079,2246
2017,2,A,골목상권,1000642,디지털로27길,385,251,134
2017,2,A,골목상권,1000641,도림로6길,100,45,55
2017,2,A,골목상권,1000640,도림로12길,106,46,60
2017,2,A,골목상권,1000639,남부순환로97길,259,89,170
2017,2,A,골목상권,1000638,구로중앙로8길,207,73,134
2017,2,A,골목상권,1000637,구로중앙로7길,181,59,122
2017,2,A,골목상권,1000636,구로중앙로42길,805,608,197
2017,2,A,골목상권,1000635,구로중앙로34길,627,367,260
2017,2,A,골목상권,1000634,구로중앙로28길,3021,1453,1568
2017,2,A,골목상권,1000633,구로중앙로19길,12,6,6
2017,2,A,골목상권,1000632,구로동로8길,148,44,104
2017,2,A,골목상권,1000631,구로동로7길,166,65,101
2017,2,A,골목상권,1000630,구로동로42길,22,14,8
2017,2,A,골목상권,1000629,구로동로41길,463,292,171
2017,2,A,골목상권,1000628,구로동로38길,37,14,23
2017,2,A,골목상권,1000627,구로동로28길,202,93,109
2017,2,A,골목상권,1000626,구로동로15길,21,2,19
2017,2,A,골목상권,1000625,공원로6가길,303,213,90
2017,2,A,골목상권,1000624,고척로52길,234,65,169
2017,2,A,골목상권,1000623,고척로27다길,212,82,130
2017,2,A,골목상권,1000622,고척로27길,244,113,131
2017,2,A,골목상권,1000621,고척로21나길,229,63,166
2017,2,A,골목상권,1000620,경인로47길,889,497,392
2017,2,A,골목상권,1000619,경인로35길,292,118,174
2017,2,A,골목상권,1000618,경인로31길,58,20,38
2017,2,A,골목상권,1000617,경인로15길,134,58,76
2017,2,A,골목상권,1000616,개봉로3길,244,150,94
2017,2,A,골목상권,1000615,개봉로2길,481,137,344
2017,2,A,골목상권,1000614,개봉로23가길,937,556,381
2017,2,A,골목상권,1000613,개봉로20길,124,72,52
2017,2,A,골목상권,1000612,개봉로1길,51,26,25
2017,2,A,골목상권,1000611,개봉로17다길,168,79,89
2017,2,A,골목상권,1000610,개봉로17길,872,356,516
2017,2,A,골목상권,1000609,개봉로11길,49,10,39
2017,2,A,골목상권,1000608,화곡로64길,2966,1641,1325
2017,2,A,골목상권,1000607,화곡로59길,476,195,281
2017,2,A,골목상권,1000606,화곡로44나길,830,710,120
2017,2,A,골목상권,1000605,화곡로31길,1142,416,726
2017,2,A,골목상권,1000604,화곡로20길,520,334,186
2017,2,A,골목상권,1000603,화곡로13길,264,88,176
2017,2,A,골목상권,1000602,초원로16길,690,318,372
2017,2,A,골목상권,1000601,초록마을로8길,174,35,139
2017,2,A,골목상권,1000600,초록마을로3길,50,25,25
2017,2,A,골목상권,1000599,월정로20길,4,2,2
2017,2,A,골목상권,1000598,우장산로6길,306,168,138
2017,2,A,골목상권,1000597,양천로73가길,1321,838,483
2017,2,A,골목상권,1000596,양천로71길,203,132,71
2017,2,A,골목상권,1000595,양천로49길,709,575,134
2017,2,A,골목상권,1000594,양천로26길,144,58,86
2017,2,A,골목상권,1000593,양천로24길,350,141,209
2017,2,A,골목상권,1000592,양천로24가길,696,316,380
2017,2,A,골목상권,1000591,양천로14길,232,143,89
2017,2,A,골목상권,1000590,방화대로6라길,762,481,281
2017,2,A,골목상권,1000589,방화대로21길,845,512,333
2017,2,A,골목상권,1000588,등촌로5길,10,3,7
2017,2,A,골목상권,1000587,등촌로55길,509,347,162
2017,2,A,골목상권,1000586,등촌로51길,19,11,8
2017,2,A,골목상권,1000585,등촌로39길,66,24,42
2017,2,A,골목상권,1000584,등촌로13길,196,105,91
2017,2,A,골목상권,1000583,남부순환로11길,413,289,124
2017,2,A,골목상권,1000582,까치산로4길,144,57,87
2017,2,A,골목상권,1000581,국회대로7길,376,223,153
2017,2,A,골목상권,1000580,공항대로8길,200,81,119
2017,2,A,골목상권,1000579,공항대로61길,223,145,78
2017,2,A,골목상권,1000578,공항대로59다길,890,646,244
2017,2,A,골목상권,1000577,공항대로59길,1182,774,408
2017,2,A,골목상권,1000576,공항대로55길,1076,736,340
2017,2,A,골목상권,1000575,공항대로42길,6,3,3
2017,2,A,골목상권,1000574,공항대로38길,270,146,124
2017,2,A,골목상권,1000573,곰달래로60길,560,296,264
2017,2,A,골목상권,1000572,곰달래로53길,61,19,42
2017,2,A,골목상권,1000571,곰달래로47길,38,14,24
2017,2,A,골목상권,1000570,곰달래로31길,12,10,2
2017,2,A,골목상권,1000569,곰달래로25길,617,251,366
2017,2,A,골목상권,1000568,개화동로25길,670,430,240
2017,2,A,골목상권,1000567,개화동로23길,128,87,41
2017,2,A,골목상권,1000566,강서로8길,148,83,65
2017,2,A,골목상권,1000565,강서로5라길,297,175,122
2017,2,A,골목상권,1000564,강서로5나길,116,66,50
2017,2,A,골목상권,1000563,강서로5가길,48,25,23
2017,2,A,골목상권,1000562,강서로47라길,107,57,50
2017,2,A,골목상권,1000561,강서로47길,392,201,191
2017,2,A,골목상권,1000560,강서로45다길,789,396,393
2017,2,A,골목상권,1000559,강서로45길,141,63,78
2017,2,A,골목상권,1000558,강서로35길,176,99,77
2017,2,A,골목상권,1000557,강서로29길,316,160,156
2017,2,A,골목상권,1000556,강서로18길,26,13,13
2017,2,A,골목상권,1000555,강서로17가길,118,50,68
2017,2,A,골목상권,1000554,강서로15길,266,129,137
2017,2,A,골목상권,1000553,가로공원로80길,57,30,27
2017,2,A,골목상권,1000552,가로공원로76가길,28,13,15
2017,2,A,골목상권,1000551,화곡로4길,244,92,152
2017,2,A,골목상권,1000550,화곡로3길,179,64,115
2017,2,A,골목상권,1000549,지양로7길,227,76,151
2017,2,A,골목상권,1000548,중앙로55길,362,190,172
2017,2,A,골목상권,1000547,중앙로51길,142,90,52
2017,2,A,골목상권,1000546,중앙로47길,127,34,93
2017,2,A,골목상권,1000545,중앙로45길,155,50,105
2017,2,A,골목상권,1000544,중앙로36길,2,2,0
2017,2,A,골목상권,1000543,중앙로32길,623,292,331
2017,2,A,골목상권,1000542,중앙로25길,245,65,180
2017,2,A,골목상권,1000541,은행정로7길,498,163,335
2017,2,A,골목상권,1000539,오목로5길,285,168,117
2017,2,A,골목상권,1000538,오목로3길,418,393,25
2017,2,A,골목상권,1000537,오목로30길,150,76,74
2017,2,A,골목상권,1000536,오목로23길,801,456,345
2017,2,A,골목상권,1000535,신월로20길,209,78,131
2017,2,A,골목상권,1000534,신월로15길,793,359,434
2017,2,A,골목상권,1000533,신목로6길,253,141,112
2017,2,A,골목상권,1000532,신목로5길,870,328,542
2017,2,A,골목상권,1000531,신목로2길,99,48,51
2017,2,A,골목상권,1000530,목동중앙서로8가길,175,103,72
2017,2,A,골목상권,1000529,목동중앙서로7길,235,72,163
2017,2,A,골목상권,1000528,목동중앙북로8길,334,115,219
2017,2,A,골목상권,1000527,목동중앙북로16길,281,91,190
2017,2,A,골목상권,1000526,목동중앙본로7길,113,46,67
2017,2,A,골목상권,1000525,목동중앙로3길,108,58,50
2017,2,A,골목상권,1000524,목동중앙로13나길,291,213,78
2017,2,A,골목상권,1000523,목동중앙남로3가길,544,353,191
2017,2,A,골목상권,1000522,목동로9길,2381,1501,880
2017,2,A,골목상권,1000521,목동로19길,987,337,650
2017,2,A,골목상권,1000519,목동동로12길,416,149,267
2017,2,A,골목상권,1000518,목동남로4길,10,4,6
2017,2,A,골목상권,1000517,남부순환로88길,294,122,172
2017,2,A,골목상권,1000516,남부순환로79길,415,314,101
2017,2,A,골목상권,1000515,남부순환로70길,525,323,202
2017,2,A,골목상권,1000514,남부순환로58길,187,110,77
2017,2,A,골목상권,1000513,남부순환로40길,15,5,10
2017,2,A,골목상권,1000512,남부순환로33길,1214,978,236
2017,2,A,골목상권,1000511,곰달래로5길,53,31,22
2017,2,A,골목상권,1000510,곰달래로3길,375,203,172
2017,2,A,골목상권,1000509,곰달래로2길,267,148,119
2017,2,A,골목상권,1000508,곰달래로10길,327,232,95
2017,2,A,골목상권,1000507,가로공원로58길,75,15,60
2017,2,A,골목상권,1000506,효창원로93길,94,46,48
2017,2,A,골목상권,1000505,토정로37길,130,58,72
2017,2,A,골목상권,1000504,월드컵로8길,1843,947,896
2017,2,A,골목상권,1000503,월드컵로7길,4,2,2
2017,2,A,골목상권,1000502,월드컵로36길,145,63,82
2017,2,A,골목상권,1000501,월드컵로25길,279,157,122
2017,2,A,골목상권,1000500,월드컵로19길,764,312,452
2017,2,A,골목상권,1000499,월드컵로16길,3995,2036,1959
2017,2,A,골목상권,1000498,월드컵로11길,272,120,152
2017,2,A,골목상권,1000497,월드컵로10길,1644,857,787
2017,2,A,골목상권,1000496,와우산로3길,148,84,64
2017,2,A,골목상권,1000495,와우산로29길,186,96,90
2017,2,A,골목상권,1000494,와우산로29가길,21,10,11
2017,2,A,골목상권,1000493,양화진길,439,304,135
2017,2,A,골목상권,1000492,양화로1길,4120,1917,2203
2017,2,A,골목상권,1000491,양화로11길,380,250,130
2017,2,A,골목상권,1000490,신촌로30길,24,17,7
2017,2,A,골목상권,1000489,신촌로28가길,109,41,68
2017,2,A,골목상권,1000488,신촌로12길,1404,646,758
2017,2,A,골목상권,1000487,숭문길,3330,2289,1041
2017,2,A,골목상권,1000486,숭문8길,116,69,47
2017,2,A,골목상권,1000485,성지3길,454,231,223
2017,2,A,골목상권,1000484,성산로4길,1687,1082,605
2017,2,A,골목상권,1000483,성미산로32길,409,189,220
2017,2,A,골목상권,1000482,성미산로1길,636,440,196
2017,2,A,골목상권,1000481,성미산로11길,1088,742,346
2017,2,A,골목상권,1000480,백범로16길,604,306,298
2017,2,A,골목상권,1000479,방울내로9안길,313,193,120
2017,2,A,골목상권,1000478,모래내로7길,264,135,129
2017,2,A,골목상권,1000477,매봉산로2길,1815,1138,677
2017,2,A,골목상권,1000476,망원로2길,190,110,80
2017,2,A,골목상권,1000475,망원로11길,1098,624,474
2017,2,A,골목상권,1000474,만리재옛길,1421,615,806
2017,2,A,골목상권,1000473,마포대로4길,171,93,78
2017,2,A,골목상권,1000472,마포대로20길,1161,597,564
2017,2,A,골목상권,1000471,마포대로12길,68,37,31
2017,2,A,골목상권,1000470,동교로38길,248,119,129
2017,2,A,골목상권,1000469,동교로27길,3538,1602,1936
2017,2,A,골목상권,1000468,동교로25길,547,271,276
2017,2,A,골목상권,1000467,동교로19길,4557,3104,1453
2017,2,A,골목상권,1000466,동교로17길,844,435,409
2017,2,A,골목상권,1000465,독막로8길,295,131,164
2017,2,A,골목상권,1000464,독막로32길,460,200,260
2017,2,A,골목상권,1000463,독막로22길,116,67,49
2017,2,A,골목상권,1000462,도화길,1059,531,528
2017,2,A,골목상권,1000461,도화4길,380,130,250
2017,2,A,골목상권,1000460,대흥로28길,53,41,12
2017,2,A,골목상권,1000459,대흥로21길,458,82,376
2017,2,A,골목상권,1000458,광성로6길,135,86,49
2017,2,A,골목상권,1000457,홍제내길,116,64,52
2017,2,A,골목상권,1000456,홍연길,76,44,32
2017,2,A,골목상권,1000455,통일로39길,11,9,2
2017,2,A,골목상권,1000454,통일로37길,367,141,226
2017,2,A,골목상권,1000453,통일로11길,9,8,1
2017,2,A,골목상권,1000452,충정로6길,13745,7837,5908
2017,2,A,골목상권,1000451,충정로4길,3043,2022,1021
2017,2,A,골목상권,1000450,증가로6길,213,91,122
2017,2,A,골목상권,1000449,증가로23나길,459,239,220
2017,2,A,골목상권,1000448,증가로20가길,246,85,161
2017,2,A,골목상권,1000447,증가로10길,160,85,75
2017,2,A,골목상권,1000446,응암로1길,395,283,112
2017,2,A,골목상권,1000445,연희로10길,115,78,37
2017,2,A,골목상권,1000444,신촌로37길,108,48,60
2017,2,A,골목상권,1000443,수색로8길,3051,2834,217
2017,2,A,골목상권,1000442,세무서길,334,118,216
2017,2,A,골목상권,1000440,세검정로1길,325,182,143
2017,2,A,골목상권,1000439,북아현로4길,416,92,324
2017,2,A,골목상권,1000438,모래내로15길,93,25,68
2017,2,A,골목상권,1000437,명지대길,386,286,100
2017,2,A,골목상권,1000436,독립문로8길,726,276,450
2017,2,A,골목상권,1000435,가재울로6길,20,10,10
2017,2,A,골목상권,1000434,통일로92길,78,36,42
2017,2,A,골목상권,1000433,통일로87길,216,102,114
2017,2,A,골목상권,1000432,통일로78길,209,61,148
2017,2,A,골목상권,1000430,진흥로1길,526,165,361
2017,2,A,골목상권,1000429,진흥로12길,485,195,290
2017,2,A,골목상권,1000428,증산서길,568,288,280
2017,2,A,골목상권,1000427,증산로9길,89,25,64
2017,2,A,골목상권,1000426,증산로5길,779,395,384
2017,2,A,골목상권,1000425,증산로21길,241,159,82
2017,2,A,골목상권,1000424,증산로17길,751,335,416
2017,2,A,골목상권,1000423,증산로15길,202,79,123
2017,2,A,골목상권,1000422,증산로13길,72,35,37
2017,2,A,골목상권,1000421,응암로34길,64,42,22
2017,2,A,골목상권,1000420,응암로22길,151,52,99
2017,2,A,골목상권,1000419,응암로14길,379,129,250
2017,2,A,골목상권,1000418,응암로13길,281,116,165
2017,2,A,골목상권,1000417,응암로12길,203,111,92
2017,2,A,골목상권,1000416,은평로8길,276,146,130
2017,2,A,골목상권,1000415,은평로3길,308,95,213
2017,2,A,골목상권,1000414,은평로20길,23,10,13
2017,2,A,골목상권,1000413,은평로13길,385,255,130
2017,2,A,골목상권,1000412,은평로10길,341,176,165
2017,2,A,골목상권,1000411,연서로5길,42,12,30
2017,2,A,골목상권,1000410,연서로41길,245,74,171
2017,2,A,골목상권,1000409,연서로3길,109,42,67
2017,2,A,골목상권,1000408,연서로34길,167,52,115
2017,2,A,골목상권,1000407,연서로33길,25,8,17
2017,2,A,골목상권,1000406,연서로29길,330,120,210
2017,2,A,골목상권,1000405,연서로28길,815,359,456
2017,2,A,골목상권,1000404,연서로27길,73,28,45
2017,2,A,골목상권,1000403,연서로21길,343,212,131
2017,2,A,골목상권,1000402,연서로17길,1189,357,832
2017,2,A,골목상권,1000401,연서로16길,259,98,161
2017,2,A,골목상권,1000400,연서로13길,729,223,506
2017,2,A,골목상권,1000399,연서로11길,239,111,128
2017,2,A,골목상권,1000398,역말로9길,19,13,6
2017,2,A,골목상권,1000397,수색로18길,21,9,12
2017,2,A,골목상권,1000396,서오릉로8길,15,0,15
2017,2,A,골목상권,1000395,서오릉로21길,409,103,306
2017,2,A,골목상권,1000394,불광천길,191,99,92
2017,2,A,골목상권,1000393,갈현로7길,914,259,655
2017,2,A,골목상권,1000392,갈현로41길,96,41,55
2017,2,A,골목상권,1000391,갈현로33길,37,9,28
2017,2,A,골목상권,1000390,갈현로1길,165,73,92
2017,2,A,골목상권,1000389,가좌로7길,58,28,30
2017,2,A,골목상권,1000388,한글비석로44길,421,231,190
2017,2,A,골목상권,1000387,한글비석로24길,403,165,238
2017,2,A,골목상권,1000386,한글비석로22길,671,309,362
2017,2,A,골목상권,1000385,석계로1길,105,67,38
2017,2,A,골목상권,1000384,상계로9가길,301,113,188
2017,2,A,골목상권,1000382,상계로12길,28,19,9
2017,2,A,골목상권,1000381,동일로242길,296,185,111
2017,2,A,골목상권,1000380,동일로192길,450,200,250
2017,2,A,골목상권,1000379,동일로173가길,2262,1201,1061
2017,2,A,골목상권,1000378,공릉로58길,134,48,86
2017,2,A,골목상권,1000377,해등로16길,88,69,19
2017,2,A,골목상권,1000376,우이천로4다길,181,106,75
2017,2,A,골목상권,1000375,우이천로32길,100,59,41
2017,2,A,골목상권,1000374,시루봉로23길,47,22,25
2017,2,A,골목상권,1000373,삼양로144길,80,58,22
2017,2,A,골목상권,1000372,방학로6가길,172,91,81
2017,2,A,골목상권,1000371,방학로5길,113,70,43
2017,2,A,골목상권,1000370,방학로15길,326,208,118
2017,2,A,골목상권,1000369,방학로10길,172,74,98
2017,2,A,골목상권,1000367,도봉산4길,322,280,42
2017,2,A,골목상권,1000366,도봉로181길,188,81,107
2017,2,A,골목상권,1000365,도봉로169나길,297,127,170
2017,2,A,골목상권,1000364,도봉로156길,256,132,124
2017,2,A,골목상권,1000363,도봉로152가길,417,365,52
2017,2,A,골목상권,1000362,도봉로147길,576,320,256
2017,2,A,골목상권,1000360,도봉로114길,506,182,324
2017,2,A,골목상권,1000359,도봉로109길,20,7,13
2017,2,A,골목상권,1000358,도당로29길,868,495,373
2017,2,A,골목상권,1000357,도당로19길,192,79,113
2017,2,A,골목상권,1000356,도당로13바길,194,85,109
2017,2,A,골목상권,1000355,도당로13가길,159,64,95
2017,2,A,골목상권,1000354,덕릉로60길,83,48,35
2017,2,A,골목상권,1000353,노해로63다길,596,261,335
2017,2,A,골목상권,1000352,노해로60길,325,145,180
2017,2,A,골목상권,1000351,한천로140길,97,49,48
2017,2,A,골목상권,1000350,한천로139가길,54,32,22
2017,2,A,골목상권,1000349,한천로132길,333,133,200
2017,2,A,골목상권,1000348,한천로130길,276,124,152
2017,2,A,골목상권,1000347,한천로124나길,85,47,38
2017,2,A,골목상권,1000346,한천로109길,591,261,330
2017,2,A,골목상권,1000345,인수봉로79길,173,46,127
2017,2,A,골목상권,1000344,인수봉로72길,75,36,39
2017,2,A,골목상권,1000342,오패산로67길,592,293,299
2017,2,A,골목상권,1000341,오패산로52길,110,42,68
2017,2,A,골목상권,1000339,수유로12길,264,170,94
2017,2,A,골목상권,1000338,솔샘로65길,506,233,273
2017,2,A,골목상권,1000337,솔매로50길,682,273,409
2017,2,A,골목상권,1000336,솔매로45길,175,87,88
2017,2,A,골목상권,1000335,솔매로41길,87,24,63
2017,2,A,골목상권,1000334,삼양로93길,18,4,14
2017,2,A,골목상권,1000333,삼양로77길,434,151,283
2017,2,A,골목상권,1000332,삼양로54길,8,4,4
2017,2,A,골목상권,1000331,삼양로41길,299,134,165
2017,2,A,골목상권,1000329,삼양로24길,81,38,43
2017,2,A,골목상권,1000328,삼양로20길,127,48,79
2017,2,A,골목상권,1000327,삼각산로28길,834,422,412
2017,2,A,골목상권,1000326,도봉로99길,206,99,107
2017,2,A,골목상권,1000325,도봉로8길,244,182,62
2017,2,A,골목상권,1000324,도봉로76길,402,217,185
2017,2,A,골목상권,1000323,도봉로67길,6,3,3
2017,2,A,골목상권,1000322,도봉로45길,113,70,43
2017,2,A,골목상권,1000321,도봉로18길,390,174,216
2017,2,A,골목상권,1000320,도봉로13길,36,11,25
2017,2,A,골목상권,1000319,덕릉로41길,776,622,154
2017,2,A,골목상권,1000318,덕릉로40길,902,698,204
2017,2,A,골목상권,1000317,노해로33길,35,12,23
2017,2,A,골목상권,1000315,노해로17길,225,69,156
2017,2,A,골목상권,1000314,화랑로40길,184,94,90
2017,2,A,골목상권,1000313,화랑로32길,466,348,118
2017,2,A,골목상권,1000312,화랑로1길,162,87,75
2017,2,A,골목상권,1000311,화랑로19길,510,269,241
2017,2,A,골목상권,1000310,화랑로14길,50,22,28
2017,2,A,골목상권,1000309,화랑로13길,93,46,47
2017,2,A,골목상권,1000308,한천로76길,130,75,55
2017,2,A,골목상권,1000307,한천로101가길,51,29,22
2017,2,A,골목상권,1000306,창경궁로43길,26,15,11
2017,2,A,골목상권,1000305,지봉로20길,95,60,35
2017,2,A,골목상권,1000304,종암로5길,123,86,37
2017,2,A,골목상권,1000303,종암로24가길,288,136,152
2017,2,A,골목상권,1000302,종암로21길,240,49,191
2017,2,A,골목상권,1000301,종암로19길,375,114,261
2017,2,A,골목상권,1000300,종암로16길,78,34,44
2017,2,A,골목상권,1000299,정릉로8길,185,106,79
2017,2,A,골목상권,1000298,정릉로27길,199,80,119
2017,2,A,골목상권,1000296,장위로50길,885,489,396
2017,2,A,골목상권,1000295,장월로1길,398,182,216
2017,2,A,골목상권,1000294,인촌로6길,2823,1608,1215
2017,2,A,골목상권,1000293,인촌로5길,28,3,25
2017,2,A,골목상권,1000292,인촌로24길,221,157,64
2017,2,A,골목상권,1000291,개운사길,3408,2109,1299
2017,2,A,골목상권,1000290,인촌로1길,159,106,53
2017,2,A,골목상권,1000289,인촌로17가길,3174,1150,2024
2017,2,A,골목상권,1000288,오패산로4길,605,195,410
2017,2,A,골목상권,1000287,오패산로3길,1250,723,527
2017,2,A,골목상권,1000286,오패산로19길,43,17,26
2017,2,A,골목상권,1000285,안암로5길,609,380,229
2017,2,A,골목상권,1000284,아리랑로4길,587,215,372
2017,2,A,골목상권,1000283,솔샘로6길,152,75,77
2017,2,A,골목상권,1000282,성북로8길,54,27,27
2017,2,A,골목상권,1000281,삼양로8길,97,62,35
2017,2,A,골목상권,1000280,삼선교로16가길,719,416,303
2017,2,A,골목상권,1000279,삼선교로10다길,101,48,53
2017,2,A,골목상권,1000278,삼선교로10길,254,125,129
2017,2,A,골목상권,1000277,보문로32길,983,396,587
2017,2,A,골목상권,1000276,보문로31길,710,294,416
2017,2,A,골목상권,1000274,보문로13길,782,471,311
2017,2,A,골목상권,1000273,보국문로16길,349,235,114
2017,2,A,골목상권,1000270,동소문로26가길,290,165,125
2017,2,A,골목상권,1000269,동소문로15길,94,44,50
2017,2,A,골목상권,1000268,동소문로13길,414,213,201
2017,2,A,골목상권,1000267,돌곶이로8길,207,107,100
2017,2,A,골목상권,1000266,돌곶이로41길,43,20,23
2017,2,A,골목상권,1000265,돌곶이로28길,236,155,81
2017,2,A,골목상권,1000264,돌곶이로27길,74,39,35
2017,2,A,골목상권,1000263,돌곶이로22길,134,73,61
2017,2,A,골목상권,1000262,돌곶이로14길,3,3,0
2017,2,A,골목상권,1000261,길음로7길,8,5,3
2017,2,A,골목상권,1000260,중랑천로10길,748,404,344
2017,2,A,골목상권,1000259,용마산로94길,436,266,170
2017,2,A,골목상권,1000258,용마산로118길,693,396,297
2017,2,A,골목상권,1000257,용마산로112길,348,152,196
2017,2,A,골목상권,1000256,용마산로100길,407,281,126
2017,2,A,골목상권,1000255,신내로7가길,272,67,205
2017,2,A,골목상권,1000254,사가정로54길,111,33,78
2017,2,A,골목상권,1000253,사가정로42길,78,19,59
2017,2,A,골목상권,1000252,봉화산로56길,590,152,438
2017,2,A,골목상권,1000251,봉화산로4길,402,143,259
2017,2,A,골목상권,1000250,봉화산로30길,358,221,137
2017,2,A,골목상권,1000249,봉우재로33길,114,46,68
2017,2,A,골목상권,1000248,면목로78길,289,155,134
2017,2,A,골목상권,1000247,면목로56길,209,156,53
2017,2,A,골목상권,1000246,면목로55길,439,136,303
2017,2,A,골목상권,1000245,면목로49길,550,176,374
2017,2,A,골목상권,1000244,면목로48길,125,64,61
2017,2,A,골목상권,1000243,면목로45길,68,31,37
2017,2,A,골목상권,1000242,면목로33길,374,147,227
2017,2,A,골목상권,1000241,면목로21길,47,38,9
2017,2,A,골목상권,1000240,망우로73길,8,4,4
2017,2,A,골목상권,1000239,망우로68길,85,35,50
2017,2,A,골목상권,1000238,동일로163길,104,70,34
2017,2,A,골목상권,1000237,동일로157길,196,105,91
2017,2,A,골목상권,1000236,동일로149길,1131,842,289
2017,2,A,골목상권,1000235,동일로140길,216,85,131
2017,2,A,골목상권,1000234,동일로139길,65,42,23
2017,2,A,골목상권,1000233,동일로139가길,1122,667,455
2017,2,A,골목상권,1000232,동일로130길,98,23,75
2017,2,A,골목상권,1000231,동일로123길,179,86,93
2017,2,A,골목상권,1000230,동일로112길,159,68,91
2017,2,A,골목상권,1000229,동일로101길,303,121,182
2017,2,A,골목상권,1000228,동일로100길,31,15,16
2017,2,A,골목상권,1000227,답십리로75길,95,53,42
2017,2,A,골목상권,1000226,공릉로2길,661,309,352
2017,2,A,골목상권,1000225,공릉로12가길,34,24,10
2017,2,A,골목상권,1000224,겸재로54길,114,54,60
2017,2,A,골목상권,1000223,겸재로36길,229,197,32
2017,2,A,골목상권,1000222,겸재로29길,442,191,251
2017,2,A,골목상권,1000221,휘경로3길,215,98,117
2017,2,A,골목상권,1000220,휘경로2길,6,2,4
2017,2,A,골목상권,1000219,휘경로23길,20,5,15
2017,2,A,골목상권,1000218,휘경로14길,107,44,63
2017,2,A,골목상권,1000217,한천로46길,391,129,262
2017,2,A,골목상권,1000216,한천로40길,325,174,151
2017,2,A,골목상권,1000215,한천로33길,76,34,42
2017,2,A,골목상권,1000214,한천로14길,630,370,260
2017,2,A,골목상권,1000213,천호대로97길,341,211,130
2017,2,A,골목상권,1000212,천호대로77길,2215,1222,993
2017,2,A,골목상권,1000211,천호대로45길,135,80,55
2017,2,A,골목상권,1000210,천호대로17길,2318,1488,830
2017,2,A,골목상권,1000209,천호대로12길,848,565,283
2017,2,A,골목상권,1000208,천장산로7길,1474,897,577
2017,2,A,골목상권,1000207,제기로5길,208,101,107
2017,2,A,골목상권,1000206,제기로21길,218,146,72
2017,2,A,골목상권,1000205,전농로4길,712,449,263
2017,2,A,골목상권,1000204,전농로3길,74,35,39
2017,2,A,골목상권,1000203,전농로29길,312,139,173
2017,2,A,골목상권,1000202,장한로8길,825,493,332
2017,2,A,골목상권,1000201,장한로5길,3001,2113,888
2017,2,A,골목상권,1000200,장한로27길,158,40,118
2017,2,A,골목상권,1000199,장한로27가길,400,187,213
2017,2,A,골목상권,1000198,장한로26길,566,275,291
2017,2,A,골목상권,1000197,장한로26가길,338,141,197
2017,2,A,골목상권,1000196,장한로25길,1077,482,595
2017,2,A,골목상권,1000195,장한로14길,185,150,35
2017,2,A,골목상권,1000194,이문로42길,241,90,151
2017,2,A,골목상권,1000193,왕산로43길,979,465,514
2017,2,A,골목상권,1000192,왕산로33길,147,99,48
2017,2,A,골목상권,1000191,왕산로32길,10,7,3
2017,2,A,골목상권,1000190,약령시로17길,300,130,170
2017,2,A,골목상권,1000189,서울시립대로4길,648,336,312
2017,2,A,골목상권,1000188,서울시립대로29길,243,135,108
2017,2,A,골목상권,1000187,서울시립대로16길,130,33,97
2017,2,A,골목상권,1000186,사가정로2길,91,72,19
2017,2,A,골목상권,1000185,사가정로23가길,96,58,38
2017,2,A,골목상권,1000184,사가정로13길,266,83,183
2017,2,A,골목상권,1000183,무학로45길,372,215,157
2017,2,A,골목상권,1000182,무학로16길,1163,1061,102
2017,2,A,골목상권,1000181,망우로21길,188,108,80
2017,2,A,골목상권,1000180,망우로18길,374,134,240
2017,2,A,골목상권,1000179,망우로18가길,68,27,41
2017,2,A,골목상권,1000178,답십리로72길,3,2,1
2017,2,A,골목상권,1000177,답십리로69길,925,397,528
2017,2,A,골목상권,1000176,답십리로68길,114,76,38
2017,2,A,골목상권,1000175,답십리로64길,337,193,144
2017,2,A,골목상권,1000174,답십리로63길,99,57,42
2017,2,A,골목상권,1000173,답십리로60길,12,7,5
2017,2,A,골목상권,1000172,답십리로56길,4,4,0
2017,2,A,골목상권,1000171,답십리로23길,9,8,1
2017,2,A,골목상권,1000170,난계로30길,121,87,34
2017,2,A,골목상권,1000168,경희대로3길,276,177,99
2017,2,A,골목상권,1000167,천호대로129길,249,86,163
2017,2,A,골목상권,1000166,천호대로123길,268,105,163
2017,2,A,골목상권,1000165,천호대로109길,1139,628,511
2017,2,A,골목상권,1000164,자양번영로3길,97,44,53
2017,2,A,골목상권,1000163,자양로53길,3,0,3
2017,2,A,골목상권,1000162,자양로50길,18,5,13
2017,2,A,골목상권,1000161,자양로45길,572,304,268
2017,2,A,골목상권,1000160,자양로26길,325,113,212
2017,2,A,골목상권,1000159,자양로15길,389,245,144
2017,2,A,골목상권,1000158,자양로11길,1423,701,722
2017,2,A,골목상권,1000157,용마산로3길,886,503,383
2017,2,A,골목상권,1000156,용마산로21길,146,63,83
2017,2,A,골목상권,1000155,아차산로78길,2596,1383,1213
2017,2,A,골목상권,1000154,아차산로65길,740,506,234
2017,2,A,골목상권,1000153,아차산로55길,331,187,144
2017,2,A,골목상권,1000152,아차산로51길,270,151,119
2017,2,A,골목상권,1000151,아차산로40길,558,321,237
2017,2,A,골목상권,1000150,면목로17길,247,160,87
2017,2,A,골목상권,1000149,뚝섬로64길,335,178,157
2017,2,A,골목상권,1000148,뚝섬로58길,184,58,126
2017,2,A,골목상권,1000147,뚝섬로54길,222,152,70
2017,2,A,골목상권,1000146,뚝섬로48길,822,356,466
2017,2,A,골목상권,1000145,뚝섬로24길,88,26,62
2017,2,A,골목상권,1000144,뚝섬로23길,120,70,50
2017,2,A,골목상권,1000143,동일로24길,8,2,6
2017,2,A,골목상권,1000142,동일로18길,172,69,103
2017,2,A,골목상권,1000141,능동로4길,239,97,142
2017,2,A,골목상권,1000140,능동로3길,233,113,120
2017,2,A,골목상권,1000139,능동로34길,948,507,441
2017,2,A,골목상권,1000138,능동로19길,326,197,129
2017,2,A,골목상권,1000137,능동로13길,369,124,245
2017,2,A,골목상권,1000136,긴고랑로9길,48,25,23
2017,2,A,골목상권,1000135,긴고랑로8길,206,182,24
2017,2,A,골목상권,1000134,긴고랑로7길,525,255,270
2017,2,A,골목상권,1000133,긴고랑로20길,531,248,283
2017,2,A,골목상권,1000132,광나루로52길,1980,995,985
2017,2,A,골목상권,1000131,광나루로40길,100,50,50
2017,2,A,골목상권,1000130,광나루로37길,281,169,112
2017,2,A,골목상권,1000129,광나루로36길,44,26,18
2017,2,A,골목상권,1000128,광나루로24길,57,30,27
2017,2,A,골목상권,1000127,광나루로12길,1017,565,452
2017,2,A,골목상권,1000126,한림말길,61,33,28
2017,2,A,골목상권,1000124,청계천로10나길,1802,1075,727
2017,2,A,골목상권,1000123,장터길,44,13,31
2017,2,A,골목상권,1000122,용답중앙길,89,49,40
2017,2,A,골목상권,1000121,용답29길,1788,921,867
2017,2,A,골목상권,1000120,왕십리로6길,1411,768,643
2017,2,A,골목상권,1000119,왕십리로31길,100,47,53
2017,2,A,골목상권,1000118,왕십리로26길,3994,2614,1380
2017,2,A,골목상권,1000117,왕십리로21길,169,53,116
2017,2,A,골목상권,1000116,왕십리로14길,2712,1949,763
2017,2,A,골목상권,1000115,아차산로5길,2268,1508,760
2017,2,A,골목상권,1000114,아차산로15길,4290,3038,1252
2017,2,A,골목상권,1000113,아차산로11길,3653,2344,1309
2017,2,A,골목상권,1000112,송정4가길,1103,483,620
2017,2,A,골목상권,1000111,송정12라길,293,182,111
2017,2,A,골목상권,1000110,성수일로6길,2636,1647,989
2017,2,A,골목상권,1000109,성수이로7길,491,290,201
2017,2,A,골목상권,1000108,성수이로18길,2242,1539,703
2017,2,A,골목상권,1000107,성덕정길,902,498,404
2017,2,A,골목상권,1000106,성덕정17길,234,130,104
2017,2,A,골목상권,1000105,서울숲2길,1277,726,551
2017,2,A,골목상권,1000104,상원길,1698,1102,596
2017,2,A,골목상권,1000103,상원12길,181,109,72
2017,2,A,골목상권,1000102,사근동길,30,16,14
2017,2,A,골목상권,1000101,무학봉길,4,2,2
2017,2,A,골목상권,1000100,무학봉28길,152,70,82
2017,2,A,골목상권,1000099,무학로6길,378,224,154
2017,2,A,골목상권,1000098,무수막길,128,59,69
2017,2,A,골목상권,1000097,매봉길,8,5,3
2017,2,A,골목상권,1000096,마조로1길,203,74,129
2017,2,A,골목상권,1000095,마조로16길,822,573,249
2017,2,A,골목상권,1000094,마장로39길,86,37,49
2017,2,A,골목상권,1000093,마장로27길,87,28,59
2017,2,A,골목상권,1000091,둘레9길,409,240,169
2017,2,A,골목상권,1000090,금호산길,431,153,278
2017,2,A,골목상권,1000089,금호산2길,38,16,22
2017,2,A,골목상권,1000088,고산자로6길,14354,5859,8495
2017,2,A,골목상권,1000087,후암로28길,202,91,111
2017,2,A,골목상권,1000086,효창원로39길,51,27,24
2017,2,A,골목상권,1000085,회나무로13길,54,30,24
2017,2,A,골목상권,1000084,한남대로20길,758,419,339
2017,2,A,골목상권,1000082,한강대로7길,536,351,185
2017,2,A,골목상권,1000081,한강대로62길,728,498,230
2017,2,A,골목상권,1000080,한강대로52길,1095,697,398
2017,2,A,골목상권,1000079,한강대로43길,5963,3777,2186
2017,2,A,골목상권,1000078,한강대로15길,1745,351,1394
2017,2,A,골목상권,1000077,한강대로104길,5661,3923,1738
2017,2,A,골목상권,1000076,청파로73길,1163,639,524
2017,2,A,골목상권,1000075,청파로71길,234,116,118
2017,2,A,골목상권,1000074,청파로47나길,173,96,77
2017,2,A,골목상권,1000073,청파로47길,937,430,507
2017,2,A,골목상권,1000072,장문로45길,44,9,35
2017,2,A,골목상권,1000071,이태원로54길,2194,1083,1111
2017,2,A,골목상권,1000070,이태원로27길,603,348,255
2017,2,A,골목상권,1000069,이촌로22길,219,132,87
2017,2,A,골목상권,1000068,원효로89길,907,735,172
2017,2,A,골목상권,1000067,원효로53길,732,444,288
2017,2,A,골목상권,1000066,원효로41길,1524,1059,465
2017,2,A,골목상권,1000065,원효로19길,995,689,306
2017,2,A,골목상권,1000064,우사단로4길,180,128,52
2017,2,A,골목상권,1000063,우사단로14길,1768,874,894
2017,2,A,골목상권,1000062,우사단로10길,80,35,45
2017,2,A,골목상권,1000061,신흥로20길,142,78,64
2017,2,A,골목상권,1000060,소월로20길,127,38,89
2017,2,A,골목상권,1000059,서빙고로71길,468,293,175
2017,2,A,골목상권,1000058,백범로90길,284,175,109
2017,2,A,골목상권,1000057,백범로79길,1045,643,402
2017,2,A,골목상권,1000056,두텁바위로1길,2325,1307,1018
2017,2,A,골목상권,1000055,대사관로34길,278,144,134
2017,2,A,골목상권,1000054,녹사평대로46길,65,41,24
2017,2,A,골목상권,1000053,녹사평대로40나길,54,29,25
2017,2,A,골목상권,1000052,녹사평대로32길,285,153,132
2017,2,A,골목상권,1000051,녹사평대로26길,2050,1124,926
2017,2,A,골목상권,1000050,녹사평대로11길,300,203,97
2017,2,A,골목상권,1000049,퇴계로90길,588,220,368
2017,2,A,골목상권,1000048,퇴계로8길,2402,1277,1125
2017,2,A,골목상권,1000047,퇴계로56길,1049,830,219
2017,2,A,골목상권,1000046,퇴계로46길,1988,834,1154
2017,2,A,골목상권,1000045,퇴계로18길,2984,1327,1657
2017,2,A,골목상권,1000044,퇴계로12길,950,439,511
2017,2,A,골목상권,1000043,청구로1길,228,92,136
2017,2,A,골목상권,1000042,청구로17길,1671,761,910
2017,2,A,골목상권,1000041,장충단로8길,3477,1225,2252
2017,2,A,골목상권,1000040,삼일대로4길,1013,602,411
2017,2,A,골목상권,1000039,명동길,36746,18217,18529
2017,2,A,골목상권,1000037,동호로20길,805,305,500
2017,2,A,골목상권,1000036,동호로15길,4224,2196,2028
2017,2,A,골목상권,1000035,동호로11길,15,9,6
2017,2,A,골목상권,1000034,동호로10길,1536,670,866
2017,2,A,골목상권,1000033,다산로39길,1230,680,550
2017,2,A,골목상권,1000032,다산로38길,1583,763,820
2017,2,A,골목상권,1000031,다산로36길,76,45,31
2017,2,A,골목상권,1000030,다산로33길,446,207,239
2017,2,A,골목상권,1000029,난계로21길,240,166,74
2017,2,A,골목상권,1000028,난계로11길,1679,1034,645
2017,2,A,골목상권,1000027,필운대로1길,5,1,4
2017,2,A,골목상권,1000026,평창길,183,93,90
2017,2,A,골목상권,1000025,통일로12길,244,100,144
2017,2,A,골목상권,1000024,창신길,264,70,194
2017,2,A,골목상권,1000023,창신5길,8,3,5
2017,2,A,골목상권,1000022,창신2길,63,31,32
2017,2,A,골목상권,1000021,창경궁로35길,1338,358,980
2017,2,A,골목상권,1000020,지봉로8길,175,94,81
2017,2,A,골목상권,1000019,종로65길,577,260,317
2017,2,A,골목상권,1000016,자하문로7길,531,326,205
2017,2,A,골목상권,1000015,이화장길,1887,915,972
2017,2,A,골목상권,1000014,율곡로16길,99,87,12
2017,2,A,골목상권,1000013,율곡로10길,2269,1674,595
2017,2,A,골목상권,1000012,옥인길,460,195,265
2017,2,A,골목상권,1000011,숭인동길,17,7,10
2017,2,A,골목상권,1000010,성균관로5길,138,83,55
2017,2,A,골목상권,1000009,삼청로5길,407,132,275
2017,2,A,골목상권,1000008,북촌로5나길,1639,1129,510
2017,2,A,골목상권,1000007,북촌로5길,61,31,30
2017,2,A,골목상권,1000006,북촌로11길,19,10,9
2017,2,A,골목상권,1000005,백석동길,122,68,54
2017,2,A,골목상권,1000004,명륜길,16,9,7
2017,2,A,골목상권,1000003,돈화문로11가길,1100,606,494
2017,2,A,골목상권,1000001,계동길,840,360,480
2017,1,U,관광특구,1001496,강남 마이스 관광특구,22217,12970,9247
2017,1,U,관광특구,1001495,잠실 관광특구,27304,16146,11158
2017,1,U,관광특구,1001494,종로?청계 관광특구,30331,18443,11888
2017,1,U,관광특구,1001493,동대문패션타운 관광특구,9790,5637,4153
2017,1,U,관광특구,1001492,명동 남대문 북창동 다동 무교동 관광특구,168933,86535,82398
2017,1,U,관광특구,1001491,이태원 관광특구,5707,3283,2424
2017,1,R,전통시장,1001490,길동복조리시장,588,376,212
2017,1,R,전통시장,1001489,둔촌역전통시장,173,93,80
2017,1,R,전통시장,1001488,성내골목시장,6,2,4
2017,1,R,전통시장,1001487,천호시장,19,11,8
2017,1,R,전통시장,1001483,암사종합시장,717,321,396
2017,1,R,전통시장,1001482,고덕전통시장,370,358,12
2017,1,R,전통시장,1001481,명일골목시장,453,154,299
2017,1,R,전통시장,1001480,새마을시장,404,219,185
2017,1,R,전통시장,1001479,석촌시장,190,125,65
2017,1,R,전통시장,1001478,방이시장,660,416,244
2017,1,R,전통시장,1001477,마천시장,249,63,186
2017,1,R,전통시장,1001476,풍납시장,14,5,9
2017,1,R,전통시장,1001475,강남개포시장,41,33,8
2017,1,R,전통시장,1001474,도곡시장,489,215,274
2017,1,R,전통시장,1001471,영동전통시장,3023,2237,786
2017,1,R,전통시장,1001466,미성동도깨비시장,432,186,246
2017,1,R,전통시장,1001465,신신림시장,2,2,0
2017,1,R,전통시장,1001464,삼성동시장,104,45,59
2017,1,R,전통시장,1001463,신림중앙시장,12,7,5
2017,1,R,전통시장,1001462,강남골목시장,293,145,148
2017,1,R,전통시장,1001460,관악신사시장,293,228,65
2017,1,R,전통시장,1001459,신원시장,365,153,212
2017,1,R,전통시장,1001458,인헌시장,257,92,165
2017,1,R,전통시장,1001456,봉천현대시장,9,4,5
2017,1,R,전통시장,1001454,봉천제일종합시장,49,24,25
2017,1,R,전통시장,1001453,낙성대시장,20,11,9
2017,1,R,전통시장,1001452,중부시장,186,64,122
2017,1,R,전통시장,1001450,남성역골목시장,512,237,275
2017,1,R,전통시장,1001449,남성사계시장,1874,821,1053
2017,1,R,전통시장,1001448,흑석시장,180,71,109
2017,1,R,전통시장,1001447,상도4동도깨비골목시장,312,76,236
2017,1,R,전통시장,1001445,영도시장,69,32,37
2017,1,R,전통시장,1001441,본동인정시장,116,56,60
2017,1,R,전통시장,1001439,대림중앙시장,29,18,11
2017,1,R,전통시장,1001438,우리시장,15,7,8
2017,1,R,전통시장,1001437,영진시장A동,36,29,7
2017,1,R,전통시장,1001436,사러가시장,24,8,16
2017,1,R,전통시장,1001431,영등포청과시장,189,121,68
2017,1,R,전통시장,1001430,영등포전통시장,4030,1988,2042
2017,1,R,전통시장,1001429,은행나무시장,39,8,31
2017,1,R,전통시장,1001427,현대시장,56,16,40
2017,1,R,전통시장,1001424,남문시장,288,111,177
2017,1,R,전통시장,1001423,독산동 우시장,138,55,83
2017,1,R,전통시장,1001421,개봉중앙시장,7,3,4
2017,1,R,전통시장,1001419,가리봉시장,18,10,8
2017,1,R,전통시장,1001418,남구로시장,17,3,14
2017,1,R,전통시장,1001417,구로시장,47,17,30
2017,1,R,전통시장,1001415,방신전통시장,128,111,17
2017,1,R,전통시장,1001414,송화골목시장,500,188,312
2017,1,R,전통시장,1001413,까치산시장,35,24,11
2017,1,R,전통시장,1001411,남부골목시장,200,87,113
2017,1,R,전통시장,1001409,화곡중앙골목시장,2,2,0
2017,1,R,전통시장,1001407,등마루시장,814,464,350
2017,1,R,전통시장,1001406,신정3동골목시장,211,103,108
2017,1,R,전통시장,1001405,신정2동골목시장,9,6,3
2017,1,R,전통시장,1001402,신월6동골목시장,237,110,127
2017,1,R,전통시장,1001401,신곡종합시장,12,9,3
2017,1,R,전통시장,1001400,신월3동골목시장,52,15,37
2017,1,R,전통시장,1001399,경창시장,185,81,104
2017,1,R,전통시장,1001398,월정로시장,113,67,46
2017,1,R,전통시장,1001397,신영시장,50,24,26
2017,1,R,전통시장,1001396,목4동시장,235,81,154
2017,1,R,전통시장,1001395,목3동시장,714,346,368
2017,1,R,전통시장,1001394,목2동시장,239,109,130
2017,1,R,전통시장,1001393,마포농수산물시장,504,309,195
2017,1,R,전통시장,1001391,망원월드컵시장,13,9,4
2017,1,R,전통시장,1001390,망원시장,34,18,16
2017,1,R,전통시장,1001386,신수시장,116,84,32
2017,1,R,전통시장,1001385,아현시장,22,3,19
2017,1,R,전통시장,1001374,대림골목시장,300,98,202
2017,1,R,전통시장,1001367,상계중앙시장,26,11,15
2017,1,R,전통시장,1001364,방학동도깨비시장,150,57,93
2017,1,R,전통시장,1001363,쌍문역골목시장,70,33,37
2017,1,R,전통시장,1001361,신도봉시장,24,15,9
2017,1,R,전통시장,1001359,창동신창시장,152,65,87
2017,1,R,전통시장,1001358,수유북부시장,12,4,8
2017,1,R,전통시장,1001357,장미원골목시장,74,44,30
2017,1,R,전통시장,1001356,수유중앙시장,136,74,62
2017,1,R,전통시장,1001355,강북종합시장,75,30,45
2017,1,R,전통시장,1001354,우이시장,146,57,89
2017,1,R,전통시장,1001353,수유전통시장,448,135,313
2017,1,R,전통시장,1001352,번동북부골목시장,80,45,35
2017,1,R,전통시장,1001351,솔샘시장,105,40,65
2017,1,R,전통시장,1001349,방천골목시장,78,25,53
2017,1,R,전통시장,1001347,석관황금시장,53,17,36
2017,1,R,전통시장,1001343,장위전통시장,181,66,115
2017,1,R,전통시장,1001340,정릉시장,36,15,21
2017,1,R,전통시장,1001339,정릉아리랑시장,2,1,1
2017,1,R,전통시장,1001338,돈암제일시장,59,24,35
2017,1,R,전통시장,1001336,우림골목시장,214,101,113
2017,1,R,전통시장,1001335,묵1동도깨비시장,285,131,154
2017,1,R,전통시장,1001334,태능시장,4,3,1
2017,1,R,전통시장,1001333,중화제일시장,24,1,23
2017,1,R,전통시장,1001332,사가정시장,245,185,60
2017,1,R,전통시장,1001330,동원시장,80,33,47
2017,1,R,전통시장,1001329,동부골목시장,92,31,61
2017,1,R,전통시장,1001326,회기시장,127,57,70
2017,1,R,전통시장,1001323,답십리시장,29,10,19
2017,1,R,전통시장,1001321,답십리현대시장,89,75,14
2017,1,R,전통시장,1001319,청량리종합시장,7,5,2
2017,1,R,전통시장,1001317,청량리농수산물시장,20,16,4
2017,1,R,전통시장,1001316,서울약령시장,1356,814,542
2017,1,R,전통시장,1001313,청량리수산시장,233,117,116
2017,1,R,전통시장,1001310,구의시장,97,60,37
2017,1,R,전통시장,1001309,조양시장,91,49,42
2017,1,R,전통시장,1001308,영동교골목시장,14,10,4
2017,1,R,전통시장,1001307,능동로골목시장,269,239,30
2017,1,R,전통시장,1001304,자양골목시장,94,47,47
2017,1,R,전통시장,1001301,중곡제일시장,140,77,63
2017,1,R,전통시장,1001299,한아름시장,133,71,62
2017,1,R,전통시장,1001298,성동용답상가시장,296,156,140
2017,1,R,전통시장,1001297,뚝도시장,31,11,20
2017,1,R,전통시장,1001296,금남시장,26,14,12
2017,1,R,전통시장,1001295,행당시장,237,115,122
2017,1,R,전통시장,1001294,마장축산물시장,1520,1001,519
2017,1,R,전통시장,1001289,용문전통시장,40,23,17
2017,1,R,전통시장,1001286,후암시장,51,19,32
2017,1,R,전통시장,1001285,합동(새벽)시장,2330,1295,1035
2017,1,R,전통시장,1001284,서울중앙시장,238,166,72
2017,1,R,전통시장,1001283,백학시장,454,236,218
2017,1,R,전통시장,1001282,약수시장,1689,679,1010
2017,1,R,전통시장,1001281,청평화시장,2995,1890,1105
2017,1,R,전통시장,1001280,제일평화시장,515,315,200
2017,1,R,전통시장,1001278,남평화시장,198,123,75
2017,1,R,전통시장,1001277,방산종합시장,1825,1178,647
2017,1,R,전통시장,1001275,인현시장,1175,746,429
2017,1,R,전통시장,1001274,신중부시장,2452,1643,809
2017,1,R,전통시장,1001273,남대문시장,7087,3729,3358
2017,1,R,전통시장,1001271,동묘시장,931,596,335
2017,1,R,전통시장,1001270,창신골목시장,232,122,110
2017,1,R,전통시장,1001268,충신시장,340,206,134
2017,1,R,전통시장,1001267,종로신진시장,28,11,17
2017,1,R,전통시장,1001266,동대문종합시장,344,186,158
2017,1,R,전통시장,1001265,광장시장,199,142,57
2017,1,D,발달상권,1001263,서울 노원구 노원역_3,789,318,471
2017,1,D,발달상권,1001261,서울 노원구 노원역_1,954,308,646
2017,1,D,발달상권,1001260,창동역,2418,1549,869
2017,1,D,발달상권,1001259,서울 강북구 수유역_3,64,31,33
2017,1,D,발달상권,1001257,서울 강북구 수유역_2,4155,2143,2012
2017,1,D,발달상권,1001256,서울 강북구 수유역_1,109,86,23
2017,1,D,발달상권,1001255,서울 은평구 연신내역_3,634,192,442
2017,1,D,발달상권,1001254,서울 은평구 연신내역_2,444,178,266
2017,1,D,발달상권,1001253,서울 은평구 연신내역_1,89,38,51
2017,1,D,발달상권,1001252,서울 성북구 미아삼거리역_2,522,230,292
2017,1,D,발달상권,1001251,서울 강북구 미아삼거리역_1,526,185,341
2017,1,D,발달상권,1001250,서울 은평구 불광역_3,55,20,35
2017,1,D,발달상권,1001249,서울 은평구 불광역_2,72,28,44
2017,1,D,발달상권,1001248,서울 은평구 불광역_1,253,102,151
2017,1,D,발달상권,1001247,미아사거리_2,99,22,77
2017,1,D,발달상권,1001246,미아사거리_1,559,251,308
2017,1,D,발달상권,1001245,서울 성북구 성신여대입구역,4901,2999,1902
2017,1,D,발달상권,1001244,경희대학교,377,169,208
2017,1,D,발달상권,1001243,서울 성북구 안암역,98,58,40
2017,1,D,발달상권,1001242,혜화역 대학로_3,1703,823,880
2017,1,D,발달상권,1001241,혜화역 대학로_2,1367,786,581
2017,1,D,발달상권,1001240,혜화역 대학로_1,1307,657,650
2017,1,D,발달상권,1001239,디지털미디어시티,22582,13467,9115
2017,1,D,발달상권,1001238,서울 동대문구 청량리역,3236,2064,1172
2017,1,D,발달상권,1001236,서울 종로구 안국역_2,736,290,446
2017,1,D,발달상권,1001235,서울 종로구 안국역_1,11654,9505,2149
2017,1,D,발달상권,1001234,서울 종로구 경복궁역_1,227,89,138
2017,1,D,발달상권,1001233,서울 종로구 종로3가역_3,3218,1728,1490
2017,1,D,발달상권,1001232,서울 종로구 종로3가역_2,1846,1006,840
2017,1,D,발달상권,1001231,서울 동대문구 신설동역_2,4363,2173,2190
2017,1,D,발달상권,1001230,인사동,21106,13041,8065
2017,1,D,발달상권,1001229,서울 종로구 종로5가역_4,683,368,315
2017,1,D,발달상권,1001228,서울 종로구 종로5가역_3,5230,3538,1692
2017,1,D,발달상권,1001227,종로구청,15806,9092,6714
2017,1,D,발달상권,1001226,서울 종로구 종로5가역_2,18935,12659,6276
2017,1,D,발달상권,1001225,신설동역,753,444,309
2017,1,D,발달상권,1001224,서울 동대문구 신설동역_1,2,2,0
2017,1,D,발달상권,1001223,서울 종로구 광화문역_2,52781,32166,20615
2017,1,D,발달상권,1001222,동묘앞역,62,40,22
2017,1,D,발달상권,1001221,장안동사거리,535,260,275
2017,1,D,발달상권,1001220,서울 종로구 동대문역_2,1053,553,500
2017,1,D,발달상권,1001218,동대문시장_2,485,305,180
2017,1,D,발달상권,1001217,서울 종로구 종로5가역_1,55,40,15
2017,1,D,발달상권,1001216,서울 종로구 종로3가역_1,3445,1488,1957
2017,1,D,발달상권,1001215,서울 종로구 광화문역_1,2295,1489,806
2017,1,D,발달상권,1001214,종각역,20605,13388,7217
2017,1,D,발달상권,1001213,종각역 젊음의 거리,2111,935,1176
2017,1,D,발달상권,1001212,서대문구 서대문역_1,355,244,111
2017,1,D,발달상권,1001211,동대문시장_1,413,222,191
2017,1,D,발달상권,1001210,시청역_2,22170,14245,7925
2017,1,D,발달상권,1001209,서울시청,23470,11511,11959
2017,1,D,발달상권,1001208,서울 중구 을지로3가역_2,7984,5201,2783
2017,1,D,발달상권,1001207,서울 중구 신당역_2,1365,677,688
2017,1,D,발달상권,1001206,서대문구 서대문역_2,2006,1366,640
2017,1,D,발달상권,1001205,동대문역사문화공원역,3918,2758,1160
2017,1,D,발달상권,1001204,서울 중구 을지로3가역_1,14332,9607,4725
2017,1,D,발달상권,1001203,명동거리,25479,11847,13632
2017,1,D,발달상권,1001202,롯데백화점,40328,22703,17625
2017,1,D,발달상권,1001201,서울 중구 신당역_1,1042,671,371
2017,1,D,발달상권,1001200,북창동,7810,4733,3077
2017,1,D,발달상권,1001199,서울 중구 충무로역_2,14143,6245,7898
2017,1,D,발달상권,1001198,서울 강서구 송정역,763,512,251
2017,1,D,발달상권,1001197,장한평역_2,11959,9580,2379
2017,1,D,발달상권,1001196,시청역_1,55429,33447,21982
2017,1,D,발달상권,1001195,왕십리역_2,655,281,374
2017,1,D,발달상권,1001194,서울 강서구 발산역,792,471,321
2017,1,D,발달상권,1001193,장한평역_1,2400,1569,831
2017,1,D,발달상권,1001192,서울 중구 충무로역_1,3168,2226,942
2017,1,D,발달상권,1001190,장한평역,2188,1538,650
2017,1,D,발달상권,1001189,서울 중구 명동역,3694,1878,1816
2017,1,D,발달상권,1001188,장충동 족발거리,198,93,105
2017,1,D,발달상권,1001187,한양시장,277,140,137
2017,1,D,발달상권,1001186,서울 서대문구 이대역,1275,511,764
2017,1,D,발달상권,1001185,서울 서대문구 신촌역,3003,1231,1772
2017,1,D,발달상권,1001184,서울 마포구 홍대입구역_3,411,272,139
2017,1,D,발달상권,1001183,서울 마포구 홍대입구역_2,3152,1229,1923
2017,1,D,발달상권,1001182,홍익대학교 주변,15066,7581,7485
2017,1,D,발달상권,1001181,서울 광진구 군자역,181,106,75
2017,1,D,발달상권,1001180,신촌역,236,116,120
2017,1,D,발달상권,1001179,강서구청,3455,2273,1182
2017,1,D,발달상권,1001178,서울 마포구 홍대입구역_1,821,462,359
2017,1,D,발달상권,1001175,서울 강동구 고덕역,490,268,222
2017,1,D,발달상권,1001173,서울 강동구 명일역,856,356,500
2017,1,D,발달상권,1001172,어린이대공원역,97,61,36
2017,1,D,발달상권,1001171,서울 마포구 공덕역_2,4124,2406,1718
2017,1,D,발달상권,1001170,공덕역,7228,4383,2845
2017,1,D,발달상권,1001169,서울 용산구 숙대입구역,4416,3093,1323
2017,1,D,발달상권,1001168,남영역,14242,6249,7993
2017,1,D,발달상권,1001167,서울 마포구 공덕역_1,4647,2279,2368
2017,1,D,발달상권,1001166,서울 마포구 마포역_2,1240,701,539
2017,1,D,발달상권,1001165,서울 광진구 건대입구역_2,2838,993,1845
2017,1,D,발달상권,1001164,서울 마포구 마포역_1,11532,6888,4644
2017,1,D,발달상권,1001163,서울 강동구 천호역_2,3826,1909,1917
2017,1,D,발달상권,1001162,서울 광진구 건대입구역_1,944,457,487
2017,1,D,발달상권,1001161,건대입구역,722,386,336
2017,1,D,발달상권,1001160,서울 광진구 구의역,865,529,336
2017,1,D,발달상권,1001159,서울 강동구 천호역,1029,496,533
2017,1,D,발달상권,1001158,당산역_2,5271,3295,1976
2017,1,D,발달상권,1001156,서울 강동구 길동역,1208,696,512
2017,1,D,발달상권,1001155,용산 전자상가_5,2380,1741,639
2017,1,D,발달상권,1001153,당산역_1,1102,696,406
2017,1,D,발달상권,1001152,서울 광진구 강변역,2126,1743,383
2017,1,D,발달상권,1001151,용산 전자상가_3,2451,1760,691
2017,1,D,발달상권,1001150,서울 용산구 이태원역,642,389,253
2017,1,D,발달상권,1001149,한남오거리,664,339,325
2017,1,D,발달상권,1001147,용산 전자상가_2,470,378,92
2017,1,D,발달상권,1001146,용산구청,99,68,31
2017,1,D,발달상권,1001145,용산 전자상가_1,8011,6075,1936
2017,1,D,발달상권,1001144,국회의사당역_2,40592,24030,16562
2017,1,D,발달상권,1001143,서울 용산구 신용산역,458,209,249
2017,1,D,발달상권,1001142,국회의사당역_1,5643,4377,1266
2017,1,D,발달상권,1001141,압구정 로데오거리_2,15549,6626,8923
2017,1,D,발달상권,1001140,서울 강남구 압구정역,10779,4899,5880
2017,1,D,발달상권,1001139,서울 영등포구 영등포구청역,3655,1134,2521
2017,1,D,발달상권,1001138,압구정 로데오거리_1,7361,2408,4953
2017,1,D,발달상권,1001137,서울 강동구 둔촌동역,53,15,38
2017,1,D,발달상권,1001136,오목교역,206,88,118
2017,1,D,발달상권,1001135,신사동 가로수길,21404,10157,11247
2017,1,D,발달상권,1001134,서울 영등포구 여의도역_2,48066,31797,16269
2017,1,D,발달상권,1001133,청담사거리_3,1456,503,953
2017,1,D,발달상권,1001132,영등포유통상가,2068,1285,783
2017,1,D,발달상권,1001131,청담역_2,1310,946,364
2017,1,D,발달상권,1001130,청담역_1,187,146,41
2017,1,D,발달상권,1001129,청담사거리_2,987,736,251
2017,1,D,발달상권,1001127,서울 영등포구 여의도역_1,53560,31778,21782
2017,1,D,발달상권,1001125,학동사거리_2,3104,1807,1297
2017,1,D,발달상권,1001124,서울 영등포구 영등포시장역,328,254,74
2017,1,D,발달상권,1001123,학동사거리_1,4086,2051,2035
2017,1,D,발달상권,1001122,여의도 시범아파트앞,2243,1442,801
2017,1,D,발달상권,1001121,영등포역_3,815,480,335
2017,1,D,발달상권,1001120,도산공원사거리_1,9677,5729,3948
2017,1,D,발달상권,1001119,영등포역_2,1152,629,523
2017,1,D,발달상권,1001118,문래동 주민센터,76,65,11
2017,1,D,발달상권,1001117,강남구 신사역_2,8379,5347,3032
2017,1,D,발달상권,1001115,서울 강남구 강남구청역_2,4618,2953,1665
2017,1,D,발달상권,1001114,강남구 신사역_1,2574,1128,1446
2017,1,D,발달상권,1001113,서울 동작구 노량진1동_1,31,19,12
2017,1,D,발달상권,1001112,서울 강남구 학동역_3,9202,5236,3966
2017,1,D,발달상권,1001111,서울 강남구 강남구청역_1,3057,1910,1147
2017,1,D,발달상권,1001110,잠실역,5718,4339,1379
2017,1,D,발달상권,1001109,강남구 논현역_4,7327,3722,3605
2017,1,D,발달상권,1001108,학동역,1409,575,834
2017,1,D,발달상권,1001107,방이동 먹자골목,4916,3118,1798
2017,1,D,발달상권,1001106,서울 강남구 학동역_2,5486,2854,2632
2017,1,D,발달상권,1001105,서울 동작구 노량진역,3618,2085,1533
2017,1,D,발달상권,1001104,삼성역_3,8659,5031,3628
2017,1,D,발달상권,1001103,코엑스,22217,12970,9247
2017,1,D,발달상권,1001102,서울 강남구 학동역_1,5071,3253,1818
2017,1,D,발달상권,1001101,선정릉역_2,6768,4248,2520
2017,1,D,발달상권,1001100,강남구 논현역_3,1498,853,645
2017,1,D,발달상권,1001099,포스코사거리_2,7170,4626,2544
2017,1,D,발달상권,1001098,포스코사거리_1,49794,33323,16471
2017,1,D,발달상권,1001097,잠실역 롯데월드,3312,1662,1650
2017,1,D,발달상권,1001096,신도림역,3445,1913,1532
2017,1,D,발달상권,1001095,강남구 논현역_2,8038,3913,4125
2017,1,D,발달상권,1001094,선정릉역_1,1734,1219,515
2017,1,D,발달상권,1001093,신천역,6159,3308,2851
2017,1,D,발달상권,1001092,강남구 논현역_1,3678,2102,1576
2017,1,D,발달상권,1001091,삼성역_2,17789,10599,7190
2017,1,D,발달상권,1001090,삼정역_2,2864,1305,1559
2017,1,D,발달상권,1001089,삼정역_1,2888,1567,1321
2017,1,D,발달상권,1001088,삼성역_1,30235,20031,10204
2017,1,D,발달상권,1001087,서울 강남구 선릉역_2,7549,4891,2658
2017,1,D,발달상권,1001086,고속터미널역,15664,4734,10930
2017,1,D,발달상권,1001085,서울 서초구 강남역,34665,19651,15014
2017,1,D,발달상권,1001084,서울 강남구 선릉역_1,19335,8122,11213
2017,1,D,발달상권,1001082,선릉역_2,20206,10619,9587
2017,1,D,발달상권,1001081,서울 강남구 역삼역_2,26179,20575,5604
2017,1,D,발달상권,1001080,서울 송파구 석촌역_1,39,28,11
2017,1,D,발달상권,1001078,서울 강남구 강남역_2,5718,3389,2329
2017,1,D,발달상권,1001077,선릉역_1,53672,28879,24793
2017,1,D,발달상권,1001076,구로역,161,96,65
2017,1,D,발달상권,1001075,역삼역_2,4289,2416,1873
2017,1,D,발달상권,1001074,대림역_2,6960,5243,1717
2017,1,D,발달상권,1001073,서울 강남구 역삼역_1,26619,16617,10002
2017,1,D,발달상권,1001072,신대방삼거리역,295,133,162
2017,1,D,발달상권,1001071,서울 강남구 한티역,1079,407,672
2017,1,D,발달상권,1001070,은마아파트입구사거리_4,88,52,36
2017,1,D,발달상권,1001067,오류동역,1520,756,764
2017,1,D,발달상권,1001066,서울 강남구 강남역,39329,18700,20629
2017,1,D,발달상권,1001063,교대역_4,5609,3133,2476
2017,1,D,발달상권,1001062,서울 강남구 강남역_1,131760,97349,34411
2017,1,D,발달상권,1001061,방배동카페골목,109,46,63
2017,1,D,발달상권,1001060,가락시장,16218,10235,5983
2017,1,D,발달상권,1001059,교대역_3,4386,2689,1697
2017,1,D,발달상권,1001058,역삼역_1,1750,1110,640
2017,1,D,발달상권,1001057,교대역_2,3525,2243,1282
2017,1,D,발달상권,1001056,서울 송파구 가락시장역,5325,3543,1782
2017,1,D,발달상권,1001055,서울 서초구 서초역,12162,5027,7135
2017,1,D,발달상권,1001054,서울 강남구 대치역_2,1479,889,590
2017,1,D,발달상권,1001052,뱅뱅사거리_2,24941,15931,9010
2017,1,D,발달상권,1001051,보라매공원,14103,8045,6058
2017,1,D,발달상권,1001050,교대역_1,13196,7905,5291
2017,1,D,발달상권,1001049,개봉동 현대아파트 인근,155,72,83
2017,1,D,발달상권,1001048,뱅뱅사거리,7125,4742,2383
2017,1,D,발달상권,1001047,뱅뱅사거리_1,10353,7297,3056
2017,1,D,발달상권,1001046,서울 관악구 신림역_4,920,434,486
2017,1,D,발달상권,1001045,동작구 총신대입구역_1,214,98,116
2017,1,D,발달상권,1001044,양재역_3,3515,2418,1097
2017,1,D,발달상권,1001043,동작구 총신대입구역_2,841,360,481
2017,1,D,발달상권,1001042,서울 서초구 남부터미널역_3,1526,870,656
2017,1,D,발달상권,1001041,서울 강남구 수서역,19103,11144,7959
2017,1,D,발달상권,1001039,서울 서초구 남부터미널역_2,11569,5628,5941
2017,1,D,발달상권,1001038,구로디지탈1단지,65309,41753,23556
2017,1,D,발달상권,1001037,양재역,119,57,62
2017,1,D,발달상권,1001035,매봉역,538,229,309
2017,1,D,발달상권,1001034,서울 서초구 방배역,3625,2132,1493
2017,1,D,발달상권,1001033,서울 서초구 남부터미널역_1,552,397,155
2017,1,D,발달상권,1001032,서울 관악구 신림역_2,31,15,16
2017,1,D,발달상권,1001031,서울 관악구 신림역_1,1925,920,1005
2017,1,D,발달상권,1001030,양재역_2,8950,5008,3942
2017,1,D,발달상권,1001029,양재역_1,1022,722,300
2017,1,D,발달상권,1001028,서울 관악구 서울대입구역_2,42,4,38
2017,1,D,발달상권,1001027,가산디지털단지역_3,31303,18640,12663
2017,1,D,발달상권,1001026,구로디지털단지역,2148,1390,758
2017,1,D,발달상권,1001025,서울 관악구 서울대입구역_1,1963,832,1131
2017,1,D,발달상권,1001024,관악구 사당역_1,3907,1603,2304
2017,1,D,발달상권,1001023,가산디지털단지역_2,61605,36900,24705
2017,1,D,발달상권,1001022,관악구 사당역_2,345,181,164
2017,1,D,발달상권,1001021,가산디지털단지역_1,26323,17730,8593
2017,1,D,발달상권,1001020,장지역,4333,2747,1586
2017,1,D,발달상권,1001019,포이사거리_1,5741,3052,2689
2017,1,D,발달상권,1001018,포이사거리_2,8907,6328,2579
2017,1,D,발달상권,1001016,서울 관악구 대학동_1,82,49,33
2017,1,D,발달상권,1001015,서울 금천구 독산1동_1,3007,2040,967
2017,1,D,발달상권,1001013,양재 화물트럭터미널앞_2,178,77,101
2017,1,D,발달상권,1001012,양재 화물트럭터미널앞_1,4379,3453,926
2017,1,D,발달상권,1001011,서울 금천구 시흥1동_4,931,471,460
2017,1,A,골목상권,1001010,풍성로37가길,36,16,20
2017,1,A,골목상권,1001009,천호옛길,556,365,191
2017,1,A,골목상권,1001008,천호옛14길,594,280,314
2017,1,A,골목상권,1001007,천호대로219길,918,557,361
2017,1,A,골목상권,1001006,천호대로197길,17,5,12
2017,1,A,골목상권,1001005,천호대로187길,874,503,371
2017,1,A,골목상권,1001004,천호대로170길,416,173,243
2017,1,A,골목상권,1001003,천호대로162길,1293,928,365
2017,1,A,골목상권,1001002,천중로51길,436,228,208
2017,1,A,골목상권,1001001,천중로39길,584,206,378
2017,1,A,골목상권,1001000,진황도로47길,1359,694,665
2017,1,A,골목상권,1000999,진황도로27길,490,286,204
2017,1,A,골목상권,1000998,올림픽로98길,41,18,23
2017,1,A,골목상권,1000997,올림픽로80길,2,1,1
2017,1,A,골목상권,1000995,올림픽로77길,13,6,7
2017,1,A,골목상권,1000994,올림픽로71길,405,305,100
2017,1,A,골목상권,1000993,올림픽로48길,5800,3487,2313
2017,1,A,골목상권,1000992,양재대로96길,1313,784,529
2017,1,A,골목상권,1000991,양재대로95길,718,385,333
2017,1,A,골목상권,1000990,양재대로91길,1187,658,529
2017,1,A,골목상권,1000989,양재대로133길,309,112,197
2017,1,A,골목상권,1000988,양재대로124길,632,396,236
2017,1,A,골목상권,1000987,양재대로116길,218,91,127
2017,1,A,골목상권,1000986,양재대로101길,1196,691,505
2017,1,A,골목상권,1000985,암사길,368,163,205
2017,1,A,골목상권,1000984,성안로3길,1614,1048,566
2017,1,A,골목상권,1000983,성내로5길,1084,552,532
2017,1,A,골목상권,1000982,상일로5길,56,33,23
2017,1,A,골목상권,1000981,상암로5길,625,275,350
2017,1,A,골목상권,1000980,상암로51길,762,324,438
2017,1,A,골목상권,1000979,상암로4길,267,212,55
2017,1,A,골목상권,1000978,상암로14길,485,304,181
2017,1,A,골목상권,1000977,명일로13길,121,46,75
2017,1,A,골목상권,1000976,동남로85길,130,67,63
2017,1,A,골목상권,1000975,동남로82길,10,3,7
2017,1,A,골목상권,1000974,동남로65길,72,24,48
2017,1,A,골목상권,1000973,구천면로42길,384,187,197
2017,1,A,골목상권,1000972,구천면로41길,603,255,348
2017,1,A,골목상권,1000971,구천면로36길,61,38,23
2017,1,A,골목상권,1000969,고덕로25길,22,12,10
2017,1,A,골목상권,1000968,고덕로10길,191,86,105
2017,1,A,골목상권,1000967,강동대로53길,900,498,402
2017,1,A,골목상권,1000966,풍성로25길,788,287,501
2017,1,A,골목상권,1000965,오금로46길,1421,721,700
2017,1,A,골목상권,1000964,오금로36길,1270,958,312
2017,1,A,골목상권,1000963,오금로11길,2197,1415,782
2017,1,A,골목상권,1000962,양재대로72길,693,378,315
2017,1,A,골목상권,1000961,양재대로71길,1292,776,516
2017,1,A,골목상권,1000960,양재대로64길,1522,596,926
2017,1,A,골목상권,1000959,양재대로62길,6352,3824,2528
2017,1,A,골목상권,1000958,송파대로30길,1749,1116,633
2017,1,A,골목상권,1000957,송이로36길,2070,1497,573
2017,1,A,골목상권,1000956,송이로32길,773,415,358
2017,1,A,골목상권,1000955,송이로23길,1272,788,484
2017,1,A,골목상권,1000954,삼전로13길,1626,813,813
2017,1,A,골목상권,1000953,백제고분로50길,3386,1663,1723
2017,1,A,골목상권,1000952,백제고분로46길,1791,1146,645
2017,1,A,골목상권,1000951,백제고분로45길,498,333,165
2017,1,A,골목상권,1000950,백제고분로42길,132,76,56
2017,1,A,골목상권,1000949,백제고분로39길,1583,1110,473
2017,1,A,골목상권,1000948,백제고분로34길,1727,1128,599
2017,1,A,골목상권,1000947,백제고분로33길,1017,645,372
2017,1,A,골목상권,1000946,백제고분로32길,1092,462,630
2017,1,A,골목상권,1000945,백제고분로31길,336,212,124
2017,1,A,골목상권,1000944,백제고분로22길,1009,584,425
2017,1,A,골목상권,1000943,백제고분로21길,206,149,57
2017,1,A,골목상권,1000942,마천로51길,130,56,74
2017,1,A,골목상권,1000941,동남로20길,155,92,63
2017,1,A,골목상권,1000940,거마로20길,486,203,283
2017,1,A,골목상권,1000939,학동로77길,2965,1547,1418
2017,1,A,골목상권,1000938,학동로6길,1919,944,975
2017,1,A,골목상권,1000937,학동로56길,907,505,402
2017,1,A,골목상권,1000936,학동로38길,6646,4231,2415
2017,1,A,골목상권,1000935,테헤란로81길,573,207,366
2017,1,A,골목상권,1000934,일원로9길,558,293,265
2017,1,A,골목상권,1000933,일원로3길,227,111,116
2017,1,A,골목상권,1000932,영동대로65길,3117,1828,1289
2017,1,A,골목상권,1000931,영동대로112길,661,410,251
2017,1,A,골목상권,1000930,언주로81길,9257,4736,4521
2017,1,A,골목상권,1000929,압구정로2길,2790,1488,1302
2017,1,A,골목상권,1000928,선릉로18길,426,227,199
2017,1,A,골목상권,1000927,선릉로146길,1884,983,901
2017,1,A,골목상권,1000926,선릉로133길,187,102,85
2017,1,A,골목상권,1000925,선릉로132길,1019,555,464
2017,1,A,골목상권,1000924,선릉로121길,1868,974,894
2017,1,A,골목상권,1000923,삼성로75길,2696,1435,1261
2017,1,A,골목상권,1000922,삼성로69길,316,146,170
2017,1,A,골목상권,1000921,삼성로64길,537,258,279
2017,1,A,골목상권,1000920,삼성로63길,151,68,83
2017,1,A,골목상권,1000919,삼성로57길,867,275,592
2017,1,A,골목상권,1000918,삼성로147길,970,394,576
2017,1,A,골목상권,1000917,삼성로115길,266,169,97
2017,1,A,골목상권,1000916,봉은사로68길,289,151,138
2017,1,A,골목상권,1000915,봉은사로57길,742,481,261
2017,1,A,골목상권,1000914,봉은사로43길,1035,707,328
2017,1,A,골목상권,1000913,봉은사로29길,124,78,46
2017,1,A,골목상권,1000912,봉은사로109길,321,168,153
2017,1,A,골목상권,1000911,도산대로89길,2595,987,1608
2017,1,A,골목상권,1000910,도산대로81길,4539,1400,3139
2017,1,A,골목상권,1000909,도산대로50길,2799,1914,885
2017,1,A,골목상권,1000908,도산대로38길,156,87,69
2017,1,A,골목상권,1000907,도산대로30길,2931,1421,1510
2017,1,A,골목상권,1000906,도산대로23길,1637,947,690
2017,1,A,골목상권,1000905,도산대로15길,1865,862,1003
2017,1,A,골목상권,1000904,도곡로37길,3601,2245,1356
2017,1,A,골목상권,1000903,논현로8길,760,409,351
2017,1,A,골목상권,1000902,논현로63길,10880,3112,7768
2017,1,A,골목상권,1000901,논현로28길,10370,7159,3211
2017,1,A,골목상권,1000900,논현로26길,6682,4054,2628
2017,1,A,골목상권,1000898,논현로139길,2706,1323,1383
2017,1,A,골목상권,1000897,논현로123길,94,55,39
2017,1,A,골목상권,1000896,논현로115길,2789,1442,1347
2017,1,A,골목상권,1000895,논현로10길,2567,1661,906
2017,1,A,골목상권,1000894,논현로106길,2732,1584,1148
2017,1,A,골목상권,1000893,남부순환로365길,185,130,55
2017,1,A,골목상권,1000891,개포로28길,286,209,77
2017,1,A,골목상권,1000890,개포로20길,4229,2365,1864
2017,1,A,골목상권,1000889,개포로17길,2654,1690,964
2017,1,A,골목상권,1000888,강남대로140길,4339,2268,2071
2017,1,A,골목상권,1000887,강남대로136길,1132,598,534
2017,1,A,골목상권,1000886,강남대로118길,622,337,285
2017,1,A,골목상권,1000885,서초중앙로8길,7055,5341,1714
2017,1,A,골목상권,1000884,방배중앙로21길,1980,671,1309
2017,1,A,골목상권,1000883,효령로72길,224,129,95
2017,1,A,골목상권,1000882,효령로34길,23,20,3
2017,1,A,골목상권,1000881,효령로31길,1440,801,639
2017,1,A,골목상권,1000880,효령로23길,713,427,286
2017,1,A,골목상권,1000879,청두곶길,2013,1319,694
2017,1,A,골목상권,1000878,주흥길,310,200,110
2017,1,A,골목상권,1000877,주흥15길,1626,1062,564
2017,1,A,골목상권,1000876,언남길,1806,1275,531
2017,1,A,골목상권,1000875,신반포로45길,404,258,146
2017,1,A,골목상권,1000874,서초대로8길,310,180,130
2017,1,A,골목상권,1000873,서초대로64길,509,351,158
2017,1,A,골목상권,1000872,서초대로4길,611,433,178
2017,1,A,골목상권,1000871,서초대로25길,3345,2024,1321
2017,1,A,골목상권,1000870,서초대로23길,506,298,208
2017,1,A,골목상권,1000869,서초대로15길,1442,685,757
2017,1,A,골목상권,1000868,사평대로57길,173,66,107
2017,1,A,골목상권,1000867,사평대로26길,15,10,5
2017,1,A,골목상권,1000866,사평대로22길,1508,913,595
2017,1,A,골목상권,1000865,사임당로17길,1817,1101,716
2017,1,A,골목상권,1000864,방배로42길,145,75,70
2017,1,A,골목상권,1000863,방배로35길,2359,1470,889
2017,1,A,골목상권,1000862,방배로18길,83,45,38
2017,1,A,골목상권,1000861,반포대로9길,684,425,259
2017,1,A,골목상권,1000860,바우뫼로39길,2089,1278,811
2017,1,A,골목상권,1000859,마방로2길,3973,2528,1445
2017,1,A,골목상권,1000858,방배천로4안길,1268,810,458
2017,1,A,골목상권,1000857,동산로19길,1334,890,444
2017,1,A,골목상권,1000856,동산로10길,2623,1376,1247
2017,1,A,골목상권,1000855,동광로39길,48,30,18
2017,1,A,골목상권,1000854,동광로1길,1206,711,495
2017,1,A,골목상권,1000853,동광로12길,787,522,265
2017,1,A,골목상권,1000852,논현로27길,3585,2538,1047
2017,1,A,골목상권,1000851,논현로1길,524,342,182
2017,1,A,골목상권,1000850,남부순환로339길,12144,5446,6698
2017,1,A,골목상권,1000849,남부순환로325길,7947,4010,3937
2017,1,A,골목상권,1000848,남부순환로317길,1511,1045,466
2017,1,A,골목상권,1000847,고무래로8길,6939,3701,3238
2017,1,A,골목상권,1000846,강남대로8길,2718,1679,1039
2017,1,A,골목상권,1000845,강남대로34길,997,648,349
2017,1,A,골목상권,1000844,강남대로23길,6639,4622,2017
2017,1,A,골목상권,1000843,소담길,22,5,17
2017,1,A,골목상권,1000842,원신길,305,115,190
2017,1,A,골목상권,1000840,양산길,363,262,101
2017,1,A,골목상권,1000839,호암로24길,640,241,399
2017,1,A,골목상권,1000838,호암로20길,43,31,12
2017,1,A,골목상권,1000837,행운길,19,3,16
2017,1,A,골목상권,1000836,행운1길,101,68,33
2017,1,A,골목상권,1000835,청림3길,79,42,37
2017,1,A,골목상권,1000834,청룡길,88,45,43
2017,1,A,골목상권,1000833,청룡8길,34,13,21
2017,1,A,골목상권,1000832,중앙길,280,114,166
2017,1,A,골목상권,1000831,조원중앙로2길,1104,788,316
2017,1,A,골목상권,1000830,조원로18길,1063,552,511
2017,1,A,골목상권,1000829,조원로10길,273,125,148
2017,1,A,골목상권,1000828,장군봉2길,223,119,104
2017,1,A,골목상권,1000827,장군봉1길,91,15,76
2017,1,A,골목상권,1000826,인헌길,82,41,41
2017,1,A,골목상권,1000825,은천로25길,286,92,194
2017,1,A,골목상권,1000824,양녕로6길,800,476,324
2017,1,A,골목상권,1000823,신원로3길,33,20,13
2017,1,A,골목상권,1000822,신사로20길,52,24,28
2017,1,A,골목상권,1000820,신림로64길,253,122,131
2017,1,A,골목상권,1000819,신림로48길,73,33,40
2017,1,A,골목상권,1000818,신림로38길,61,32,29
2017,1,A,골목상권,1000817,신림로28길,320,219,101
2017,1,A,골목상권,1000816,신림로11길,453,409,44
2017,1,A,골목상권,1000815,신림동길,342,194,148
2017,1,A,골목상권,1000814,승방길,558,363,195
2017,1,A,골목상권,1000813,서림7길,266,97,169
2017,1,A,골목상권,1000812,봉천로33길,377,238,139
2017,1,A,골목상권,1000811,봉천로13길,300,90,210
2017,1,A,골목상권,1000810,복은길,174,61,113
2017,1,A,골목상권,1000809,법원단지길,2,1,1
2017,1,A,골목상권,1000808,법원단지9길,90,33,57
2017,1,A,골목상권,1000807,미성5길,66,39,27
2017,1,A,골목상권,1000806,대학길,80,31,49
2017,1,A,골목상권,1000805,대학14길,10,2,8
2017,1,A,골목상권,1000804,당곡길,351,162,189
2017,1,A,골목상권,1000803,남현길,234,90,144
2017,1,A,골목상권,1000802,남현3길,430,258,172
2017,1,A,골목상권,1000800,남부순환로248길,252,130,122
2017,1,A,골목상권,1000799,남부순환로234길,112,75,37
2017,1,A,골목상권,1000798,남부순환로172길,1478,863,615
2017,1,A,골목상권,1000797,남부순환로161길,21,5,16
2017,1,A,골목상권,1000796,남부순환로151길,123,76,47
2017,1,A,골목상권,1000795,남부순환로142길,76,38,38
2017,1,A,골목상권,1000794,난향길,169,42,127
2017,1,A,골목상권,1000793,난우길,436,188,248
2017,1,A,골목상권,1000792,난곡로74길,144,63,81
2017,1,A,골목상권,1000791,난곡로34길,22,7,15
2017,1,A,골목상권,1000790,난곡로26길,121,47,74
2017,1,A,골목상권,1000789,난곡로24길,40,18,22
2017,1,A,골목상권,1000788,낙성대역길,736,467,269
2017,1,A,골목상권,1000787,국회단지길,529,237,292
2017,1,A,골목상권,1000786,구암길,84,31,53
2017,1,A,골목상권,1000785,관천로22길,25,10,15
2017,1,A,골목상권,1000784,관천로15길,134,73,61
2017,1,A,골목상권,1000783,관악로30길,172,62,110
2017,1,A,골목상권,1000782,관악로28길,148,69,79
2017,1,A,골목상권,1000781,관악로14길,408,224,184
2017,1,A,골목상권,1000780,관악로10길,261,182,79
2017,1,A,골목상권,1000779,흑석로9길,194,81,113
2017,1,A,골목상권,1000778,흑석로13길,128,13,115
2017,1,A,골목상권,1000777,장승배기로27길,39,19,20
2017,1,A,골목상권,1000776,장승배기로19길,9,5,4
2017,1,A,골목상권,1000774,여의대방로46길,459,143,316
2017,1,A,골목상권,1000773,여의대방로24길,17082,8225,8857
2017,1,A,골목상권,1000772,여의대방로22카길,274,110,164
2017,1,A,골목상권,1000771,여의대방로22나길,139,55,84
2017,1,A,골목상권,1000770,여의대방로22길,201,115,86
2017,1,A,골목상권,1000769,양녕로26길,126,57,69
2017,1,A,골목상권,1000768,신대방길,107,72,35
2017,1,A,골목상권,1000767,성대로29길,4,2,2
2017,1,A,골목상권,1000766,성대로1길,311,122,189
2017,1,A,골목상권,1000765,서달로8가길,228,98,130
2017,1,A,골목상권,1000763,서달로14길,34,13,21
2017,1,A,골목상권,1000762,서달로10길,87,31,56
2017,1,A,골목상권,1000761,상도로62길,215,99,116
2017,1,A,골목상권,1000760,상도로61길,39,16,23
2017,1,A,골목상권,1000759,상도로47길,53,42,11
2017,1,A,골목상권,1000758,상도로37길,1985,962,1023
2017,1,A,골목상권,1000757,상도로15길,306,137,169
2017,1,A,골목상권,1000756,사당로8길,128,68,60
2017,1,A,골목상권,1000755,사당로30길,308,216,92
2017,1,A,골목상권,1000754,사당로2차길,152,107,45
2017,1,A,골목상권,1000753,사당로29길,16,13,3
2017,1,A,골목상권,1000752,사당로26길,245,134,111
2017,1,A,골목상권,1000751,사당로23나길,167,44,123
2017,1,A,골목상권,1000750,사당로23길,14,12,2
2017,1,A,골목상권,1000749,사당로20길,175,131,44
2017,1,A,골목상권,1000748,사당로16길,132,39,93
2017,1,A,골목상권,1000747,사당로16가길,815,483,332
2017,1,A,골목상권,1000746,만양로8길,88,38,50
2017,1,A,골목상권,1000745,만양로14길,360,152,208
2017,1,A,골목상권,1000744,등용로14길,624,431,193
2017,1,A,골목상권,1000743,동작대로7길,2058,751,1307
2017,1,A,골목상권,1000742,동작대로35길,267,98,169
2017,1,A,골목상권,1000741,동작대로33길,119,62,57
2017,1,A,골목상권,1000740,동작대로29길,27,15,12
2017,1,A,골목상권,1000739,동작대로17길,1359,734,625
2017,1,A,골목상권,1000738,대방동2길,477,233,244
2017,1,A,골목상권,1000737,대방동27길,94,50,44
2017,1,A,골목상권,1000736,노량진로6길,113,30,83
2017,1,A,골목상권,1000735,국사봉길,36,4,32
2017,1,A,골목상권,1000734,국사봉2길,94,54,40
2017,1,A,골목상권,1000733,국사봉1길,7,3,4
2017,1,A,골목상권,1000732,영신로9길,458,200,258
2017,1,A,골목상권,1000731,영등포로84길,344,84,260
2017,1,A,골목상권,1000730,영등포로80길,51,25,26
2017,1,A,골목상권,1000729,영등포로62길,2,2,0
2017,1,A,골목상권,1000728,영등포로35길,95,64,31
2017,1,A,골목상권,1000727,영등포로27길,362,229,133
2017,1,A,골목상권,1000724,여의대방로43나길,2368,1883,485
2017,1,A,골목상권,1000723,여의대방로39길,8,6,2
2017,1,A,골목상권,1000722,여의대방로35길,769,405,364
2017,1,A,골목상권,1000721,양평로28길,605,474,131
2017,1,A,골목상권,1000720,양평로22라길,33,20,13
2017,1,A,골목상권,1000719,양평로19길,4256,3344,912
2017,1,A,골목상권,1000718,신길로60길,436,190,246
2017,1,A,골목상권,1000717,신길로42길,375,183,192
2017,1,A,골목상권,1000716,신길로42가길,96,27,69
2017,1,A,골목상권,1000715,신길로39길,92,42,50
2017,1,A,골목상권,1000714,신길로17길,60,41,19
2017,1,A,골목상권,1000713,선유서로28길,587,284,303
2017,1,A,골목상권,1000712,선유서로25길,2457,1784,673
2017,1,A,골목상권,1000711,선유서로24길,155,81,74
2017,1,A,골목상권,1000710,선유로55길,2346,1414,932
2017,1,A,골목상권,1000709,디지털로74길,54,33,21
2017,1,A,골목상권,1000708,디지털로57길,10,3,7
2017,1,A,골목상권,1000707,디지털로37길,206,89,117
2017,1,A,골목상권,1000706,도신로62길,184,53,131
2017,1,A,골목상권,1000705,도신로60길,60,12,48
2017,1,A,골목상권,1000704,도신로29길,82,36,46
2017,1,A,골목상권,1000703,도신로15길,77,32,45
2017,1,A,골목상권,1000702,도림천로21길,92,44,48
2017,1,A,골목상권,1000701,도림로63길,32,21,11
2017,1,A,골목상권,1000700,도림로147길,1703,1204,499
2017,1,A,골목상권,1000699,도림로112길,12,6,6
2017,1,A,골목상권,1000698,대림로8길,1834,599,1235
2017,1,A,골목상권,1000697,대림로7길,14,5,9
2017,1,A,골목상권,1000696,대림로44길,45,27,18
2017,1,A,골목상권,1000695,대림로34길,187,70,117
2017,1,A,골목상권,1000694,대림로31길,753,369,384
2017,1,A,골목상권,1000693,대림로29길,1637,778,859
2017,1,A,골목상권,1000692,대림로22길,343,190,153
2017,1,A,골목상권,1000691,당산로46길,4455,2497,1958
2017,1,A,골목상권,1000690,당산로38길,218,154,64
2017,1,A,골목상권,1000689,당산로37길,4062,2537,1525
2017,1,A,골목상권,1000688,당산로31길,4110,2263,1847
2017,1,A,골목상권,1000687,국회대로56길,1674,1095,579
2017,1,A,골목상권,1000686,경인로90길,310,184,126
2017,1,A,골목상권,1000685,경인로80길,1561,1125,436
2017,1,A,골목상권,1000684,경인로77길,686,453,233
2017,1,A,골목상권,1000683,가마산로61길,164,56,108
2017,1,A,골목상권,1000682,시흥대로94길,780,395,385
2017,1,A,골목상권,1000681,시흥대로84길,174,68,106
2017,1,A,골목상권,1000680,시흥대로68길,535,160,375
2017,1,A,골목상권,1000679,시흥대로63길,2876,1478,1398
2017,1,A,골목상권,1000678,시흥대로62가길,430,113,317
2017,1,A,골목상권,1000677,시흥대로36길,365,213,152
2017,1,A,골목상권,1000676,시흥대로22길,510,361,149
2017,1,A,골목상권,1000675,시흥대로153길,646,347,299
2017,1,A,골목상권,1000674,시흥대로150길,546,249,297
2017,1,A,골목상권,1000673,시흥대로141길,657,400,257
2017,1,A,골목상권,1000672,시흥대로138길,18,11,7
2017,1,A,골목상권,1000671,시흥대로120길,608,407,201
2017,1,A,골목상권,1000670,벚꽃로56길,1826,1257,569
2017,1,A,골목상권,1000669,범안로17길,129,73,56
2017,1,A,골목상권,1000668,범안로11길,1139,900,239
2017,1,A,골목상권,1000667,문성로5길,145,42,103
2017,1,A,골목상권,1000666,독산로85길,85,24,61
2017,1,A,골목상권,1000665,독산로78다길,234,101,133
2017,1,A,골목상권,1000664,독산로70길,4,3,1
2017,1,A,골목상권,1000663,독산로64길,158,39,119
2017,1,A,골목상권,1000662,독산로50길,90,33,57
2017,1,A,골목상권,1000661,독산로40길,54,15,39
2017,1,A,골목상권,1000660,독산로108길,737,334,403
2017,1,A,골목상권,1000659,남부순환로112길,10,6,4
2017,1,A,골목상권,1000658,금하로24길,176,55,121
2017,1,A,골목상권,1000657,금하로1길,66,32,34
2017,1,A,골목상권,1000656,금하로14길,17,8,9
2017,1,A,골목상권,1000655,가산로5길,547,429,118
2017,1,A,골목상권,1000654,가산로3길,2414,1850,564
2017,1,A,골목상권,1000653,중앙로1길,1534,1063,471
2017,1,A,골목상권,1000652,중앙로15길,98,47,51
2017,1,A,골목상권,1000651,우마길,34,23,11
2017,1,A,골목상권,1000650,오류로8길,246,116,130
2017,1,A,골목상권,1000649,신도림로13길,775,585,190
2017,1,A,골목상권,1000648,새말로18길,1072,471,601
2017,1,A,골목상권,1000647,부일로1길,782,640,142
2017,1,A,골목상권,1000646,부일로15길,181,159,22
2017,1,A,골목상권,1000645,부일로11길,22,6,16
2017,1,A,골목상권,1000644,디지털로32길,1169,592,577
2017,1,A,골목상권,1000643,디지털로32가길,7202,5069,2133
2017,1,A,골목상권,1000642,디지털로27길,387,250,137
2017,1,A,골목상권,1000641,도림로6길,109,46,63
2017,1,A,골목상권,1000640,도림로12길,99,37,62
2017,1,A,골목상권,1000639,남부순환로97길,278,94,184
2017,1,A,골목상권,1000638,구로중앙로8길,234,83,151
2017,1,A,골목상권,1000637,구로중앙로7길,177,56,121
2017,1,A,골목상권,1000636,구로중앙로42길,791,589,202
2017,1,A,골목상권,1000635,구로중앙로34길,641,335,306
2017,1,A,골목상권,1000634,구로중앙로28길,3052,1476,1576
2017,1,A,골목상권,1000633,구로중앙로19길,8,5,3
2017,1,A,골목상권,1000632,구로동로8길,151,52,99
2017,1,A,골목상권,1000631,구로동로7길,162,61,101
2017,1,A,골목상권,1000630,구로동로42길,27,16,11
2017,1,A,골목상권,1000629,구로동로41길,440,279,161
2017,1,A,골목상권,1000628,구로동로38길,50,26,24
2017,1,A,골목상권,1000627,구로동로28길,191,91,100
2017,1,A,골목상권,1000626,구로동로15길,21,1,20
2017,1,A,골목상권,1000625,공원로6가길,302,211,91
2017,1,A,골목상권,1000624,고척로52길,230,69,161
2017,1,A,골목상권,1000623,고척로27다길,223,84,139
2017,1,A,골목상권,1000622,고척로27길,239,101,138
2017,1,A,골목상권,1000621,고척로21나길,242,64,178
2017,1,A,골목상권,1000620,경인로47길,850,474,376
2017,1,A,골목상권,1000619,경인로35길,276,111,165
2017,1,A,골목상권,1000618,경인로31길,48,15,33
2017,1,A,골목상권,1000617,경인로15길,141,63,78
2017,1,A,골목상권,1000616,개봉로3길,268,161,107
2017,1,A,골목상권,1000615,개봉로2길,475,134,341
2017,1,A,골목상권,1000614,개봉로23가길,865,505,360
2017,1,A,골목상권,1000613,개봉로20길,128,72,56
2017,1,A,골목상권,1000612,개봉로1길,49,24,25
2017,1,A,골목상권,1000611,개봉로17다길,163,76,87
2017,1,A,골목상권,1000610,개봉로17길,821,384,437
2017,1,A,골목상권,1000609,개봉로11길,51,10,41
2017,1,A,골목상권,1000608,화곡로64길,2939,1601,1338
2017,1,A,골목상권,1000607,화곡로59길,516,203,313
2017,1,A,골목상권,1000606,화곡로44나길,803,676,127
2017,1,A,골목상권,1000605,화곡로31길,1129,403,726
2017,1,A,골목상권,1000604,화곡로20길,555,332,223
2017,1,A,골목상권,1000603,화곡로13길,273,98,175
2017,1,A,골목상권,1000602,초원로16길,594,242,352
2017,1,A,골목상권,1000601,초록마을로8길,174,34,140
2017,1,A,골목상권,1000600,초록마을로3길,48,26,22
2017,1,A,골목상권,1000599,월정로20길,4,2,2
2017,1,A,골목상권,1000598,우장산로6길,318,193,125
2017,1,A,골목상권,1000597,양천로73가길,1357,882,475
2017,1,A,골목상권,1000596,양천로71길,194,127,67
2017,1,A,골목상권,1000595,양천로49길,724,581,143
2017,1,A,골목상권,1000594,양천로26길,121,56,65
2017,1,A,골목상권,1000593,양천로24길,355,129,226
2017,1,A,골목상권,1000592,양천로24가길,668,309,359
2017,1,A,골목상권,1000591,양천로14길,342,203,139
2017,1,A,골목상권,1000590,방화대로6라길,713,451,262
2017,1,A,골목상권,1000589,방화대로21길,820,488,332
2017,1,A,골목상권,1000588,등촌로5길,10,3,7
2017,1,A,골목상권,1000587,등촌로55길,465,323,142
2017,1,A,골목상권,1000586,등촌로51길,16,11,5
2017,1,A,골목상권,1000585,등촌로39길,66,23,43
2017,1,A,골목상권,1000584,등촌로13길,201,104,97
2017,1,A,골목상권,1000583,남부순환로11길,403,285,118
2017,1,A,골목상권,1000582,까치산로4길,134,50,84
2017,1,A,골목상권,1000581,국회대로7길,400,231,169
2017,1,A,골목상권,1000580,공항대로8길,189,75,114
2017,1,A,골목상권,1000579,공항대로61길,228,153,75
2017,1,A,골목상권,1000578,공항대로59다길,839,621,218
2017,1,A,골목상권,1000577,공항대로59길,1126,719,407
2017,1,A,골목상권,1000576,공항대로55길,1026,707,319
2017,1,A,골목상권,1000575,공항대로42길,6,3,3
2017,1,A,골목상권,1000574,공항대로38길,264,144,120
2017,1,A,골목상권,1000573,곰달래로60길,596,316,280
2017,1,A,골목상권,1000572,곰달래로53길,55,16,39
2017,1,A,골목상권,1000571,곰달래로47길,36,14,22
2017,1,A,골목상권,1000570,곰달래로31길,9,8,1
2017,1,A,골목상권,1000569,곰달래로25길,613,246,367
2017,1,A,골목상권,1000568,개화동로25길,670,428,242
2017,1,A,골목상권,1000567,개화동로23길,115,78,37
2017,1,A,골목상권,1000566,강서로8길,142,78,64
2017,1,A,골목상권,1000565,강서로5라길,289,166,123
2017,1,A,골목상권,1000564,강서로5나길,122,69,53
2017,1,A,골목상권,1000563,강서로5가길,45,25,20
2017,1,A,골목상권,1000562,강서로47라길,91,53,38
2017,1,A,골목상권,1000561,강서로47길,411,206,205
2017,1,A,골목상권,1000560,강서로45다길,802,395,407
2017,1,A,골목상권,1000559,강서로45길,134,62,72
2017,1,A,골목상권,1000558,강서로35길,179,106,73
2017,1,A,골목상권,1000557,강서로29길,325,163,162
2017,1,A,골목상권,1000556,강서로18길,27,15,12
2017,1,A,골목상권,1000555,강서로17가길,117,52,65
2017,1,A,골목상권,1000554,강서로15길,262,136,126
2017,1,A,골목상권,1000553,가로공원로80길,56,26,30
2017,1,A,골목상권,1000552,가로공원로76가길,26,11,15
2017,1,A,골목상권,1000551,화곡로4길,253,95,158
2017,1,A,골목상권,1000550,화곡로3길,178,65,113
2017,1,A,골목상권,1000549,지양로7길,230,75,155
2017,1,A,골목상권,1000548,중앙로55길,350,184,166
2017,1,A,골목상권,1000547,중앙로51길,147,90,57
2017,1,A,골목상권,1000546,중앙로47길,125,33,92
2017,1,A,골목상권,1000545,중앙로45길,160,61,99
2017,1,A,골목상권,1000544,중앙로36길,2,2,0
2017,1,A,골목상권,1000543,중앙로32길,609,286,323
2017,1,A,골목상권,1000542,중앙로25길,252,76,176
2017,1,A,골목상권,1000541,은행정로7길,491,167,324
2017,1,A,골목상권,1000539,오목로5길,302,174,128
2017,1,A,골목상권,1000538,오목로3길,445,421,24
2017,1,A,골목상권,1000537,오목로30길,165,80,85
2017,1,A,골목상권,1000536,오목로23길,816,463,353
2017,1,A,골목상권,1000535,신월로20길,205,80,125
2017,1,A,골목상권,1000534,신월로15길,796,360,436
2017,1,A,골목상권,1000533,신목로6길,269,150,119
2017,1,A,골목상권,1000532,신목로5길,901,325,576
2017,1,A,골목상권,1000531,신목로2길,115,54,61
2017,1,A,골목상권,1000530,목동중앙서로8가길,177,102,75
2017,1,A,골목상권,1000529,목동중앙서로7길,263,87,176
2017,1,A,골목상권,1000528,목동중앙북로8길,363,104,259
2017,1,A,골목상권,1000527,목동중앙북로16길,270,85,185
2017,1,A,골목상권,1000526,목동중앙본로7길,111,43,68
2017,1,A,골목상권,1000525,목동중앙로3길,98,53,45
2017,1,A,골목상권,1000524,목동중앙로13나길,286,202,84
2017,1,A,골목상권,1000523,목동중앙남로3가길,576,385,191
2017,1,A,골목상권,1000522,목동로9길,2483,1632,851
2017,1,A,골목상권,1000521,목동로19길,999,355,644
2017,1,A,골목상권,1000519,목동동로12길,419,162,257
2017,1,A,골목상권,1000518,목동남로4길,10,4,6
2017,1,A,골목상권,1000517,남부순환로88길,300,118,182
2017,1,A,골목상권,1000516,남부순환로79길,460,342,118
2017,1,A,골목상권,1000515,남부순환로70길,550,355,195
2017,1,A,골목상권,1000514,남부순환로58길,293,125,168
2017,1,A,골목상권,1000513,남부순환로40길,14,4,10
2017,1,A,골목상권,1000512,남부순환로33길,1095,898,197
2017,1,A,골목상권,1000511,곰달래로5길,45,25,20
2017,1,A,골목상권,1000510,곰달래로3길,393,211,182
2017,1,A,골목상권,1000509,곰달래로2길,264,144,120
2017,1,A,골목상권,1000508,곰달래로10길,315,224,91
2017,1,A,골목상권,1000507,가로공원로58길,79,17,62
2017,1,A,골목상권,1000506,효창원로93길,103,55,48
2017,1,A,골목상권,1000505,토정로37길,123,53,70
2017,1,A,골목상권,1000504,월드컵로8길,1745,843,902
2017,1,A,골목상권,1000503,월드컵로7길,3,2,1
2017,1,A,골목상권,1000502,월드컵로36길,149,64,85
2017,1,A,골목상권,1000501,월드컵로25길,299,169,130
2017,1,A,골목상권,1000500,월드컵로19길,655,287,368
2017,1,A,골목상권,1000499,월드컵로16길,3899,2038,1861
2017,1,A,골목상권,1000498,월드컵로11길,240,93,147
2017,1,A,골목상권,1000497,월드컵로10길,1554,795,759
2017,1,A,골목상권,1000496,와우산로3길,147,86,61
2017,1,A,골목상권,1000495,와우산로29길,153,77,76
2017,1,A,골목상권,1000494,와우산로29가길,18,7,11
2017,1,A,골목상권,1000493,양화진길,444,304,140
2017,1,A,골목상권,1000492,양화로1길,3912,1868,2044
2017,1,A,골목상권,1000491,양화로11길,354,227,127
2017,1,A,골목상권,1000490,신촌로30길,30,16,14
2017,1,A,골목상권,1000489,신촌로28가길,108,42,66
2017,1,A,골목상권,1000488,신촌로12길,1309,607,702
2017,1,A,골목상권,1000487,숭문길,2984,2046,938
2017,1,A,골목상권,1000486,숭문8길,117,69,48
2017,1,A,골목상권,1000485,성지3길,435,231,204
2017,1,A,골목상권,1000484,성산로4길,1687,1059,628
2017,1,A,골목상권,1000483,성미산로32길,392,170,222
2017,1,A,골목상권,1000482,성미산로1길,638,441,197
2017,1,A,골목상권,1000481,성미산로11길,1056,698,358
2017,1,A,골목상권,1000480,백범로16길,574,300,274
2017,1,A,골목상권,1000479,방울내로9안길,328,196,132
2017,1,A,골목상권,1000478,모래내로7길,246,130,116
2017,1,A,골목상권,1000477,매봉산로2길,2009,1313,696
2017,1,A,골목상권,1000476,망원로2길,207,125,82
2017,1,A,골목상권,1000475,망원로11길,1039,574,465
2017,1,A,골목상권,1000474,만리재옛길,1407,589,818
2017,1,A,골목상권,1000473,마포대로4길,181,97,84
2017,1,A,골목상권,1000472,마포대로20길,1156,587,569
2017,1,A,골목상권,1000471,마포대로12길,64,36,28
2017,1,A,골목상권,1000470,동교로38길,250,119,131
2017,1,A,골목상권,1000469,동교로27길,3470,1565,1905
2017,1,A,골목상권,1000468,동교로25길,557,264,293
2017,1,A,골목상권,1000467,동교로19길,4667,2944,1723
2017,1,A,골목상권,1000466,동교로17길,767,392,375
2017,1,A,골목상권,1000465,독막로8길,307,139,168
2017,1,A,골목상권,1000464,독막로32길,472,200,272
2017,1,A,골목상권,1000463,독막로22길,104,56,48
2017,1,A,골목상권,1000462,도화길,1033,531,502
2017,1,A,골목상권,1000461,도화4길,351,115,236
2017,1,A,골목상권,1000460,대흥로28길,55,40,15
2017,1,A,골목상권,1000459,대흥로21길,484,91,393
2017,1,A,골목상권,1000458,광성로6길,116,77,39
2017,1,A,골목상권,1000457,홍제내길,113,64,49
2017,1,A,골목상권,1000456,홍연길,76,44,32
2017,1,A,골목상권,1000455,통일로39길,11,9,2
2017,1,A,골목상권,1000454,통일로37길,360,139,221
2017,1,A,골목상권,1000453,통일로11길,11,10,1
2017,1,A,골목상권,1000452,충정로6길,15729,8688,7041
2017,1,A,골목상권,1000451,충정로4길,3015,2019,996
2017,1,A,골목상권,1000450,증가로6길,188,69,119
2017,1,A,골목상권,1000449,증가로23나길,444,217,227
2017,1,A,골목상권,1000448,증가로20가길,237,78,159
2017,1,A,골목상권,1000447,증가로10길,163,91,72
2017,1,A,골목상권,1000446,응암로1길,361,255,106
2017,1,A,골목상권,1000445,연희로10길,118,83,35
2017,1,A,골목상권,1000444,신촌로37길,152,64,88
2017,1,A,골목상권,1000443,수색로8길,2631,2517,114
2017,1,A,골목상권,1000442,세무서길,332,122,210
2017,1,A,골목상권,1000440,세검정로1길,334,176,158
2017,1,A,골목상권,1000439,북아현로4길,421,94,327
2017,1,A,골목상권,1000438,모래내로15길,95,24,71
2017,1,A,골목상권,1000437,명지대길,387,289,98
2017,1,A,골목상권,1000436,독립문로8길,773,287,486
2017,1,A,골목상권,1000435,가재울로6길,15,8,7
2017,1,A,골목상권,1000434,통일로92길,77,39,38
2017,1,A,골목상권,1000433,통일로87길,226,111,115
2017,1,A,골목상권,1000432,통일로78길,212,63,149
2017,1,A,골목상권,1000430,진흥로1길,470,139,331
2017,1,A,골목상권,1000429,진흥로12길,491,204,287
2017,1,A,골목상권,1000428,증산서길,577,297,280
2017,1,A,골목상권,1000427,증산로9길,103,34,69
2017,1,A,골목상권,1000426,증산로5길,772,404,368
2017,1,A,골목상권,1000425,증산로21길,260,164,96
2017,1,A,골목상권,1000424,증산로17길,748,357,391
2017,1,A,골목상권,1000423,증산로15길,204,76,128
2017,1,A,골목상권,1000422,증산로13길,73,40,33
2017,1,A,골목상권,1000421,응암로34길,63,40,23
2017,1,A,골목상권,1000420,응암로22길,148,49,99
2017,1,A,골목상권,1000419,응암로14길,382,127,255
2017,1,A,골목상권,1000418,응암로13길,291,117,174
2017,1,A,골목상권,1000417,응암로12길,218,106,112
2017,1,A,골목상권,1000416,은평로8길,263,133,130
2017,1,A,골목상권,1000415,은평로3길,291,79,212
2017,1,A,골목상권,1000414,은평로20길,24,9,15
2017,1,A,골목상권,1000413,은평로13길,491,324,167
2017,1,A,골목상권,1000412,은평로10길,367,210,157
2017,1,A,골목상권,1000411,연서로5길,44,13,31
2017,1,A,골목상권,1000410,연서로41길,242,69,173
2017,1,A,골목상권,1000409,연서로3길,109,39,70
2017,1,A,골목상권,1000408,연서로34길,155,46,109
2017,1,A,골목상권,1000407,연서로33길,25,8,17
2017,1,A,골목상권,1000406,연서로29길,342,132,210
2017,1,A,골목상권,1000405,연서로28길,702,303,399
2017,1,A,골목상권,1000404,연서로27길,62,29,33
2017,1,A,골목상권,1000403,연서로21길,340,214,126
2017,1,A,골목상권,1000402,연서로17길,1122,327,795
2017,1,A,골목상권,1000401,연서로16길,275,110,165
2017,1,A,골목상권,1000400,연서로13길,711,225,486
2017,1,A,골목상권,1000399,연서로11길,236,108,128
2017,1,A,골목상권,1000398,역말로9길,14,10,4
2017,1,A,골목상권,1000397,수색로18길,23,12,11
2017,1,A,골목상권,1000396,서오릉로8길,16,1,15
2017,1,A,골목상권,1000395,서오릉로21길,457,132,325
2017,1,A,골목상권,1000394,불광천길,168,83,85
2017,1,A,골목상권,1000393,갈현로7길,967,269,698
2017,1,A,골목상권,1000392,갈현로41길,83,32,51
2017,1,A,골목상권,1000391,갈현로33길,36,8,28
2017,1,A,골목상권,1000390,갈현로1길,166,77,89
2017,1,A,골목상권,1000389,가좌로7길,60,27,33
2017,1,A,골목상권,1000388,한글비석로44길,445,243,202
2017,1,A,골목상권,1000387,한글비석로24길,394,149,245
2017,1,A,골목상권,1000386,한글비석로22길,796,321,475
2017,1,A,골목상권,1000385,석계로1길,107,68,39
2017,1,A,골목상권,1000384,상계로9가길,282,112,170
2017,1,A,골목상권,1000382,상계로12길,24,16,8
2017,1,A,골목상권,1000381,동일로242길,293,191,102
2017,1,A,골목상권,1000380,동일로192길,420,194,226
2017,1,A,골목상권,1000379,동일로173가길,2379,1366,1013
2017,1,A,골목상권,1000378,공릉로58길,118,43,75
2017,1,A,골목상권,1000377,해등로16길,85,64,21
2017,1,A,골목상권,1000376,우이천로4다길,181,107,74
2017,1,A,골목상권,1000375,우이천로32길,99,56,43
2017,1,A,골목상권,1000374,시루봉로23길,50,22,28
2017,1,A,골목상권,1000373,삼양로144길,72,54,18
2017,1,A,골목상권,1000372,방학로6가길,223,139,84
2017,1,A,골목상권,1000371,방학로5길,116,69,47
2017,1,A,골목상권,1000370,방학로15길,342,222,120
2017,1,A,골목상권,1000369,방학로10길,176,69,107
2017,1,A,골목상권,1000367,도봉산4길,328,283,45
2017,1,A,골목상권,1000366,도봉로181길,191,82,109
2017,1,A,골목상권,1000365,도봉로169나길,301,133,168
2017,1,A,골목상권,1000364,도봉로156길,252,135,117
2017,1,A,골목상권,1000363,도봉로152가길,412,369,43
2017,1,A,골목상권,1000362,도봉로147길,569,321,248
2017,1,A,골목상권,1000360,도봉로114길,475,165,310
2017,1,A,골목상권,1000359,도봉로109길,21,7,14
2017,1,A,골목상권,1000358,도당로29길,865,508,357
2017,1,A,골목상권,1000357,도당로19길,206,88,118
2017,1,A,골목상권,1000356,도당로13바길,201,80,121
2017,1,A,골목상권,1000355,도당로13가길,153,59,94
2017,1,A,골목상권,1000354,덕릉로60길,77,42,35
2017,1,A,골목상권,1000353,노해로63다길,595,260,335
2017,1,A,골목상권,1000352,노해로60길,303,125,178
2017,1,A,골목상권,1000351,한천로140길,92,48,44
2017,1,A,골목상권,1000350,한천로139가길,43,24,19
2017,1,A,골목상권,1000349,한천로132길,324,132,192
2017,1,A,골목상권,1000348,한천로130길,289,125,164
2017,1,A,골목상권,1000347,한천로124나길,87,45,42
2017,1,A,골목상권,1000346,한천로109길,604,273,331
2017,1,A,골목상권,1000345,인수봉로79길,180,44,136
2017,1,A,골목상권,1000344,인수봉로72길,88,41,47
2017,1,A,골목상권,1000343,인수봉로56길,10,1,9
2017,1,A,골목상권,1000342,오패산로67길,538,282,256
2017,1,A,골목상권,1000341,오패산로52길,90,28,62
2017,1,A,골목상권,1000339,수유로12길,275,177,98
2017,1,A,골목상권,1000338,솔샘로65길,507,229,278
2017,1,A,골목상권,1000337,솔매로50길,720,289,431
2017,1,A,골목상권,1000336,솔매로45길,179,84,95
2017,1,A,골목상권,1000335,솔매로41길,80,21,59
2017,1,A,골목상권,1000334,삼양로93길,18,4,14
2017,1,A,골목상권,1000333,삼양로77길,398,133,265
2017,1,A,골목상권,1000332,삼양로54길,8,4,4
2017,1,A,골목상권,1000331,삼양로41길,289,129,160
2017,1,A,골목상권,1000329,삼양로24길,86,37,49
2017,1,A,골목상권,1000328,삼양로20길,128,46,82
2017,1,A,골목상권,1000327,삼각산로28길,742,391,351
2017,1,A,골목상권,1000326,도봉로99길,186,91,95
2017,1,A,골목상권,1000325,도봉로8길,239,170,69
2017,1,A,골목상권,1000324,도봉로76길,395,210,185
2017,1,A,골목상권,1000323,도봉로67길,5,3,2
2017,1,A,골목상권,1000322,도봉로45길,127,82,45
2017,1,A,골목상권,1000321,도봉로18길,383,167,216
2017,1,A,골목상권,1000320,도봉로13길,28,9,19
2017,1,A,골목상권,1000319,덕릉로41길,778,628,150
2017,1,A,골목상권,1000318,덕릉로40길,903,704,199
2017,1,A,골목상권,1000317,노해로33길,34,13,21
2017,1,A,골목상권,1000315,노해로17길,231,65,166
2017,1,A,골목상권,1000314,화랑로40길,152,82,70
2017,1,A,골목상권,1000313,화랑로32길,438,320,118
2017,1,A,골목상권,1000312,화랑로1길,176,93,83
2017,1,A,골목상권,1000311,화랑로19길,491,258,233
2017,1,A,골목상권,1000310,화랑로14길,56,24,32
2017,1,A,골목상권,1000309,화랑로13길,90,43,47
2017,1,A,골목상권,1000308,한천로76길,128,73,55
2017,1,A,골목상권,1000307,한천로101가길,50,30,20
2017,1,A,골목상권,1000306,창경궁로43길,29,17,12
2017,1,A,골목상권,1000305,지봉로20길,102,59,43
2017,1,A,골목상권,1000304,종암로5길,118,82,36
2017,1,A,골목상권,1000303,종암로24가길,272,136,136
2017,1,A,골목상권,1000302,종암로21길,142,51,91
2017,1,A,골목상권,1000301,종암로19길,406,121,285
2017,1,A,골목상권,1000300,종암로16길,79,33,46
2017,1,A,골목상권,1000299,정릉로8길,181,102,79
2017,1,A,골목상권,1000298,정릉로27길,205,87,118
2017,1,A,골목상권,1000296,장위로50길,906,505,401
2017,1,A,골목상권,1000295,장월로1길,432,190,242
2017,1,A,골목상권,1000294,인촌로6길,2459,1315,1144
2017,1,A,골목상권,1000293,인촌로5길,30,3,27
2017,1,A,골목상권,1000292,인촌로24길,198,133,65
2017,1,A,골목상권,1000291,개운사길,3303,2020,1283
2017,1,A,골목상권,1000290,인촌로1길,155,108,47
2017,1,A,골목상권,1000289,인촌로17가길,3197,1191,2006
2017,1,A,골목상권,1000288,오패산로4길,588,179,409
2017,1,A,골목상권,1000287,오패산로3길,1126,631,495
2017,1,A,골목상권,1000286,오패산로19길,43,17,26
2017,1,A,골목상권,1000285,안암로5길,605,358,247
2017,1,A,골목상권,1000284,아리랑로4길,615,234,381
2017,1,A,골목상권,1000283,솔샘로6길,146,69,77
2017,1,A,골목상권,1000282,성북로8길,50,23,27
2017,1,A,골목상권,1000281,삼양로8길,88,50,38
2017,1,A,골목상권,1000280,삼선교로16가길,712,408,304
2017,1,A,골목상권,1000279,삼선교로10다길,100,47,53
2017,1,A,골목상권,1000278,삼선교로10길,248,115,133
2017,1,A,골목상권,1000277,보문로32길,923,387,536
2017,1,A,골목상권,1000276,보문로31길,723,291,432
2017,1,A,골목상권,1000274,보문로13길,774,462,312
2017,1,A,골목상권,1000273,보국문로16길,296,198,98
2017,1,A,골목상권,1000270,동소문로26가길,289,164,125
2017,1,A,골목상권,1000269,동소문로15길,67,35,32
2017,1,A,골목상권,1000268,동소문로13길,412,217,195
2017,1,A,골목상권,1000267,돌곶이로8길,202,104,98
2017,1,A,골목상권,1000266,돌곶이로41길,59,30,29
2017,1,A,골목상권,1000265,돌곶이로28길,229,154,75
2017,1,A,골목상권,1000264,돌곶이로27길,71,39,32
2017,1,A,골목상권,1000263,돌곶이로22길,97,47,50
2017,1,A,골목상권,1000261,길음로7길,8,5,3
2017,1,A,골목상권,1000260,중랑천로10길,712,385,327
2017,1,A,골목상권,1000259,용마산로94길,441,266,175
2017,1,A,골목상권,1000258,용마산로118길,569,284,285
2017,1,A,골목상권,1000257,용마산로112길,291,133,158
2017,1,A,골목상권,1000256,용마산로100길,429,292,137
2017,1,A,골목상권,1000255,신내로7가길,265,69,196
2017,1,A,골목상권,1000254,사가정로54길,121,38,83
2017,1,A,골목상권,1000253,사가정로42길,66,19,47
2017,1,A,골목상권,1000252,봉화산로56길,573,141,432
2017,1,A,골목상권,1000251,봉화산로4길,400,139,261
2017,1,A,골목상권,1000250,봉화산로30길,380,242,138
2017,1,A,골목상권,1000249,봉우재로33길,109,41,68
2017,1,A,골목상권,1000248,면목로78길,306,166,140
2017,1,A,골목상권,1000247,면목로56길,222,161,61
2017,1,A,골목상권,1000246,면목로55길,436,133,303
2017,1,A,골목상권,1000245,면목로49길,541,175,366
2017,1,A,골목상권,1000244,면목로48길,118,58,60
2017,1,A,골목상권,1000243,면목로45길,66,28,38
2017,1,A,골목상권,1000242,면목로33길,397,156,241
2017,1,A,골목상권,1000241,면목로21길,45,33,12
2017,1,A,골목상권,1000240,망우로73길,8,4,4
2017,1,A,골목상권,1000239,망우로68길,84,36,48
2017,1,A,골목상권,1000238,동일로163길,104,66,38
2017,1,A,골목상권,1000237,동일로157길,193,96,97
2017,1,A,골목상권,1000236,동일로149길,1144,840,304
2017,1,A,골목상권,1000235,동일로140길,217,83,134
2017,1,A,골목상권,1000234,동일로139길,64,41,23
2017,1,A,골목상권,1000233,동일로139가길,1122,663,459
2017,1,A,골목상권,1000232,동일로130길,98,23,75
2017,1,A,골목상권,1000231,동일로123길,171,82,89
2017,1,A,골목상권,1000230,동일로112길,174,75,99
2017,1,A,골목상권,1000229,동일로101길,291,115,176
2017,1,A,골목상권,1000228,동일로100길,31,14,17
2017,1,A,골목상권,1000227,답십리로75길,99,53,46
2017,1,A,골목상권,1000226,공릉로2길,657,304,353
2017,1,A,골목상권,1000225,공릉로12가길,39,25,14
2017,1,A,골목상권,1000224,겸재로54길,116,58,58
2017,1,A,골목상권,1000223,겸재로36길,226,194,32
2017,1,A,골목상권,1000222,겸재로29길,435,187,248
2017,1,A,골목상권,1000221,휘경로3길,225,108,117
2017,1,A,골목상권,1000220,휘경로2길,7,3,4
2017,1,A,골목상권,1000219,휘경로23길,16,0,16
2017,1,A,골목상권,1000218,휘경로14길,104,42,62
2017,1,A,골목상권,1000217,한천로46길,391,131,260
2017,1,A,골목상권,1000216,한천로40길,316,160,156
2017,1,A,골목상권,1000215,한천로33길,74,30,44
2017,1,A,골목상권,1000214,한천로14길,621,371,250
2017,1,A,골목상권,1000213,천호대로97길,333,214,119
2017,1,A,골목상권,1000212,천호대로77길,2015,1067,948
2017,1,A,골목상권,1000211,천호대로45길,163,99,64
2017,1,A,골목상권,1000210,천호대로17길,2212,1415,797
2017,1,A,골목상권,1000209,천호대로12길,839,566,273
2017,1,A,골목상권,1000208,천장산로7길,1440,886,554
2017,1,A,골목상권,1000207,제기로5길,195,102,93
2017,1,A,골목상권,1000206,제기로21길,220,141,79
2017,1,A,골목상권,1000205,전농로4길,704,444,260
2017,1,A,골목상권,1000204,전농로3길,93,41,52
2017,1,A,골목상권,1000203,전농로29길,312,135,177
2017,1,A,골목상권,1000202,장한로8길,875,531,344
2017,1,A,골목상권,1000201,장한로5길,2868,2001,867
2017,1,A,골목상권,1000200,장한로27길,149,43,106
2017,1,A,골목상권,1000199,장한로27가길,383,180,203
2017,1,A,골목상권,1000198,장한로26길,592,286,306
2017,1,A,골목상권,1000197,장한로26가길,362,151,211
2017,1,A,골목상권,1000196,장한로25길,1071,467,604
2017,1,A,골목상권,1000195,장한로14길,184,154,30
2017,1,A,골목상권,1000194,이문로42길,263,108,155
2017,1,A,골목상권,1000193,왕산로43길,985,474,511
2017,1,A,골목상권,1000192,왕산로33길,153,103,50
2017,1,A,골목상권,1000191,왕산로32길,12,8,4
2017,1,A,골목상권,1000190,약령시로17길,277,137,140
2017,1,A,골목상권,1000189,서울시립대로4길,664,343,321
2017,1,A,골목상권,1000188,서울시립대로29길,246,137,109
2017,1,A,골목상권,1000187,서울시립대로16길,148,36,112
2017,1,A,골목상권,1000186,사가정로2길,85,65,20
2017,1,A,골목상권,1000185,사가정로23가길,102,60,42
2017,1,A,골목상권,1000184,사가정로13길,271,87,184
2017,1,A,골목상권,1000183,무학로45길,378,217,161
2017,1,A,골목상권,1000182,무학로16길,1141,1035,106
2017,1,A,골목상권,1000181,망우로21길,193,111,82
2017,1,A,골목상권,1000180,망우로18길,505,198,307
2017,1,A,골목상권,1000179,망우로18가길,71,30,41
2017,1,A,골목상권,1000178,답십리로72길,14,12,2
2017,1,A,골목상권,1000177,답십리로69길,909,392,517
2017,1,A,골목상권,1000176,답십리로68길,126,83,43
2017,1,A,골목상권,1000175,답십리로64길,349,201,148
2017,1,A,골목상권,1000174,답십리로63길,87,50,37
2017,1,A,골목상권,1000173,답십리로60길,11,7,4
2017,1,A,골목상권,1000172,답십리로56길,5,4,1
2017,1,A,골목상권,1000171,답십리로23길,7,6,1
2017,1,A,골목상권,1000170,난계로30길,156,109,47
2017,1,A,골목상권,1000168,경희대로3길,273,175,98
2017,1,A,골목상권,1000167,천호대로129길,238,79,159
2017,1,A,골목상권,1000166,천호대로123길,305,118,187
2017,1,A,골목상권,1000165,천호대로109길,1054,545,509
2017,1,A,골목상권,1000164,자양번영로3길,94,40,54
2017,1,A,골목상권,1000162,자양로50길,17,4,13
2017,1,A,골목상권,1000161,자양로45길,555,297,258
2017,1,A,골목상권,1000160,자양로26길,318,106,212
2017,1,A,골목상권,1000159,자양로15길,376,252,124
2017,1,A,골목상권,1000158,자양로11길,1405,698,707
2017,1,A,골목상권,1000157,용마산로3길,814,466,348
2017,1,A,골목상권,1000156,용마산로21길,139,55,84
2017,1,A,골목상권,1000155,아차산로78길,2663,1429,1234
2017,1,A,골목상권,1000154,아차산로65길,726,475,251
2017,1,A,골목상권,1000153,아차산로55길,389,189,200
2017,1,A,골목상권,1000152,아차산로51길,256,146,110
2017,1,A,골목상권,1000151,아차산로40길,489,288,201
2017,1,A,골목상권,1000150,면목로17길,244,160,84
2017,1,A,골목상권,1000149,뚝섬로64길,351,194,157
2017,1,A,골목상권,1000148,뚝섬로58길,188,63,125
2017,1,A,골목상권,1000147,뚝섬로54길,168,101,67
2017,1,A,골목상권,1000146,뚝섬로48길,796,331,465
2017,1,A,골목상권,1000145,뚝섬로24길,99,37,62
2017,1,A,골목상권,1000144,뚝섬로23길,109,69,40
2017,1,A,골목상권,1000143,동일로24길,8,3,5
2017,1,A,골목상권,1000142,동일로18길,168,68,100
2017,1,A,골목상권,1000141,능동로4길,248,107,141
2017,1,A,골목상권,1000140,능동로3길,209,97,112
2017,1,A,골목상권,1000139,능동로34길,924,516,408
2017,1,A,골목상권,1000138,능동로19길,323,202,121
2017,1,A,골목상권,1000137,능동로13길,352,115,237
2017,1,A,골목상권,1000136,긴고랑로9길,67,29,38
2017,1,A,골목상권,1000135,긴고랑로8길,218,195,23
2017,1,A,골목상권,1000134,긴고랑로7길,523,245,278
2017,1,A,골목상권,1000133,긴고랑로20길,542,250,292
2017,1,A,골목상권,1000132,광나루로52길,1649,843,806
2017,1,A,골목상권,1000131,광나루로40길,96,49,47
2017,1,A,골목상권,1000130,광나루로37길,303,184,119
2017,1,A,골목상권,1000129,광나루로36길,37,23,14
2017,1,A,골목상권,1000128,광나루로24길,59,30,29
2017,1,A,골목상권,1000127,광나루로12길,1010,568,442
2017,1,A,골목상권,1000126,한림말길,62,35,27
2017,1,A,골목상권,1000124,청계천로10나길,1810,1063,747
2017,1,A,골목상권,1000123,장터길,44,16,28
2017,1,A,골목상권,1000122,용답중앙길,93,52,41
2017,1,A,골목상권,1000121,용답29길,1871,946,925
2017,1,A,골목상권,1000120,왕십리로6길,1347,729,618
2017,1,A,골목상권,1000119,왕십리로31길,99,46,53
2017,1,A,골목상권,1000118,왕십리로26길,4367,2494,1873
2017,1,A,골목상권,1000117,왕십리로21길,174,54,120
2017,1,A,골목상권,1000116,왕십리로14길,2743,1994,749
2017,1,A,골목상권,1000115,아차산로5길,2285,1572,713
2017,1,A,골목상권,1000114,아차산로15길,4070,2933,1137
2017,1,A,골목상권,1000113,아차산로11길,3549,2306,1243
2017,1,A,골목상권,1000112,송정4가길,1062,500,562
2017,1,A,골목상권,1000111,송정12라길,284,183,101
2017,1,A,골목상권,1000110,성수일로6길,2471,1549,922
2017,1,A,골목상권,1000109,성수이로7길,416,266,150
2017,1,A,골목상권,1000108,성수이로18길,2204,1520,684
2017,1,A,골목상권,1000107,성덕정길,632,399,233
2017,1,A,골목상권,1000106,성덕정17길,219,119,100
2017,1,A,골목상권,1000105,서울숲2길,1426,823,603
2017,1,A,골목상권,1000104,상원길,1662,1127,535
2017,1,A,골목상권,1000103,상원12길,182,107,75
2017,1,A,골목상권,1000102,사근동길,31,17,14
2017,1,A,골목상권,1000101,무학봉길,3,3,0
2017,1,A,골목상권,1000100,무학봉28길,155,70,85
2017,1,A,골목상권,1000099,무학로6길,384,232,152
2017,1,A,골목상권,1000098,무수막길,118,54,64
2017,1,A,골목상권,1000097,매봉길,12,8,4
2017,1,A,골목상권,1000096,마조로1길,195,79,116
2017,1,A,골목상권,1000095,마조로16길,787,551,236
2017,1,A,골목상권,1000094,마장로39길,167,66,101
2017,1,A,골목상권,1000093,마장로27길,96,36,60
2017,1,A,골목상권,1000091,둘레9길,426,249,177
2017,1,A,골목상권,1000090,금호산길,420,153,267
2017,1,A,골목상권,1000089,금호산2길,35,15,20
2017,1,A,골목상권,1000088,고산자로6길,14618,5935,8683
2017,1,A,골목상권,1000087,후암로28길,199,85,114
2017,1,A,골목상권,1000086,효창원로39길,51,27,24
2017,1,A,골목상권,1000085,회나무로13길,62,36,26
2017,1,A,골목상권,1000084,한남대로20길,744,416,328
2017,1,A,골목상권,1000082,한강대로7길,598,399,199
2017,1,A,골목상권,1000081,한강대로62길,657,450,207
2017,1,A,골목상권,1000080,한강대로52길,1161,738,423
2017,1,A,골목상권,1000079,한강대로43길,4557,2880,1677
2017,1,A,골목상권,1000078,한강대로15길,1788,345,1443
2017,1,A,골목상권,1000077,한강대로104길,4287,3047,1240
2017,1,A,골목상권,1000076,청파로73길,1274,726,548
2017,1,A,골목상권,1000075,청파로71길,247,128,119
2017,1,A,골목상권,1000074,청파로47나길,121,80,41
2017,1,A,골목상권,1000073,청파로47길,819,397,422
2017,1,A,골목상권,1000072,장문로45길,72,11,61
2017,1,A,골목상권,1000071,이태원로54길,2204,1165,1039
2017,1,A,골목상권,1000070,이태원로27길,555,318,237
2017,1,A,골목상권,1000069,이촌로22길,224,140,84
2017,1,A,골목상권,1000068,원효로89길,935,758,177
2017,1,A,골목상권,1000067,원효로53길,723,423,300
2017,1,A,골목상권,1000066,원효로41길,2407,1698,709
2017,1,A,골목상권,1000065,원효로19길,956,669,287
2017,1,A,골목상권,1000064,우사단로4길,175,122,53
2017,1,A,골목상권,1000063,우사단로14길,1674,851,823
2017,1,A,골목상권,1000062,우사단로10길,60,30,30
2017,1,A,골목상권,1000061,신흥로20길,187,95,92
2017,1,A,골목상권,1000060,소월로20길,128,39,89
2017,1,A,골목상권,1000059,서빙고로71길,472,293,179
2017,1,A,골목상권,1000058,백범로90길,314,186,128
2017,1,A,골목상권,1000057,백범로79길,1059,642,417
2017,1,A,골목상권,1000056,두텁바위로1길,2649,1476,1173
2017,1,A,골목상권,1000055,대사관로34길,322,184,138
2017,1,A,골목상권,1000054,녹사평대로46길,59,46,13
2017,1,A,골목상권,1000053,녹사평대로40나길,55,32,23
2017,1,A,골목상권,1000052,녹사평대로32길,315,172,143
2017,1,A,골목상권,1000051,녹사평대로26길,2092,1145,947
2017,1,A,골목상권,1000050,녹사평대로11길,301,200,101
2017,1,A,골목상권,1000049,퇴계로90길,570,209,361
2017,1,A,골목상권,1000048,퇴계로8길,2379,1319,1060
2017,1,A,골목상권,1000047,퇴계로56길,1022,816,206
2017,1,A,골목상권,1000046,퇴계로46길,1934,785,1149
2017,1,A,골목상권,1000045,퇴계로18길,2880,1285,1595
2017,1,A,골목상권,1000044,퇴계로12길,953,434,519
2017,1,A,골목상권,1000043,청구로1길,211,107,104
2017,1,A,골목상권,1000042,청구로17길,1675,745,930
2017,1,A,골목상권,1000041,장충단로8길,4059,1289,2770
2017,1,A,골목상권,1000040,삼일대로4길,1005,599,406
2017,1,A,골목상권,1000039,명동길,36555,18129,18426
2017,1,A,골목상권,1000037,동호로20길,1014,446,568
2017,1,A,골목상권,1000036,동호로15길,4211,2228,1983
2017,1,A,골목상권,1000035,동호로11길,16,13,3
2017,1,A,골목상권,1000034,동호로10길,1473,644,829
2017,1,A,골목상권,1000033,다산로39길,1185,673,512
2017,1,A,골목상권,1000032,다산로38길,1495,758,737
2017,1,A,골목상권,1000031,다산로36길,65,42,23
2017,1,A,골목상권,1000030,다산로33길,412,196,216
2017,1,A,골목상권,1000029,난계로21길,210,140,70
2017,1,A,골목상권,1000028,난계로11길,1838,1064,774
2017,1,A,골목상권,1000027,필운대로1길,5,1,4
2017,1,A,골목상권,1000026,평창길,162,78,84
2017,1,A,골목상권,1000025,통일로12길,243,104,139
2017,1,A,골목상권,1000024,창신길,255,66,189
2017,1,A,골목상권,1000023,창신5길,7,3,4
2017,1,A,골목상권,1000022,창신2길,58,32,26
2017,1,A,골목상권,1000021,창경궁로35길,1426,405,1021
2017,1,A,골목상권,1000020,지봉로8길,153,79,74
2017,1,A,골목상권,1000019,종로65길,599,280,319
2017,1,A,골목상권,1000016,자하문로7길,473,255,218
2017,1,A,골목상권,1000015,이화장길,1960,932,1028
2017,1,A,골목상권,1000014,율곡로16길,96,84,12
2017,1,A,골목상권,1000013,율곡로10길,2312,1725,587
2017,1,A,골목상권,1000012,옥인길,472,201,271
2017,1,A,골목상권,1000011,숭인동길,19,9,10
2017,1,A,골목상권,1000010,성균관로5길,138,78,60
2017,1,A,골목상권,1000009,삼청로5길,413,153,260
2017,1,A,골목상권,1000008,북촌로5나길,1625,1122,503
2017,1,A,골목상권,1000007,북촌로5길,56,27,29
2017,1,A,골목상권,1000006,북촌로11길,18,10,8
2017,1,A,골목상권,1000005,백석동길,119,62,57
2017,1,A,골목상권,1000004,명륜길,20,12,8
2017,1,A,골목상권,1000003,돈화문로11가길,1079,571,508
2017,1,A,골목상권,1000001,계동길,809,345,464
2016,4,U,관광특구,1001496,강남 마이스 관광특구,22217,12970,9247
2016,4,U,관광특구,1001495,잠실 관광특구,27304,16146,11158
2016,4,U,관광특구,1001494,종로?청계 관광특구,30331,18443,11888
2016,4,U,관광특구,1001493,동대문패션타운 관광특구,9790,5637,4153
2016,4,U,관광특구,1001492,명동 남대문 북창동 다동 무교동 관광특구,168933,86535,82398
2016,4,U,관광특구,1001491,이태원 관광특구,5707,3283,2424
2016,4,R,전통시장,1001490,길동복조리시장,588,376,212
2016,4,R,전통시장,1001489,둔촌역전통시장,173,93,80
2016,4,R,전통시장,1001488,성내골목시장,6,2,4
2016,4,R,전통시장,1001487,천호시장,19,11,8
2016,4,R,전통시장,1001483,암사종합시장,717,321,396
2016,4,R,전통시장,1001482,고덕전통시장,370,358,12
2016,4,R,전통시장,1001481,명일골목시장,453,154,299
2016,4,R,전통시장,1001480,새마을시장,404,219,185
2016,4,R,전통시장,1001479,석촌시장,190,125,65
2016,4,R,전통시장,1001478,방이시장,660,416,244
2016,4,R,전통시장,1001477,마천시장,249,63,186
2016,4,R,전통시장,1001476,풍납시장,14,5,9
2016,4,R,전통시장,1001475,강남개포시장,41,33,8
2016,4,R,전통시장,1001474,도곡시장,489,215,274
2016,4,R,전통시장,1001471,영동전통시장,3023,2237,786
2016,4,R,전통시장,1001466,미성동도깨비시장,432,186,246
2016,4,R,전통시장,1001465,신신림시장,2,2,0
2016,4,R,전통시장,1001464,삼성동시장,104,45,59
2016,4,R,전통시장,1001463,신림중앙시장,12,7,5
2016,4,R,전통시장,1001462,강남골목시장,293,145,148
2016,4,R,전통시장,1001460,관악신사시장,293,228,65
2016,4,R,전통시장,1001459,신원시장,365,153,212
2016,4,R,전통시장,1001458,인헌시장,257,92,165
2016,4,R,전통시장,1001456,봉천현대시장,9,4,5
2016,4,R,전통시장,1001454,봉천제일종합시장,49,24,25
2016,4,R,전통시장,1001453,낙성대시장,20,11,9
2016,4,R,전통시장,1001452,중부시장,186,64,122
2016,4,R,전통시장,1001450,남성역골목시장,512,237,275
2016,4,R,전통시장,1001449,남성사계시장,1874,821,1053
2016,4,R,전통시장,1001448,흑석시장,180,71,109
2016,4,R,전통시장,1001447,상도4동도깨비골목시장,312,76,236
2016,4,R,전통시장,1001445,영도시장,69,32,37
2016,4,R,전통시장,1001441,본동인정시장,116,56,60
2016,4,R,전통시장,1001439,대림중앙시장,29,18,11
2016,4,R,전통시장,1001438,우리시장,15,7,8
2016,4,R,전통시장,1001437,영진시장A동,36,29,7
2016,4,R,전통시장,1001436,사러가시장,24,8,16
2016,4,R,전통시장,1001431,영등포청과시장,189,121,68
2016,4,R,전통시장,1001430,영등포전통시장,4030,1988,2042
2016,4,R,전통시장,1001429,은행나무시장,39,8,31
2016,4,R,전통시장,1001427,현대시장,56,16,40
2016,4,R,전통시장,1001424,남문시장,288,111,177
2016,4,R,전통시장,1001423,독산동 우시장,138,55,83
2016,4,R,전통시장,1001421,개봉중앙시장,7,3,4
2016,4,R,전통시장,1001419,가리봉시장,18,10,8
2016,4,R,전통시장,1001418,남구로시장,17,3,14
2016,4,R,전통시장,1001417,구로시장,47,17,30
2016,4,R,전통시장,1001415,방신전통시장,128,111,17
2016,4,R,전통시장,1001414,송화골목시장,500,188,312
2016,4,R,전통시장,1001413,까치산시장,35,24,11
2016,4,R,전통시장,1001411,남부골목시장,200,87,113
2016,4,R,전통시장,1001409,화곡중앙골목시장,2,2,0
2016,4,R,전통시장,1001407,등마루시장,814,464,350
2016,4,R,전통시장,1001406,신정3동골목시장,211,103,108
2016,4,R,전통시장,1001405,신정2동골목시장,9,6,3
2016,4,R,전통시장,1001402,신월6동골목시장,237,110,127
2016,4,R,전통시장,1001401,신곡종합시장,12,9,3
2016,4,R,전통시장,1001400,신월3동골목시장,52,15,37
2016,4,R,전통시장,1001399,경창시장,185,81,104
2016,4,R,전통시장,1001398,월정로시장,113,67,46
2016,4,R,전통시장,1001397,신영시장,50,24,26
2016,4,R,전통시장,1001396,목4동시장,235,81,154
2016,4,R,전통시장,1001395,목3동시장,714,346,368
2016,4,R,전통시장,1001394,목2동시장,239,109,130
2016,4,R,전통시장,1001393,마포농수산물시장,504,309,195
2016,4,R,전통시장,1001391,망원월드컵시장,13,9,4
2016,4,R,전통시장,1001390,망원시장,34,18,16
2016,4,R,전통시장,1001386,신수시장,116,84,32
2016,4,R,전통시장,1001385,아현시장,22,3,19
2016,4,R,전통시장,1001374,대림골목시장,300,98,202
2016,4,R,전통시장,1001367,상계중앙시장,26,11,15
2016,4,R,전통시장,1001364,방학동도깨비시장,150,57,93
2016,4,R,전통시장,1001363,쌍문역골목시장,70,33,37
2016,4,R,전통시장,1001361,신도봉시장,24,15,9
2016,4,R,전통시장,1001359,창동신창시장,152,65,87
2016,4,R,전통시장,1001358,수유북부시장,12,4,8
2016,4,R,전통시장,1001357,장미원골목시장,74,44,30
2016,4,R,전통시장,1001356,수유중앙시장,136,74,62
2016,4,R,전통시장,1001355,강북종합시장,75,30,45
2016,4,R,전통시장,1001354,우이시장,146,57,89
2016,4,R,전통시장,1001353,수유전통시장,448,135,313
2016,4,R,전통시장,1001352,번동북부골목시장,80,45,35
2016,4,R,전통시장,1001351,솔샘시장,105,40,65
2016,4,R,전통시장,1001349,방천골목시장,78,25,53
2016,4,R,전통시장,1001347,석관황금시장,53,17,36
2016,4,R,전통시장,1001343,장위전통시장,181,66,115
2016,4,R,전통시장,1001340,정릉시장,36,15,21
2016,4,R,전통시장,1001339,정릉아리랑시장,2,1,1
2016,4,R,전통시장,1001338,돈암제일시장,59,24,35
2016,4,R,전통시장,1001336,우림골목시장,214,101,113
2016,4,R,전통시장,1001335,묵1동도깨비시장,285,131,154
2016,4,R,전통시장,1001334,태능시장,4,3,1
2016,4,R,전통시장,1001333,중화제일시장,24,1,23
2016,4,R,전통시장,1001332,사가정시장,245,185,60
2016,4,R,전통시장,1001330,동원시장,80,33,47
2016,4,R,전통시장,1001329,동부골목시장,92,31,61
2016,4,R,전통시장,1001326,회기시장,127,57,70
2016,4,R,전통시장,1001323,답십리시장,29,10,19
2016,4,R,전통시장,1001321,답십리현대시장,89,75,14
2016,4,R,전통시장,1001319,청량리종합시장,7,5,2
2016,4,R,전통시장,1001317,청량리농수산물시장,20,16,4
2016,4,R,전통시장,1001316,서울약령시장,1356,814,542
2016,4,R,전통시장,1001313,청량리수산시장,233,117,116
2016,4,R,전통시장,1001310,구의시장,97,60,37
2016,4,R,전통시장,1001309,조양시장,91,49,42
2016,4,R,전통시장,1001308,영동교골목시장,14,10,4
2016,4,R,전통시장,1001307,능동로골목시장,269,239,30
2016,4,R,전통시장,1001304,자양골목시장,94,47,47
2016,4,R,전통시장,1001301,중곡제일시장,140,77,63
2016,4,R,전통시장,1001299,한아름시장,133,71,62
2016,4,R,전통시장,1001298,성동용답상가시장,296,156,140
2016,4,R,전통시장,1001297,뚝도시장,31,11,20
2016,4,R,전통시장,1001296,금남시장,26,14,12
2016,4,R,전통시장,1001295,행당시장,237,115,122
2016,4,R,전통시장,1001294,마장축산물시장,1520,1001,519
2016,4,R,전통시장,1001289,용문전통시장,40,23,17
2016,4,R,전통시장,1001286,후암시장,51,19,32
2016,4,R,전통시장,1001285,합동(새벽)시장,2330,1295,1035
2016,4,R,전통시장,1001284,서울중앙시장,238,166,72
2016,4,R,전통시장,1001283,백학시장,454,236,218
2016,4,R,전통시장,1001282,약수시장,1689,679,1010
2016,4,R,전통시장,1001281,청평화시장,2995,1890,1105
2016,4,R,전통시장,1001280,제일평화시장,515,315,200
2016,4,R,전통시장,1001278,남평화시장,198,123,75
2016,4,R,전통시장,1001277,방산종합시장,1825,1178,647
2016,4,R,전통시장,1001275,인현시장,1175,746,429
2016,4,R,전통시장,1001274,신중부시장,2452,1643,809
2016,4,R,전통시장,1001273,남대문시장,7087,3729,3358
2016,4,R,전통시장,1001271,동묘시장,931,596,335
2016,4,R,전통시장,1001270,창신골목시장,232,122,110
2016,4,R,전통시장,1001268,충신시장,340,206,134
2016,4,R,전통시장,1001267,종로신진시장,28,11,17
2016,4,R,전통시장,1001266,동대문종합시장,344,186,158
2016,4,R,전통시장,1001265,광장시장,199,142,57
2016,4,D,발달상권,1001263,서울 노원구 노원역_3,789,318,471
2016,4,D,발달상권,1001261,서울 노원구 노원역_1,954,308,646
2016,4,D,발달상권,1001260,창동역,2418,1549,869
2016,4,D,발달상권,1001259,서울 강북구 수유역_3,64,31,33
2016,4,D,발달상권,1001257,서울 강북구 수유역_2,4155,2143,2012
2016,4,D,발달상권,1001256,서울 강북구 수유역_1,109,86,23
2016,4,D,발달상권,1001255,서울 은평구 연신내역_3,634,192,442
2016,4,D,발달상권,1001254,서울 은평구 연신내역_2,444,178,266
2016,4,D,발달상권,1001253,서울 은평구 연신내역_1,89,38,51
2016,4,D,발달상권,1001252,서울 성북구 미아삼거리역_2,522,230,292
2016,4,D,발달상권,1001251,서울 강북구 미아삼거리역_1,526,185,341
2016,4,D,발달상권,1001250,서울 은평구 불광역_3,55,20,35
2016,4,D,발달상권,1001249,서울 은평구 불광역_2,72,28,44
2016,4,D,발달상권,1001248,서울 은평구 불광역_1,253,102,151
2016,4,D,발달상권,1001247,미아사거리_2,99,22,77
2016,4,D,발달상권,1001246,미아사거리_1,559,251,308
2016,4,D,발달상권,1001245,서울 성북구 성신여대입구역,4901,2999,1902
2016,4,D,발달상권,1001244,경희대학교,377,169,208
2016,4,D,발달상권,1001243,서울 성북구 안암역,98,58,40
2016,4,D,발달상권,1001242,혜화역 대학로_3,1703,823,880
2016,4,D,발달상권,1001241,혜화역 대학로_2,1367,786,581
2016,4,D,발달상권,1001240,혜화역 대학로_1,1307,657,650
2016,4,D,발달상권,1001239,디지털미디어시티,22582,13467,9115
2016,4,D,발달상권,1001238,서울 동대문구 청량리역,3236,2064,1172
2016,4,D,발달상권,1001236,서울 종로구 안국역_2,736,290,446
2016,4,D,발달상권,1001235,서울 종로구 안국역_1,11654,9505,2149
2016,4,D,발달상권,1001234,서울 종로구 경복궁역_1,227,89,138
2016,4,D,발달상권,1001233,서울 종로구 종로3가역_3,3218,1728,1490
2016,4,D,발달상권,1001232,서울 종로구 종로3가역_2,1846,1006,840
2016,4,D,발달상권,1001231,서울 동대문구 신설동역_2,4363,2173,2190
2016,4,D,발달상권,1001230,인사동,21106,13041,8065
2016,4,D,발달상권,1001229,서울 종로구 종로5가역_4,683,368,315
2016,4,D,발달상권,1001228,서울 종로구 종로5가역_3,5230,3538,1692
2016,4,D,발달상권,1001227,종로구청,15806,9092,6714
2016,4,D,발달상권,1001226,서울 종로구 종로5가역_2,18935,12659,6276
2016,4,D,발달상권,1001225,신설동역,753,444,309
2016,4,D,발달상권,1001224,서울 동대문구 신설동역_1,2,2,0
2016,4,D,발달상권,1001223,서울 종로구 광화문역_2,52781,32166,20615
2016,4,D,발달상권,1001222,동묘앞역,62,40,22
2016,4,D,발달상권,1001221,장안동사거리,535,260,275
2016,4,D,발달상권,1001220,서울 종로구 동대문역_2,1053,553,500
2016,4,D,발달상권,1001218,동대문시장_2,485,305,180
2016,4,D,발달상권,1001217,서울 종로구 종로5가역_1,55,40,15
2016,4,D,발달상권,1001216,서울 종로구 종로3가역_1,3445,1488,1957
2016,4,D,발달상권,1001215,서울 종로구 광화문역_1,2295,1489,806
2016,4,D,발달상권,1001214,종각역,20605,13388,7217
2016,4,D,발달상권,1001213,종각역 젊음의 거리,2111,935,1176
2016,4,D,발달상권,1001212,서대문구 서대문역_1,355,244,111
2016,4,D,발달상권,1001211,동대문시장_1,413,222,191
2016,4,D,발달상권,1001210,시청역_2,22170,14245,7925
2016,4,D,발달상권,1001209,서울시청,23470,11511,11959
2016,4,D,발달상권,1001208,서울 중구 을지로3가역_2,7984,5201,2783
2016,4,D,발달상권,1001207,서울 중구 신당역_2,1365,677,688
2016,4,D,발달상권,1001206,서대문구 서대문역_2,2006,1366,640
2016,4,D,발달상권,1001205,동대문역사문화공원역,3918,2758,1160
2016,4,D,발달상권,1001204,서울 중구 을지로3가역_1,14332,9607,4725
2016,4,D,발달상권,1001203,명동거리,25479,11847,13632
2016,4,D,발달상권,1001202,롯데백화점,40328,22703,17625
2016,4,D,발달상권,1001201,서울 중구 신당역_1,1042,671,371
2016,4,D,발달상권,1001200,북창동,7810,4733,3077
2016,4,D,발달상권,1001199,서울 중구 충무로역_2,14143,6245,7898
2016,4,D,발달상권,1001198,서울 강서구 송정역,763,512,251
2016,4,D,발달상권,1001197,장한평역_2,11959,9580,2379
2016,4,D,발달상권,1001196,시청역_1,55429,33447,21982
2016,4,D,발달상권,1001195,왕십리역_2,655,281,374
2016,4,D,발달상권,1001194,서울 강서구 발산역,792,471,321
2016,4,D,발달상권,1001193,장한평역_1,2400,1569,831
2016,4,D,발달상권,1001192,서울 중구 충무로역_1,3168,2226,942
2016,4,D,발달상권,1001190,장한평역,2188,1538,650
2016,4,D,발달상권,1001189,서울 중구 명동역,3694,1878,1816
2016,4,D,발달상권,1001188,장충동 족발거리,198,93,105
2016,4,D,발달상권,1001187,한양시장,277,140,137
2016,4,D,발달상권,1001186,서울 서대문구 이대역,1275,511,764
2016,4,D,발달상권,1001185,서울 서대문구 신촌역,3003,1231,1772
2016,4,D,발달상권,1001184,서울 마포구 홍대입구역_3,411,272,139
2016,4,D,발달상권,1001183,서울 마포구 홍대입구역_2,3152,1229,1923
2016,4,D,발달상권,1001182,홍익대학교 주변,15066,7581,7485
2016,4,D,발달상권,1001181,서울 광진구 군자역,181,106,75
2016,4,D,발달상권,1001180,신촌역,236,116,120
2016,4,D,발달상권,1001179,강서구청,3455,2273,1182
2016,4,D,발달상권,1001178,서울 마포구 홍대입구역_1,821,462,359
2016,4,D,발달상권,1001175,서울 강동구 고덕역,490,268,222
2016,4,D,발달상권,1001173,서울 강동구 명일역,856,356,500
2016,4,D,발달상권,1001172,어린이대공원역,97,61,36
2016,4,D,발달상권,1001171,서울 마포구 공덕역_2,4124,2406,1718
2016,4,D,발달상권,1001170,공덕역,7228,4383,2845
2016,4,D,발달상권,1001169,서울 용산구 숙대입구역,4416,3093,1323
2016,4,D,발달상권,1001168,남영역,14242,6249,7993
2016,4,D,발달상권,1001167,서울 마포구 공덕역_1,4647,2279,2368
2016,4,D,발달상권,1001166,서울 마포구 마포역_2,1240,701,539
2016,4,D,발달상권,1001165,서울 광진구 건대입구역_2,2838,993,1845
2016,4,D,발달상권,1001164,서울 마포구 마포역_1,11532,6888,4644
2016,4,D,발달상권,1001163,서울 강동구 천호역_2,3826,1909,1917
2016,4,D,발달상권,1001162,서울 광진구 건대입구역_1,944,457,487
2016,4,D,발달상권,1001161,건대입구역,722,386,336
2016,4,D,발달상권,1001160,서울 광진구 구의역,865,529,336
2016,4,D,발달상권,1001159,서울 강동구 천호역,1029,496,533
2016,4,D,발달상권,1001158,당산역_2,5271,3295,1976
2016,4,D,발달상권,1001156,서울 강동구 길동역,1208,696,512
2016,4,D,발달상권,1001155,용산 전자상가_5,2380,1741,639
2016,4,D,발달상권,1001153,당산역_1,1102,696,406
2016,4,D,발달상권,1001152,서울 광진구 강변역,2126,1743,383
2016,4,D,발달상권,1001151,용산 전자상가_3,2451,1760,691
2016,4,D,발달상권,1001150,서울 용산구 이태원역,642,389,253
2016,4,D,발달상권,1001149,한남오거리,664,339,325
2016,4,D,발달상권,1001147,용산 전자상가_2,470,378,92
2016,4,D,발달상권,1001146,용산구청,99,68,31
2016,4,D,발달상권,1001145,용산 전자상가_1,8011,6075,1936
2016,4,D,발달상권,1001144,국회의사당역_2,40592,24030,16562
2016,4,D,발달상권,1001143,서울 용산구 신용산역,458,209,249
2016,4,D,발달상권,1001142,국회의사당역_1,5643,4377,1266
2016,4,D,발달상권,1001141,압구정 로데오거리_2,15549,6626,8923
2016,4,D,발달상권,1001140,서울 강남구 압구정역,10779,4899,5880
2016,4,D,발달상권,1001139,서울 영등포구 영등포구청역,3655,1134,2521
2016,4,D,발달상권,1001138,압구정 로데오거리_1,7361,2408,4953
2016,4,D,발달상권,1001137,서울 강동구 둔촌동역,53,15,38
2016,4,D,발달상권,1001136,오목교역,206,88,118
2016,4,D,발달상권,1001135,신사동 가로수길,21404,10157,11247
2016,4,D,발달상권,1001134,서울 영등포구 여의도역_2,48066,31797,16269
2016,4,D,발달상권,1001133,청담사거리_3,1456,503,953
2016,4,D,발달상권,1001132,영등포유통상가,2068,1285,783
2016,4,D,발달상권,1001131,청담역_2,1310,946,364
2016,4,D,발달상권,1001130,청담역_1,187,146,41
2016,4,D,발달상권,1001129,청담사거리_2,987,736,251
2016,4,D,발달상권,1001127,서울 영등포구 여의도역_1,53560,31778,21782
2016,4,D,발달상권,1001125,학동사거리_2,3104,1807,1297
2016,4,D,발달상권,1001124,서울 영등포구 영등포시장역,328,254,74
2016,4,D,발달상권,1001123,학동사거리_1,4086,2051,2035
2016,4,D,발달상권,1001122,여의도 시범아파트앞,2243,1442,801
2016,4,D,발달상권,1001121,영등포역_3,815,480,335
2016,4,D,발달상권,1001120,도산공원사거리_1,9677,5729,3948
2016,4,D,발달상권,1001119,영등포역_2,1152,629,523
2016,4,D,발달상권,1001118,문래동 주민센터,76,65,11
2016,4,D,발달상권,1001117,강남구 신사역_2,8379,5347,3032
2016,4,D,발달상권,1001115,서울 강남구 강남구청역_2,4618,2953,1665
2016,4,D,발달상권,1001114,강남구 신사역_1,2574,1128,1446
2016,4,D,발달상권,1001113,서울 동작구 노량진1동_1,31,19,12
2016,4,D,발달상권,1001112,서울 강남구 학동역_3,9202,5236,3966
2016,4,D,발달상권,1001111,서울 강남구 강남구청역_1,3057,1910,1147
2016,4,D,발달상권,1001110,잠실역,5718,4339,1379
2016,4,D,발달상권,1001109,강남구 논현역_4,7327,3722,3605
2016,4,D,발달상권,1001108,학동역,1409,575,834
2016,4,D,발달상권,1001107,방이동 먹자골목,4916,3118,1798
2016,4,D,발달상권,1001106,서울 강남구 학동역_2,5486,2854,2632
2016,4,D,발달상권,1001105,서울 동작구 노량진역,3618,2085,1533
2016,4,D,발달상권,1001104,삼성역_3,8659,5031,3628
2016,4,D,발달상권,1001103,코엑스,22217,12970,9247
2016,4,D,발달상권,1001102,서울 강남구 학동역_1,5071,3253,1818
2016,4,D,발달상권,1001101,선정릉역_2,6768,4248,2520
2016,4,D,발달상권,1001100,강남구 논현역_3,1498,853,645
2016,4,D,발달상권,1001099,포스코사거리_2,7170,4626,2544
2016,4,D,발달상권,1001098,포스코사거리_1,49794,33323,16471
2016,4,D,발달상권,1001097,잠실역 롯데월드,3312,1662,1650
2016,4,D,발달상권,1001096,신도림역,3445,1913,1532
2016,4,D,발달상권,1001095,강남구 논현역_2,8038,3913,4125
2016,4,D,발달상권,1001094,선정릉역_1,1734,1219,515
2016,4,D,발달상권,1001093,신천역,6159,3308,2851
2016,4,D,발달상권,1001092,강남구 논현역_1,3678,2102,1576
2016,4,D,발달상권,1001091,삼성역_2,17789,10599,7190
2016,4,D,발달상권,1001090,삼정역_2,2864,1305,1559
2016,4,D,발달상권,1001089,삼정역_1,2888,1567,1321
2016,4,D,발달상권,1001088,삼성역_1,30235,20031,10204
2016,4,D,발달상권,1001087,서울 강남구 선릉역_2,7549,4891,2658
2016,4,D,발달상권,1001086,고속터미널역,15664,4734,10930
2016,4,D,발달상권,1001085,서울 서초구 강남역,34665,19651,15014
2016,4,D,발달상권,1001084,서울 강남구 선릉역_1,19335,8122,11213
2016,4,D,발달상권,1001082,선릉역_2,20206,10619,9587
2016,4,D,발달상권,1001081,서울 강남구 역삼역_2,26179,20575,5604
2016,4,D,발달상권,1001080,서울 송파구 석촌역_1,39,28,11
2016,4,D,발달상권,1001078,서울 강남구 강남역_2,5718,3389,2329
2016,4,D,발달상권,1001077,선릉역_1,53672,28879,24793
2016,4,D,발달상권,1001076,구로역,161,96,65
2016,4,D,발달상권,1001075,역삼역_2,4289,2416,1873
2016,4,D,발달상권,1001074,대림역_2,6960,5243,1717
2016,4,D,발달상권,1001073,서울 강남구 역삼역_1,26619,16617,10002
2016,4,D,발달상권,1001072,신대방삼거리역,295,133,162
2016,4,D,발달상권,1001071,서울 강남구 한티역,1079,407,672
2016,4,D,발달상권,1001070,은마아파트입구사거리_4,88,52,36
2016,4,D,발달상권,1001067,오류동역,1520,756,764
2016,4,D,발달상권,1001066,서울 강남구 강남역,39329,18700,20629
2016,4,D,발달상권,1001063,교대역_4,5609,3133,2476
2016,4,D,발달상권,1001062,서울 강남구 강남역_1,131760,97349,34411
2016,4,D,발달상권,1001061,방배동카페골목,109,46,63
2016,4,D,발달상권,1001060,가락시장,16218,10235,5983
2016,4,D,발달상권,1001059,교대역_3,4386,2689,1697
2016,4,D,발달상권,1001058,역삼역_1,1750,1110,640
2016,4,D,발달상권,1001057,교대역_2,3525,2243,1282
2016,4,D,발달상권,1001056,서울 송파구 가락시장역,5325,3543,1782
2016,4,D,발달상권,1001055,서울 서초구 서초역,12162,5027,7135
2016,4,D,발달상권,1001054,서울 강남구 대치역_2,1479,889,590
2016,4,D,발달상권,1001052,뱅뱅사거리_2,24941,15931,9010
2016,4,D,발달상권,1001051,보라매공원,14103,8045,6058
2016,4,D,발달상권,1001050,교대역_1,13196,7905,5291
2016,4,D,발달상권,1001049,개봉동 현대아파트 인근,155,72,83
2016,4,D,발달상권,1001048,뱅뱅사거리,7125,4742,2383
2016,4,D,발달상권,1001047,뱅뱅사거리_1,10353,7297,3056
2016,4,D,발달상권,1001046,서울 관악구 신림역_4,920,434,486
2016,4,D,발달상권,1001045,동작구 총신대입구역_1,214,98,116
2016,4,D,발달상권,1001044,양재역_3,3515,2418,1097
2016,4,D,발달상권,1001043,동작구 총신대입구역_2,841,360,481
2016,4,D,발달상권,1001042,서울 서초구 남부터미널역_3,1526,870,656
2016,4,D,발달상권,1001041,서울 강남구 수서역,19103,11144,7959
2016,4,D,발달상권,1001039,서울 서초구 남부터미널역_2,11569,5628,5941
2016,4,D,발달상권,1001038,구로디지탈1단지,65309,41753,23556
2016,4,D,발달상권,1001037,양재역,119,57,62
2016,4,D,발달상권,1001035,매봉역,538,229,309
2016,4,D,발달상권,1001034,서울 서초구 방배역,3625,2132,1493
2016,4,D,발달상권,1001033,서울 서초구 남부터미널역_1,552,397,155
2016,4,D,발달상권,1001032,서울 관악구 신림역_2,31,15,16
2016,4,D,발달상권,1001031,서울 관악구 신림역_1,1925,920,1005
2016,4,D,발달상권,1001030,양재역_2,8950,5008,3942
2016,4,D,발달상권,1001029,양재역_1,1022,722,300
2016,4,D,발달상권,1001028,서울 관악구 서울대입구역_2,42,4,38
2016,4,D,발달상권,1001027,가산디지털단지역_3,31303,18640,12663
2016,4,D,발달상권,1001026,구로디지털단지역,2148,1390,758
2016,4,D,발달상권,1001025,서울 관악구 서울대입구역_1,1963,832,1131
2016,4,D,발달상권,1001024,관악구 사당역_1,3907,1603,2304
2016,4,D,발달상권,1001023,가산디지털단지역_2,61605,36900,24705
2016,4,D,발달상권,1001022,관악구 사당역_2,345,181,164
2016,4,D,발달상권,1001021,가산디지털단지역_1,26323,17730,8593
2016,4,D,발달상권,1001020,장지역,4333,2747,1586
2016,4,D,발달상권,1001019,포이사거리_1,5741,3052,2689
2016,4,D,발달상권,1001018,포이사거리_2,8907,6328,2579
2016,4,D,발달상권,1001016,서울 관악구 대학동_1,82,49,33
2016,4,D,발달상권,1001015,서울 금천구 독산1동_1,3007,2040,967
2016,4,D,발달상권,1001013,양재 화물트럭터미널앞_2,178,77,101
2016,4,D,발달상권,1001012,양재 화물트럭터미널앞_1,4379,3453,926
2016,4,D,발달상권,1001011,서울 금천구 시흥1동_4,931,471,460
2016,4,A,골목상권,1001010,풍성로37가길,36,16,20
2016,4,A,골목상권,1001009,천호옛길,556,365,191
2016,4,A,골목상권,1001008,천호옛14길,594,280,314
2016,4,A,골목상권,1001007,천호대로219길,918,557,361
2016,4,A,골목상권,1001006,천호대로197길,17,5,12
2016,4,A,골목상권,1001005,천호대로187길,874,503,371
2016,4,A,골목상권,1001004,천호대로170길,416,173,243
2016,4,A,골목상권,1001003,천호대로162길,1293,928,365
2016,4,A,골목상권,1001002,천중로51길,436,228,208
2016,4,A,골목상권,1001001,천중로39길,584,206,378
2016,4,A,골목상권,1001000,진황도로47길,1359,694,665
2016,4,A,골목상권,1000999,진황도로27길,490,286,204
2016,4,A,골목상권,1000998,올림픽로98길,41,18,23
2016,4,A,골목상권,1000997,올림픽로80길,2,1,1
2016,4,A,골목상권,1000995,올림픽로77길,13,6,7
2016,4,A,골목상권,1000994,올림픽로71길,405,305,100
2016,4,A,골목상권,1000993,올림픽로48길,5800,3487,2313
2016,4,A,골목상권,1000992,양재대로96길,1313,784,529
2016,4,A,골목상권,1000991,양재대로95길,718,385,333
2016,4,A,골목상권,1000990,양재대로91길,1187,658,529
2016,4,A,골목상권,1000989,양재대로133길,309,112,197
2016,4,A,골목상권,1000988,양재대로124길,632,396,236
2016,4,A,골목상권,1000987,양재대로116길,218,91,127
2016,4,A,골목상권,1000986,양재대로101길,1196,691,505
2016,4,A,골목상권,1000985,암사길,368,163,205
2016,4,A,골목상권,1000984,성안로3길,1614,1048,566
2016,4,A,골목상권,1000983,성내로5길,1084,552,532
2016,4,A,골목상권,1000982,상일로5길,56,33,23
2016,4,A,골목상권,1000981,상암로5길,625,275,350
2016,4,A,골목상권,1000980,상암로51길,762,324,438
2016,4,A,골목상권,1000979,상암로4길,267,212,55
2016,4,A,골목상권,1000978,상암로14길,485,304,181
2016,4,A,골목상권,1000977,명일로13길,121,46,75
2016,4,A,골목상권,1000976,동남로85길,130,67,63
2016,4,A,골목상권,1000975,동남로82길,10,3,7
2016,4,A,골목상권,1000974,동남로65길,72,24,48
2016,4,A,골목상권,1000973,구천면로42길,384,187,197
2016,4,A,골목상권,1000972,구천면로41길,603,255,348
2016,4,A,골목상권,1000971,구천면로36길,61,38,23
2016,4,A,골목상권,1000969,고덕로25길,22,12,10
2016,4,A,골목상권,1000968,고덕로10길,191,86,105
2016,4,A,골목상권,1000967,강동대로53길,900,498,402
2016,4,A,골목상권,1000966,풍성로25길,788,287,501
2016,4,A,골목상권,1000965,오금로46길,1421,721,700
2016,4,A,골목상권,1000964,오금로36길,1270,958,312
2016,4,A,골목상권,1000963,오금로11길,2197,1415,782
2016,4,A,골목상권,1000962,양재대로72길,693,378,315
2016,4,A,골목상권,1000961,양재대로71길,1292,776,516
2016,4,A,골목상권,1000960,양재대로64길,1522,596,926
2016,4,A,골목상권,1000959,양재대로62길,6352,3824,2528
2016,4,A,골목상권,1000958,송파대로30길,1749,1116,633
2016,4,A,골목상권,1000957,송이로36길,2070,1497,573
2016,4,A,골목상권,1000956,송이로32길,773,415,358
2016,4,A,골목상권,1000955,송이로23길,1272,788,484
2016,4,A,골목상권,1000954,삼전로13길,1626,813,813
2016,4,A,골목상권,1000953,백제고분로50길,3386,1663,1723
2016,4,A,골목상권,1000952,백제고분로46길,1791,1146,645
2016,4,A,골목상권,1000951,백제고분로45길,498,333,165
2016,4,A,골목상권,1000950,백제고분로42길,132,76,56
2016,4,A,골목상권,1000949,백제고분로39길,1583,1110,473
2016,4,A,골목상권,1000948,백제고분로34길,1727,1128,599
2016,4,A,골목상권,1000947,백제고분로33길,1017,645,372
2016,4,A,골목상권,1000946,백제고분로32길,1092,462,630
2016,4,A,골목상권,1000945,백제고분로31길,336,212,124
2016,4,A,골목상권,1000944,백제고분로22길,1009,584,425
2016,4,A,골목상권,1000943,백제고분로21길,206,149,57
2016,4,A,골목상권,1000942,마천로51길,130,56,74
2016,4,A,골목상권,1000941,동남로20길,155,92,63
2016,4,A,골목상권,1000940,거마로20길,486,203,283
2016,4,A,골목상권,1000939,학동로77길,2965,1547,1418
2016,4,A,골목상권,1000938,학동로6길,1919,944,975
2016,4,A,골목상권,1000937,학동로56길,907,505,402
2016,4,A,골목상권,1000936,학동로38길,6646,4231,2415
2016,4,A,골목상권,1000935,테헤란로81길,573,207,366
2016,4,A,골목상권,1000934,일원로9길,558,293,265
2016,4,A,골목상권,1000933,일원로3길,227,111,116
2016,4,A,골목상권,1000932,영동대로65길,3117,1828,1289
2016,4,A,골목상권,1000931,영동대로112길,661,410,251
2016,4,A,골목상권,1000930,언주로81길,9257,4736,4521
2016,4,A,골목상권,1000929,압구정로2길,2790,1488,1302
2016,4,A,골목상권,1000928,선릉로18길,426,227,199
2016,4,A,골목상권,1000927,선릉로146길,1884,983,901
2016,4,A,골목상권,1000926,선릉로133길,187,102,85
2016,4,A,골목상권,1000925,선릉로132길,1019,555,464
2016,4,A,골목상권,1000924,선릉로121길,1868,974,894
2016,4,A,골목상권,1000923,삼성로75길,2696,1435,1261
2016,4,A,골목상권,1000922,삼성로69길,316,146,170
2016,4,A,골목상권,1000921,삼성로64길,537,258,279
2016,4,A,골목상권,1000920,삼성로63길,151,68,83
2016,4,A,골목상권,1000919,삼성로57길,867,275,592
2016,4,A,골목상권,1000918,삼성로147길,970,394,576
2016,4,A,골목상권,1000917,삼성로115길,266,169,97
2016,4,A,골목상권,1000916,봉은사로68길,289,151,138
2016,4,A,골목상권,1000915,봉은사로57길,742,481,261
2016,4,A,골목상권,1000914,봉은사로43길,1035,707,328
2016,4,A,골목상권,1000913,봉은사로29길,124,78,46
2016,4,A,골목상권,1000912,봉은사로109길,321,168,153
2016,4,A,골목상권,1000911,도산대로89길,2595,987,1608
2016,4,A,골목상권,1000910,도산대로81길,4539,1400,3139
2016,4,A,골목상권,1000909,도산대로50길,2799,1914,885
2016,4,A,골목상권,1000908,도산대로38길,156,87,69
2016,4,A,골목상권,1000907,도산대로30길,2931,1421,1510
2016,4,A,골목상권,1000906,도산대로23길,1637,947,690
2016,4,A,골목상권,1000905,도산대로15길,1865,862,1003
2016,4,A,골목상권,1000904,도곡로37길,3601,2245,1356
2016,4,A,골목상권,1000903,논현로8길,760,409,351
2016,4,A,골목상권,1000902,논현로63길,10880,3112,7768
2016,4,A,골목상권,1000901,논현로28길,10370,7159,3211
2016,4,A,골목상권,1000900,논현로26길,6682,4054,2628
2016,4,A,골목상권,1000898,논현로139길,2706,1323,1383
2016,4,A,골목상권,1000897,논현로123길,94,55,39
2016,4,A,골목상권,1000896,논현로115길,2789,1442,1347
2016,4,A,골목상권,1000895,논현로10길,2567,1661,906
2016,4,A,골목상권,1000894,논현로106길,2732,1584,1148
2016,4,A,골목상권,1000893,남부순환로365길,185,130,55
2016,4,A,골목상권,1000891,개포로28길,286,209,77
2016,4,A,골목상권,1000890,개포로20길,4229,2365,1864
2016,4,A,골목상권,1000889,개포로17길,2654,1690,964
2016,4,A,골목상권,1000888,강남대로140길,4339,2268,2071
2016,4,A,골목상권,1000887,강남대로136길,1132,598,534
2016,4,A,골목상권,1000886,강남대로118길,622,337,285
2016,4,A,골목상권,1000885,서초중앙로8길,7055,5341,1714
2016,4,A,골목상권,1000884,방배중앙로21길,1980,671,1309
2016,4,A,골목상권,1000883,효령로72길,224,129,95
2016,4,A,골목상권,1000882,효령로34길,23,20,3
2016,4,A,골목상권,1000881,효령로31길,1440,801,639
2016,4,A,골목상권,1000880,효령로23길,713,427,286
2016,4,A,골목상권,1000879,청두곶길,2013,1319,694
2016,4,A,골목상권,1000878,주흥길,310,200,110
2016,4,A,골목상권,1000877,주흥15길,1626,1062,564
2016,4,A,골목상권,1000876,언남길,1806,1275,531
2016,4,A,골목상권,1000875,신반포로45길,404,258,146
2016,4,A,골목상권,1000874,서초대로8길,310,180,130
2016,4,A,골목상권,1000873,서초대로64길,509,351,158
2016,4,A,골목상권,1000872,서초대로4길,611,433,178
2016,4,A,골목상권,1000871,서초대로25길,3345,2024,1321
2016,4,A,골목상권,1000870,서초대로23길,506,298,208
2016,4,A,골목상권,1000869,서초대로15길,1442,685,757
2016,4,A,골목상권,1000868,사평대로57길,173,66,107
2016,4,A,골목상권,1000867,사평대로26길,15,10,5
2016,4,A,골목상권,1000866,사평대로22길,1508,913,595
2016,4,A,골목상권,1000865,사임당로17길,1817,1101,716
2016,4,A,골목상권,1000864,방배로42길,145,75,70
2016,4,A,골목상권,1000863,방배로35길,2359,1470,889
2016,4,A,골목상권,1000862,방배로18길,83,45,38
2016,4,A,골목상권,1000861,반포대로9길,684,425,259
2016,4,A,골목상권,1000860,바우뫼로39길,2089,1278,811
2016,4,A,골목상권,1000859,마방로2길,3973,2528,1445
2016,4,A,골목상권,1000858,방배천로4안길,1268,810,458
2016,4,A,골목상권,1000857,동산로19길,1334,890,444
2016,4,A,골목상권,1000856,동산로10길,2623,1376,1247
2016,4,A,골목상권,1000855,동광로39길,48,30,18
2016,4,A,골목상권,1000854,동광로1길,1206,711,495
2016,4,A,골목상권,1000853,동광로12길,787,522,265
2016,4,A,골목상권,1000852,논현로27길,3585,2538,1047
2016,4,A,골목상권,1000851,논현로1길,524,342,182
2016,4,A,골목상권,1000850,남부순환로339길,12144,5446,6698
2016,4,A,골목상권,1000849,남부순환로325길,7947,4010,3937
2016,4,A,골목상권,1000848,남부순환로317길,1511,1045,466
2016,4,A,골목상권,1000847,고무래로8길,6939,3701,3238
2016,4,A,골목상권,1000846,강남대로8길,2718,1679,1039
2016,4,A,골목상권,1000845,강남대로34길,997,648,349
2016,4,A,골목상권,1000844,강남대로23길,6639,4622,2017
2016,4,A,골목상권,1000843,소담길,22,5,17
2016,4,A,골목상권,1000842,원신길,305,115,190
2016,4,A,골목상권,1000840,양산길,363,262,101
2016,4,A,골목상권,1000839,호암로24길,640,241,399
2016,4,A,골목상권,1000838,호암로20길,43,31,12
2016,4,A,골목상권,1000837,행운길,19,3,16
2016,4,A,골목상권,1000836,행운1길,101,68,33
2016,4,A,골목상권,1000835,청림3길,79,42,37
2016,4,A,골목상권,1000834,청룡길,88,45,43
2016,4,A,골목상권,1000833,청룡8길,34,13,21
2016,4,A,골목상권,1000832,중앙길,280,114,166
2016,4,A,골목상권,1000831,조원중앙로2길,1104,788,316
2016,4,A,골목상권,1000830,조원로18길,1063,552,511
2016,4,A,골목상권,1000829,조원로10길,273,125,148
2016,4,A,골목상권,1000828,장군봉2길,223,119,104
2016,4,A,골목상권,1000827,장군봉1길,91,15,76
2016,4,A,골목상권,1000826,인헌길,82,41,41
2016,4,A,골목상권,1000825,은천로25길,286,92,194
2016,4,A,골목상권,1000824,양녕로6길,800,476,324
2016,4,A,골목상권,1000823,신원로3길,33,20,13
2016,4,A,골목상권,1000822,신사로20길,52,24,28
2016,4,A,골목상권,1000820,신림로64길,253,122,131
2016,4,A,골목상권,1000819,신림로48길,73,33,40
2016,4,A,골목상권,1000818,신림로38길,61,32,29
2016,4,A,골목상권,1000817,신림로28길,320,219,101
2016,4,A,골목상권,1000816,신림로11길,453,409,44
2016,4,A,골목상권,1000815,신림동길,342,194,148
2016,4,A,골목상권,1000814,승방길,558,363,195
2016,4,A,골목상권,1000813,서림7길,266,97,169
2016,4,A,골목상권,1000812,봉천로33길,377,238,139
2016,4,A,골목상권,1000811,봉천로13길,300,90,210
2016,4,A,골목상권,1000810,복은길,174,61,113
2016,4,A,골목상권,1000809,법원단지길,2,1,1
2016,4,A,골목상권,1000808,법원단지9길,90,33,57
2016,4,A,골목상권,1000807,미성5길,66,39,27
2016,4,A,골목상권,1000806,대학길,80,31,49
2016,4,A,골목상권,1000805,대학14길,10,2,8
2016,4,A,골목상권,1000804,당곡길,351,162,189
2016,4,A,골목상권,1000803,남현길,234,90,144
2016,4,A,골목상권,1000802,남현3길,430,258,172
2016,4,A,골목상권,1000800,남부순환로248길,252,130,122
2016,4,A,골목상권,1000799,남부순환로234길,112,75,37
2016,4,A,골목상권,1000798,남부순환로172길,1478,863,615
2016,4,A,골목상권,1000797,남부순환로161길,21,5,16
2016,4,A,골목상권,1000796,남부순환로151길,123,76,47
2016,4,A,골목상권,1000795,남부순환로142길,76,38,38
2016,4,A,골목상권,1000794,난향길,169,42,127
2016,4,A,골목상권,1000793,난우길,436,188,248
2016,4,A,골목상권,1000792,난곡로74길,144,63,81
2016,4,A,골목상권,1000791,난곡로34길,22,7,15
2016,4,A,골목상권,1000790,난곡로26길,121,47,74
2016,4,A,골목상권,1000789,난곡로24길,40,18,22
2016,4,A,골목상권,1000788,낙성대역길,736,467,269
2016,4,A,골목상권,1000787,국회단지길,529,237,292
2016,4,A,골목상권,1000786,구암길,84,31,53
2016,4,A,골목상권,1000785,관천로22길,25,10,15
2016,4,A,골목상권,1000784,관천로15길,134,73,61
2016,4,A,골목상권,1000783,관악로30길,172,62,110
2016,4,A,골목상권,1000782,관악로28길,148,69,79
2016,4,A,골목상권,1000781,관악로14길,408,224,184
2016,4,A,골목상권,1000780,관악로10길,261,182,79
2016,4,A,골목상권,1000779,흑석로9길,194,81,113
2016,4,A,골목상권,1000778,흑석로13길,128,13,115
2016,4,A,골목상권,1000777,장승배기로27길,39,19,20
2016,4,A,골목상권,1000776,장승배기로19길,9,5,4
2016,4,A,골목상권,1000774,여의대방로46길,459,143,316
2016,4,A,골목상권,1000773,여의대방로24길,17082,8225,8857
2016,4,A,골목상권,1000772,여의대방로22카길,274,110,164
2016,4,A,골목상권,1000771,여의대방로22나길,139,55,84
2016,4,A,골목상권,1000770,여의대방로22길,201,115,86
2016,4,A,골목상권,1000769,양녕로26길,126,57,69
2016,4,A,골목상권,1000768,신대방길,107,72,35
2016,4,A,골목상권,1000767,성대로29길,4,2,2
2016,4,A,골목상권,1000766,성대로1길,311,122,189
2016,4,A,골목상권,1000765,서달로8가길,228,98,130
2016,4,A,골목상권,1000763,서달로14길,34,13,21
2016,4,A,골목상권,1000762,서달로10길,87,31,56
2016,4,A,골목상권,1000761,상도로62길,215,99,116
2016,4,A,골목상권,1000760,상도로61길,39,16,23
2016,4,A,골목상권,1000759,상도로47길,53,42,11
2016,4,A,골목상권,1000758,상도로37길,1985,962,1023
2016,4,A,골목상권,1000757,상도로15길,306,137,169
2016,4,A,골목상권,1000756,사당로8길,128,68,60
2016,4,A,골목상권,1000755,사당로30길,308,216,92
2016,4,A,골목상권,1000754,사당로2차길,152,107,45
2016,4,A,골목상권,1000753,사당로29길,16,13,3
2016,4,A,골목상권,1000752,사당로26길,245,134,111
2016,4,A,골목상권,1000751,사당로23나길,167,44,123
2016,4,A,골목상권,1000750,사당로23길,14,12,2
2016,4,A,골목상권,1000749,사당로20길,175,131,44
2016,4,A,골목상권,1000748,사당로16길,132,39,93
2016,4,A,골목상권,1000747,사당로16가길,815,483,332
2016,4,A,골목상권,1000746,만양로8길,88,38,50
2016,4,A,골목상권,1000745,만양로14길,360,152,208
2016,4,A,골목상권,1000744,등용로14길,624,431,193
2016,4,A,골목상권,1000743,동작대로7길,2058,751,1307
2016,4,A,골목상권,1000742,동작대로35길,267,98,169
2016,4,A,골목상권,1000741,동작대로33길,119,62,57
2016,4,A,골목상권,1000740,동작대로29길,27,15,12
2016,4,A,골목상권,1000739,동작대로17길,1359,734,625
2016,4,A,골목상권,1000738,대방동2길,477,233,244
2016,4,A,골목상권,1000737,대방동27길,94,50,44
2016,4,A,골목상권,1000736,노량진로6길,113,30,83
2016,4,A,골목상권,1000735,국사봉길,36,4,32
2016,4,A,골목상권,1000734,국사봉2길,94,54,40
2016,4,A,골목상권,1000733,국사봉1길,7,3,4
2016,4,A,골목상권,1000732,영신로9길,458,200,258
2016,4,A,골목상권,1000731,영등포로84길,344,84,260
2016,4,A,골목상권,1000730,영등포로80길,51,25,26
2016,4,A,골목상권,1000729,영등포로62길,2,2,0
2016,4,A,골목상권,1000728,영등포로35길,95,64,31
2016,4,A,골목상권,1000727,영등포로27길,362,229,133
2016,4,A,골목상권,1000724,여의대방로43나길,2368,1883,485
2016,4,A,골목상권,1000723,여의대방로39길,8,6,2
2016,4,A,골목상권,1000722,여의대방로35길,769,405,364
2016,4,A,골목상권,1000721,양평로28길,605,474,131
2016,4,A,골목상권,1000720,양평로22라길,33,20,13
2016,4,A,골목상권,1000719,양평로19길,4256,3344,912
2016,4,A,골목상권,1000718,신길로60길,436,190,246
2016,4,A,골목상권,1000717,신길로42길,375,183,192
2016,4,A,골목상권,1000716,신길로42가길,96,27,69
2016,4,A,골목상권,1000715,신길로39길,92,42,50
2016,4,A,골목상권,1000714,신길로17길,60,41,19
2016,4,A,골목상권,1000713,선유서로28길,587,284,303
2016,4,A,골목상권,1000712,선유서로25길,2457,1784,673
2016,4,A,골목상권,1000711,선유서로24길,155,81,74
2016,4,A,골목상권,1000710,선유로55길,2346,1414,932
2016,4,A,골목상권,1000709,디지털로74길,54,33,21
2016,4,A,골목상권,1000708,디지털로57길,10,3,7
2016,4,A,골목상권,1000707,디지털로37길,206,89,117
2016,4,A,골목상권,1000706,도신로62길,184,53,131
2016,4,A,골목상권,1000705,도신로60길,60,12,48
2016,4,A,골목상권,1000704,도신로29길,82,36,46
2016,4,A,골목상권,1000703,도신로15길,77,32,45
2016,4,A,골목상권,1000702,도림천로21길,92,44,48
2016,4,A,골목상권,1000701,도림로63길,32,21,11
2016,4,A,골목상권,1000700,도림로147길,1703,1204,499
2016,4,A,골목상권,1000699,도림로112길,12,6,6
2016,4,A,골목상권,1000698,대림로8길,1834,599,1235
2016,4,A,골목상권,1000697,대림로7길,14,5,9
2016,4,A,골목상권,1000696,대림로44길,45,27,18
2016,4,A,골목상권,1000695,대림로34길,187,70,117
2016,4,A,골목상권,1000694,대림로31길,753,369,384
2016,4,A,골목상권,1000693,대림로29길,1637,778,859
2016,4,A,골목상권,1000692,대림로22길,343,190,153
2016,4,A,골목상권,1000691,당산로46길,4455,2497,1958
2016,4,A,골목상권,1000690,당산로38길,218,154,64
2016,4,A,골목상권,1000689,당산로37길,4062,2537,1525
2016,4,A,골목상권,1000688,당산로31길,4110,2263,1847
2016,4,A,골목상권,1000687,국회대로56길,1674,1095,579
2016,4,A,골목상권,1000686,경인로90길,310,184,126
2016,4,A,골목상권,1000685,경인로80길,1561,1125,436
2016,4,A,골목상권,1000684,경인로77길,686,453,233
2016,4,A,골목상권,1000683,가마산로61길,164,56,108
2016,4,A,골목상권,1000682,시흥대로94길,780,395,385
2016,4,A,골목상권,1000681,시흥대로84길,174,68,106
2016,4,A,골목상권,1000680,시흥대로68길,535,160,375
2016,4,A,골목상권,1000679,시흥대로63길,2876,1478,1398
2016,4,A,골목상권,1000678,시흥대로62가길,430,113,317
2016,4,A,골목상권,1000677,시흥대로36길,365,213,152
2016,4,A,골목상권,1000676,시흥대로22길,510,361,149
2016,4,A,골목상권,1000675,시흥대로153길,646,347,299
2016,4,A,골목상권,1000674,시흥대로150길,546,249,297
2016,4,A,골목상권,1000673,시흥대로141길,657,400,257
2016,4,A,골목상권,1000672,시흥대로138길,18,11,7
2016,4,A,골목상권,1000671,시흥대로120길,608,407,201
2016,4,A,골목상권,1000670,벚꽃로56길,1826,1257,569
2016,4,A,골목상권,1000669,범안로17길,129,73,56
2016,4,A,골목상권,1000668,범안로11길,1139,900,239
2016,4,A,골목상권,1000667,문성로5길,145,42,103
2016,4,A,골목상권,1000666,독산로85길,85,24,61
2016,4,A,골목상권,1000665,독산로78다길,234,101,133
2016,4,A,골목상권,1000664,독산로70길,4,3,1
2016,4,A,골목상권,1000663,독산로64길,158,39,119
2016,4,A,골목상권,1000662,독산로50길,90,33,57
2016,4,A,골목상권,1000661,독산로40길,54,15,39
2016,4,A,골목상권,1000660,독산로108길,737,334,403
2016,4,A,골목상권,1000659,남부순환로112길,10,6,4
2016,4,A,골목상권,1000658,금하로24길,176,55,121
2016,4,A,골목상권,1000657,금하로1길,66,32,34
2016,4,A,골목상권,1000656,금하로14길,17,8,9
2016,4,A,골목상권,1000655,가산로5길,547,429,118
2016,4,A,골목상권,1000654,가산로3길,2414,1850,564
2016,4,A,골목상권,1000653,중앙로1길,1534,1063,471
2016,4,A,골목상권,1000652,중앙로15길,98,47,51
2016,4,A,골목상권,1000651,우마길,34,23,11
2016,4,A,골목상권,1000650,오류로8길,246,116,130
2016,4,A,골목상권,1000649,신도림로13길,775,585,190
2016,4,A,골목상권,1000648,새말로18길,1072,471,601
2016,4,A,골목상권,1000647,부일로1길,782,640,142
2016,4,A,골목상권,1000646,부일로15길,181,159,22
2016,4,A,골목상권,1000645,부일로11길,22,6,16
2016,4,A,골목상권,1000644,디지털로32길,1169,592,577
2016,4,A,골목상권,1000643,디지털로32가길,7202,5069,2133
2016,4,A,골목상권,1000642,디지털로27길,387,250,137
2016,4,A,골목상권,1000641,도림로6길,109,46,63
2016,4,A,골목상권,1000640,도림로12길,99,37,62
2016,4,A,골목상권,1000639,남부순환로97길,278,94,184
2016,4,A,골목상권,1000638,구로중앙로8길,234,83,151
2016,4,A,골목상권,1000637,구로중앙로7길,177,56,121
2016,4,A,골목상권,1000636,구로중앙로42길,791,589,202
2016,4,A,골목상권,1000635,구로중앙로34길,641,335,306
2016,4,A,골목상권,1000634,구로중앙로28길,3052,1476,1576
2016,4,A,골목상권,1000633,구로중앙로19길,8,5,3
2016,4,A,골목상권,1000632,구로동로8길,151,52,99
2016,4,A,골목상권,1000631,구로동로7길,162,61,101
2016,4,A,골목상권,1000630,구로동로42길,27,16,11
2016,4,A,골목상권,1000629,구로동로41길,440,279,161
2016,4,A,골목상권,1000628,구로동로38길,50,26,24
2016,4,A,골목상권,1000627,구로동로28길,191,91,100
2016,4,A,골목상권,1000626,구로동로15길,21,1,20
2016,4,A,골목상권,1000625,공원로6가길,302,211,91
2016,4,A,골목상권,1000624,고척로52길,230,69,161
2016,4,A,골목상권,1000623,고척로27다길,223,84,139
2016,4,A,골목상권,1000622,고척로27길,239,101,138
2016,4,A,골목상권,1000621,고척로21나길,242,64,178
2016,4,A,골목상권,1000620,경인로47길,850,474,376
2016,4,A,골목상권,1000619,경인로35길,276,111,165
2016,4,A,골목상권,1000618,경인로31길,48,15,33
2016,4,A,골목상권,1000617,경인로15길,141,63,78
2016,4,A,골목상권,1000616,개봉로3길,268,161,107
2016,4,A,골목상권,1000615,개봉로2길,475,134,341
2016,4,A,골목상권,1000614,개봉로23가길,865,505,360
2016,4,A,골목상권,1000613,개봉로20길,128,72,56
2016,4,A,골목상권,1000612,개봉로1길,49,24,25
2016,4,A,골목상권,1000611,개봉로17다길,163,76,87
2016,4,A,골목상권,1000610,개봉로17길,821,384,437
2016,4,A,골목상권,1000609,개봉로11길,51,10,41
2016,4,A,골목상권,1000608,화곡로64길,2939,1601,1338
2016,4,A,골목상권,1000607,화곡로59길,516,203,313
2016,4,A,골목상권,1000606,화곡로44나길,803,676,127
2016,4,A,골목상권,1000605,화곡로31길,1129,403,726
2016,4,A,골목상권,1000604,화곡로20길,555,332,223
2016,4,A,골목상권,1000603,화곡로13길,273,98,175
2016,4,A,골목상권,1000602,초원로16길,594,242,352
2016,4,A,골목상권,1000601,초록마을로8길,174,34,140
2016,4,A,골목상권,1000600,초록마을로3길,48,26,22
2016,4,A,골목상권,1000599,월정로20길,4,2,2
2016,4,A,골목상권,1000598,우장산로6길,318,193,125
2016,4,A,골목상권,1000597,양천로73가길,1357,882,475
2016,4,A,골목상권,1000596,양천로71길,194,127,67
2016,4,A,골목상권,1000595,양천로49길,724,581,143
2016,4,A,골목상권,1000594,양천로26길,121,56,65
2016,4,A,골목상권,1000593,양천로24길,355,129,226
2016,4,A,골목상권,1000592,양천로24가길,668,309,359
2016,4,A,골목상권,1000591,양천로14길,342,203,139
2016,4,A,골목상권,1000590,방화대로6라길,713,451,262
2016,4,A,골목상권,1000589,방화대로21길,820,488,332
2016,4,A,골목상권,1000588,등촌로5길,10,3,7
2016,4,A,골목상권,1000587,등촌로55길,465,323,142
2016,4,A,골목상권,1000586,등촌로51길,16,11,5
2016,4,A,골목상권,1000585,등촌로39길,66,23,43
2016,4,A,골목상권,1000584,등촌로13길,201,104,97
2016,4,A,골목상권,1000583,남부순환로11길,403,285,118
2016,4,A,골목상권,1000582,까치산로4길,134,50,84
2016,4,A,골목상권,1000581,국회대로7길,400,231,169
2016,4,A,골목상권,1000580,공항대로8길,189,75,114
2016,4,A,골목상권,1000579,공항대로61길,228,153,75
2016,4,A,골목상권,1000578,공항대로59다길,839,621,218
2016,4,A,골목상권,1000577,공항대로59길,1126,719,407
2016,4,A,골목상권,1000576,공항대로55길,1026,707,319
2016,4,A,골목상권,1000575,공항대로42길,6,3,3
2016,4,A,골목상권,1000574,공항대로38길,264,144,120
2016,4,A,골목상권,1000573,곰달래로60길,596,316,280
2016,4,A,골목상권,1000572,곰달래로53길,55,16,39
2016,4,A,골목상권,1000571,곰달래로47길,36,14,22
2016,4,A,골목상권,1000570,곰달래로31길,9,8,1
2016,4,A,골목상권,1000569,곰달래로25길,613,246,367
2016,4,A,골목상권,1000568,개화동로25길,670,428,242
2016,4,A,골목상권,1000567,개화동로23길,115,78,37
2016,4,A,골목상권,1000566,강서로8길,142,78,64
2016,4,A,골목상권,1000565,강서로5라길,289,166,123
2016,4,A,골목상권,1000564,강서로5나길,122,69,53
2016,4,A,골목상권,1000563,강서로5가길,45,25,20
2016,4,A,골목상권,1000562,강서로47라길,91,53,38
2016,4,A,골목상권,1000561,강서로47길,411,206,205
2016,4,A,골목상권,1000560,강서로45다길,802,395,407
2016,4,A,골목상권,1000559,강서로45길,134,62,72
2016,4,A,골목상권,1000558,강서로35길,179,106,73
2016,4,A,골목상권,1000557,강서로29길,325,163,162
2016,4,A,골목상권,1000556,강서로18길,27,15,12
2016,4,A,골목상권,1000555,강서로17가길,117,52,65
2016,4,A,골목상권,1000554,강서로15길,262,136,126
2016,4,A,골목상권,1000553,가로공원로80길,56,26,30
2016,4,A,골목상권,1000552,가로공원로76가길,26,11,15
2016,4,A,골목상권,1000551,화곡로4길,253,95,158
2016,4,A,골목상권,1000550,화곡로3길,178,65,113
2016,4,A,골목상권,1000549,지양로7길,230,75,155
2016,4,A,골목상권,1000548,중앙로55길,350,184,166
2016,4,A,골목상권,1000547,중앙로51길,147,90,57
2016,4,A,골목상권,1000546,중앙로47길,125,33,92
2016,4,A,골목상권,1000545,중앙로45길,160,61,99
2016,4,A,골목상권,1000544,중앙로36길,2,2,0
2016,4,A,골목상권,1000543,중앙로32길,609,286,323
2016,4,A,골목상권,1000542,중앙로25길,252,76,176
2016,4,A,골목상권,1000541,은행정로7길,491,167,324
2016,4,A,골목상권,1000539,오목로5길,302,174,128
2016,4,A,골목상권,1000538,오목로3길,445,421,24
2016,4,A,골목상권,1000537,오목로30길,165,80,85
2016,4,A,골목상권,1000536,오목로23길,816,463,353
2016,4,A,골목상권,1000535,신월로20길,205,80,125
2016,4,A,골목상권,1000534,신월로15길,796,360,436
2016,4,A,골목상권,1000533,신목로6길,269,150,119
2016,4,A,골목상권,1000532,신목로5길,901,325,576
2016,4,A,골목상권,1000531,신목로2길,115,54,61
2016,4,A,골목상권,1000530,목동중앙서로8가길,177,102,75
2016,4,A,골목상권,1000529,목동중앙서로7길,263,87,176
2016,4,A,골목상권,1000528,목동중앙북로8길,363,104,259
2016,4,A,골목상권,1000527,목동중앙북로16길,270,85,185
2016,4,A,골목상권,1000526,목동중앙본로7길,111,43,68
2016,4,A,골목상권,1000525,목동중앙로3길,98,53,45
2016,4,A,골목상권,1000524,목동중앙로13나길,286,202,84
2016,4,A,골목상권,1000523,목동중앙남로3가길,576,385,191
2016,4,A,골목상권,1000522,목동로9길,2483,1632,851
2016,4,A,골목상권,1000521,목동로19길,999,355,644
2016,4,A,골목상권,1000519,목동동로12길,419,162,257
2016,4,A,골목상권,1000518,목동남로4길,10,4,6
2016,4,A,골목상권,1000517,남부순환로88길,300,118,182
2016,4,A,골목상권,1000516,남부순환로79길,460,342,118
2016,4,A,골목상권,1000515,남부순환로70길,550,355,195
2016,4,A,골목상권,1000514,남부순환로58길,293,125,168
2016,4,A,골목상권,1000513,남부순환로40길,14,4,10
2016,4,A,골목상권,1000512,남부순환로33길,1095,898,197
2016,4,A,골목상권,1000511,곰달래로5길,45,25,20
2016,4,A,골목상권,1000510,곰달래로3길,393,211,182
2016,4,A,골목상권,1000509,곰달래로2길,264,144,120
2016,4,A,골목상권,1000508,곰달래로10길,315,224,91
2016,4,A,골목상권,1000507,가로공원로58길,79,17,62
2016,4,A,골목상권,1000506,효창원로93길,103,55,48
2016,4,A,골목상권,1000505,토정로37길,123,53,70
2016,4,A,골목상권,1000504,월드컵로8길,1745,843,902
2016,4,A,골목상권,1000503,월드컵로7길,3,2,1
2016,4,A,골목상권,1000502,월드컵로36길,149,64,85
2016,4,A,골목상권,1000501,월드컵로25길,299,169,130
2016,4,A,골목상권,1000500,월드컵로19길,655,287,368
2016,4,A,골목상권,1000499,월드컵로16길,3899,2038,1861
2016,4,A,골목상권,1000498,월드컵로11길,240,93,147
2016,4,A,골목상권,1000497,월드컵로10길,1554,795,759
2016,4,A,골목상권,1000496,와우산로3길,147,86,61
2016,4,A,골목상권,1000495,와우산로29길,153,77,76
2016,4,A,골목상권,1000494,와우산로29가길,18,7,11
2016,4,A,골목상권,1000493,양화진길,444,304,140
2016,4,A,골목상권,1000492,양화로1길,3912,1868,2044
2016,4,A,골목상권,1000491,양화로11길,354,227,127
2016,4,A,골목상권,1000490,신촌로30길,30,16,14
2016,4,A,골목상권,1000489,신촌로28가길,108,42,66
2016,4,A,골목상권,1000488,신촌로12길,1309,607,702
2016,4,A,골목상권,1000487,숭문길,2984,2046,938
2016,4,A,골목상권,1000486,숭문8길,117,69,48
2016,4,A,골목상권,1000485,성지3길,435,231,204
2016,4,A,골목상권,1000484,성산로4길,1687,1059,628
2016,4,A,골목상권,1000483,성미산로32길,392,170,222
2016,4,A,골목상권,1000482,성미산로1길,638,441,197
2016,4,A,골목상권,1000481,성미산로11길,1056,698,358
2016,4,A,골목상권,1000480,백범로16길,574,300,274
2016,4,A,골목상권,1000479,방울내로9안길,328,196,132
2016,4,A,골목상권,1000478,모래내로7길,246,130,116
2016,4,A,골목상권,1000477,매봉산로2길,2009,1313,696
2016,4,A,골목상권,1000476,망원로2길,207,125,82
2016,4,A,골목상권,1000475,망원로11길,1039,574,465
2016,4,A,골목상권,1000474,만리재옛길,1407,589,818
2016,4,A,골목상권,1000473,마포대로4길,181,97,84
2016,4,A,골목상권,1000472,마포대로20길,1156,587,569
2016,4,A,골목상권,1000471,마포대로12길,64,36,28
2016,4,A,골목상권,1000470,동교로38길,250,119,131
2016,4,A,골목상권,1000469,동교로27길,3470,1565,1905
2016,4,A,골목상권,1000468,동교로25길,557,264,293
2016,4,A,골목상권,1000467,동교로19길,4667,2944,1723
2016,4,A,골목상권,1000466,동교로17길,767,392,375
2016,4,A,골목상권,1000465,독막로8길,307,139,168
2016,4,A,골목상권,1000464,독막로32길,472,200,272
2016,4,A,골목상권,1000463,독막로22길,104,56,48
2016,4,A,골목상권,1000462,도화길,1033,531,502
2016,4,A,골목상권,1000461,도화4길,351,115,236
2016,4,A,골목상권,1000460,대흥로28길,55,40,15
2016,4,A,골목상권,1000459,대흥로21길,484,91,393
2016,4,A,골목상권,1000458,광성로6길,116,77,39
2016,4,A,골목상권,1000457,홍제내길,113,64,49
2016,4,A,골목상권,1000456,홍연길,76,44,32
2016,4,A,골목상권,1000455,통일로39길,11,9,2
2016,4,A,골목상권,1000454,통일로37길,360,139,221
2016,4,A,골목상권,1000453,통일로11길,11,10,1
2016,4,A,골목상권,1000452,충정로6길,15729,8688,7041
2016,4,A,골목상권,1000451,충정로4길,3015,2019,996
2016,4,A,골목상권,1000450,증가로6길,188,69,119
2016,4,A,골목상권,1000449,증가로23나길,444,217,227
2016,4,A,골목상권,1000448,증가로20가길,237,78,159
2016,4,A,골목상권,1000447,증가로10길,163,91,72
2016,4,A,골목상권,1000446,응암로1길,361,255,106
2016,4,A,골목상권,1000445,연희로10길,118,83,35
2016,4,A,골목상권,1000444,신촌로37길,152,64,88
2016,4,A,골목상권,1000443,수색로8길,2631,2517,114
2016,4,A,골목상권,1000442,세무서길,332,122,210
2016,4,A,골목상권,1000440,세검정로1길,334,176,158
2016,4,A,골목상권,1000439,북아현로4길,421,94,327
2016,4,A,골목상권,1000438,모래내로15길,95,24,71
2016,4,A,골목상권,1000437,명지대길,387,289,98
2016,4,A,골목상권,1000436,독립문로8길,773,287,486
2016,4,A,골목상권,1000435,가재울로6길,15,8,7
2016,4,A,골목상권,1000434,통일로92길,77,39,38
2016,4,A,골목상권,1000433,통일로87길,226,111,115
2016,4,A,골목상권,1000432,통일로78길,212,63,149
2016,4,A,골목상권,1000430,진흥로1길,470,139,331
2016,4,A,골목상권,1000429,진흥로12길,491,204,287
2016,4,A,골목상권,1000428,증산서길,577,297,280
2016,4,A,골목상권,1000427,증산로9길,103,34,69
2016,4,A,골목상권,1000426,증산로5길,772,404,368
2016,4,A,골목상권,1000425,증산로21길,260,164,96
2016,4,A,골목상권,1000424,증산로17길,748,357,391
2016,4,A,골목상권,1000423,증산로15길,204,76,128
2016,4,A,골목상권,1000422,증산로13길,73,40,33
2016,4,A,골목상권,1000421,응암로34길,63,40,23
2016,4,A,골목상권,1000420,응암로22길,148,49,99
2016,4,A,골목상권,1000419,응암로14길,382,127,255
2016,4,A,골목상권,1000418,응암로13길,291,117,174
2016,4,A,골목상권,1000417,응암로12길,218,106,112
2016,4,A,골목상권,1000416,은평로8길,263,133,130
2016,4,A,골목상권,1000415,은평로3길,291,79,212
2016,4,A,골목상권,1000414,은평로20길,24,9,15
2016,4,A,골목상권,1000413,은평로13길,491,324,167
2016,4,A,골목상권,1000412,은평로10길,367,210,157
2016,4,A,골목상권,1000411,연서로5길,44,13,31
2016,4,A,골목상권,1000410,연서로41길,242,69,173
2016,4,A,골목상권,1000409,연서로3길,109,39,70
2016,4,A,골목상권,1000408,연서로34길,155,46,109
2016,4,A,골목상권,1000407,연서로33길,25,8,17
2016,4,A,골목상권,1000406,연서로29길,342,132,210
2016,4,A,골목상권,1000405,연서로28길,702,303,399
2016,4,A,골목상권,1000404,연서로27길,62,29,33
2016,4,A,골목상권,1000403,연서로21길,340,214,126
2016,4,A,골목상권,1000402,연서로17길,1122,327,795
2016,4,A,골목상권,1000401,연서로16길,275,110,165
2016,4,A,골목상권,1000400,연서로13길,711,225,486
2016,4,A,골목상권,1000399,연서로11길,236,108,128
2016,4,A,골목상권,1000398,역말로9길,14,10,4
2016,4,A,골목상권,1000397,수색로18길,23,12,11
2016,4,A,골목상권,1000396,서오릉로8길,16,1,15
2016,4,A,골목상권,1000395,서오릉로21길,457,132,325
2016,4,A,골목상권,1000394,불광천길,168,83,85
2016,4,A,골목상권,1000393,갈현로7길,967,269,698
2016,4,A,골목상권,1000392,갈현로41길,83,32,51
2016,4,A,골목상권,1000391,갈현로33길,36,8,28
2016,4,A,골목상권,1000390,갈현로1길,166,77,89
2016,4,A,골목상권,1000389,가좌로7길,60,27,33
2016,4,A,골목상권,1000388,한글비석로44길,445,243,202
2016,4,A,골목상권,1000387,한글비석로24길,394,149,245
2016,4,A,골목상권,1000386,한글비석로22길,796,321,475
2016,4,A,골목상권,1000385,석계로1길,107,68,39
2016,4,A,골목상권,1000384,상계로9가길,282,112,170
2016,4,A,골목상권,1000382,상계로12길,24,16,8
2016,4,A,골목상권,1000381,동일로242길,293,191,102
2016,4,A,골목상권,1000380,동일로192길,420,194,226
2016,4,A,골목상권,1000379,동일로173가길,2379,1366,1013
2016,4,A,골목상권,1000378,공릉로58길,118,43,75
2016,4,A,골목상권,1000377,해등로16길,85,64,21
2016,4,A,골목상권,1000376,우이천로4다길,181,107,74
2016,4,A,골목상권,1000375,우이천로32길,99,56,43
2016,4,A,골목상권,1000374,시루봉로23길,50,22,28
2016,4,A,골목상권,1000373,삼양로144길,72,54,18
2016,4,A,골목상권,1000372,방학로6가길,223,139,84
2016,4,A,골목상권,1000371,방학로5길,116,69,47
2016,4,A,골목상권,1000370,방학로15길,342,222,120
2016,4,A,골목상권,1000369,방학로10길,176,69,107
2016,4,A,골목상권,1000367,도봉산4길,328,283,45
2016,4,A,골목상권,1000366,도봉로181길,191,82,109
2016,4,A,골목상권,1000365,도봉로169나길,301,133,168
2016,4,A,골목상권,1000364,도봉로156길,252,135,117
2016,4,A,골목상권,1000363,도봉로152가길,412,369,43
2016,4,A,골목상권,1000362,도봉로147길,569,321,248
2016,4,A,골목상권,1000360,도봉로114길,475,165,310
2016,4,A,골목상권,1000359,도봉로109길,21,7,14
2016,4,A,골목상권,1000358,도당로29길,865,508,357
2016,4,A,골목상권,1000357,도당로19길,206,88,118
2016,4,A,골목상권,1000356,도당로13바길,201,80,121
2016,4,A,골목상권,1000355,도당로13가길,153,59,94
2016,4,A,골목상권,1000354,덕릉로60길,77,42,35
2016,4,A,골목상권,1000353,노해로63다길,595,260,335
2016,4,A,골목상권,1000352,노해로60길,303,125,178
2016,4,A,골목상권,1000351,한천로140길,92,48,44
2016,4,A,골목상권,1000350,한천로139가길,43,24,19
2016,4,A,골목상권,1000349,한천로132길,324,132,192
2016,4,A,골목상권,1000348,한천로130길,289,125,164
2016,4,A,골목상권,1000347,한천로124나길,87,45,42
2016,4,A,골목상권,1000346,한천로109길,604,273,331
2016,4,A,골목상권,1000345,인수봉로79길,180,44,136
2016,4,A,골목상권,1000344,인수봉로72길,88,41,47
2016,4,A,골목상권,1000343,인수봉로56길,10,1,9
2016,4,A,골목상권,1000342,오패산로67길,538,282,256
2016,4,A,골목상권,1000341,오패산로52길,90,28,62
2016,4,A,골목상권,1000339,수유로12길,275,177,98
2016,4,A,골목상권,1000338,솔샘로65길,507,229,278
2016,4,A,골목상권,1000337,솔매로50길,720,289,431
2016,4,A,골목상권,1000336,솔매로45길,179,84,95
2016,4,A,골목상권,1000335,솔매로41길,80,21,59
2016,4,A,골목상권,1000334,삼양로93길,18,4,14
2016,4,A,골목상권,1000333,삼양로77길,398,133,265
2016,4,A,골목상권,1000332,삼양로54길,8,4,4
2016,4,A,골목상권,1000331,삼양로41길,289,129,160
2016,4,A,골목상권,1000329,삼양로24길,86,37,49
2016,4,A,골목상권,1000328,삼양로20길,128,46,82
2016,4,A,골목상권,1000327,삼각산로28길,742,391,351
2016,4,A,골목상권,1000326,도봉로99길,186,91,95
2016,4,A,골목상권,1000325,도봉로8길,239,170,69
2016,4,A,골목상권,1000324,도봉로76길,395,210,185
2016,4,A,골목상권,1000323,도봉로67길,5,3,2
2016,4,A,골목상권,1000322,도봉로45길,127,82,45
2016,4,A,골목상권,1000321,도봉로18길,383,167,216
2016,4,A,골목상권,1000320,도봉로13길,28,9,19
2016,4,A,골목상권,1000319,덕릉로41길,778,628,150
2016,4,A,골목상권,1000318,덕릉로40길,903,704,199
2016,4,A,골목상권,1000317,노해로33길,34,13,21
2016,4,A,골목상권,1000315,노해로17길,231,65,166
2016,4,A,골목상권,1000314,화랑로40길,152,82,70
2016,4,A,골목상권,1000313,화랑로32길,438,320,118
2016,4,A,골목상권,1000312,화랑로1길,176,93,83
2016,4,A,골목상권,1000311,화랑로19길,491,258,233
2016,4,A,골목상권,1000310,화랑로14길,56,24,32
2016,4,A,골목상권,1000309,화랑로13길,90,43,47
2016,4,A,골목상권,1000308,한천로76길,128,73,55
2016,4,A,골목상권,1000307,한천로101가길,50,30,20
2016,4,A,골목상권,1000306,창경궁로43길,29,17,12
2016,4,A,골목상권,1000305,지봉로20길,102,59,43
2016,4,A,골목상권,1000304,종암로5길,118,82,36
2016,4,A,골목상권,1000303,종암로24가길,272,136,136
2016,4,A,골목상권,1000302,종암로21길,142,51,91
2016,4,A,골목상권,1000301,종암로19길,406,121,285
2016,4,A,골목상권,1000300,종암로16길,79,33,46
2016,4,A,골목상권,1000299,정릉로8길,181,102,79
2016,4,A,골목상권,1000298,정릉로27길,205,87,118
2016,4,A,골목상권,1000296,장위로50길,906,505,401
2016,4,A,골목상권,1000295,장월로1길,432,190,242
2016,4,A,골목상권,1000294,인촌로6길,2459,1315,1144
2016,4,A,골목상권,1000293,인촌로5길,30,3,27
2016,4,A,골목상권,1000292,인촌로24길,198,133,65
2016,4,A,골목상권,1000291,개운사길,3303,2020,1283
2016,4,A,골목상권,1000290,인촌로1길,155,108,47
2016,4,A,골목상권,1000289,인촌로17가길,3197,1191,2006
2016,4,A,골목상권,1000288,오패산로4길,588,179,409
2016,4,A,골목상권,1000287,오패산로3길,1126,631,495
2016,4,A,골목상권,1000286,오패산로19길,43,17,26
2016,4,A,골목상권,1000285,안암로5길,605,358,247
2016,4,A,골목상권,1000284,아리랑로4길,615,234,381
2016,4,A,골목상권,1000283,솔샘로6길,146,69,77
2016,4,A,골목상권,1000282,성북로8길,50,23,27
2016,4,A,골목상권,1000281,삼양로8길,88,50,38
2016,4,A,골목상권,1000280,삼선교로16가길,712,408,304
2016,4,A,골목상권,1000279,삼선교로10다길,100,47,53
2016,4,A,골목상권,1000278,삼선교로10길,248,115,133
2016,4,A,골목상권,1000277,보문로32길,923,387,536
2016,4,A,골목상권,1000276,보문로31길,723,291,432
2016,4,A,골목상권,1000274,보문로13길,774,462,312
2016,4,A,골목상권,1000273,보국문로16길,296,198,98
2016,4,A,골목상권,1000270,동소문로26가길,289,164,125
2016,4,A,골목상권,1000269,동소문로15길,67,35,32
2016,4,A,골목상권,1000268,동소문로13길,412,217,195
2016,4,A,골목상권,1000267,돌곶이로8길,202,104,98
2016,4,A,골목상권,1000266,돌곶이로41길,59,30,29
2016,4,A,골목상권,1000265,돌곶이로28길,229,154,75
2016,4,A,골목상권,1000264,돌곶이로27길,71,39,32
2016,4,A,골목상권,1000263,돌곶이로22길,97,47,50
2016,4,A,골목상권,1000261,길음로7길,8,5,3
2016,4,A,골목상권,1000260,중랑천로10길,712,385,327
2016,4,A,골목상권,1000259,용마산로94길,441,266,175
2016,4,A,골목상권,1000258,용마산로118길,569,284,285
2016,4,A,골목상권,1000257,용마산로112길,291,133,158
2016,4,A,골목상권,1000256,용마산로100길,429,292,137
2016,4,A,골목상권,1000255,신내로7가길,265,69,196
2016,4,A,골목상권,1000254,사가정로54길,121,38,83
2016,4,A,골목상권,1000253,사가정로42길,66,19,47
2016,4,A,골목상권,1000252,봉화산로56길,573,141,432
2016,4,A,골목상권,1000251,봉화산로4길,400,139,261
2016,4,A,골목상권,1000250,봉화산로30길,380,242,138
2016,4,A,골목상권,1000249,봉우재로33길,109,41,68
2016,4,A,골목상권,1000248,면목로78길,306,166,140
2016,4,A,골목상권,1000247,면목로56길,222,161,61
2016,4,A,골목상권,1000246,면목로55길,436,133,303
2016,4,A,골목상권,1000245,면목로49길,541,175,366
2016,4,A,골목상권,1000244,면목로48길,118,58,60
2016,4,A,골목상권,1000243,면목로45길,66,28,38
2016,4,A,골목상권,1000242,면목로33길,397,156,241
2016,4,A,골목상권,1000241,면목로21길,45,33,12
2016,4,A,골목상권,1000240,망우로73길,8,4,4
2016,4,A,골목상권,1000239,망우로68길,84,36,48
2016,4,A,골목상권,1000238,동일로163길,104,66,38
2016,4,A,골목상권,1000237,동일로157길,193,96,97
2016,4,A,골목상권,1000236,동일로149길,1144,840,304
2016,4,A,골목상권,1000235,동일로140길,217,83,134
2016,4,A,골목상권,1000234,동일로139길,64,41,23
2016,4,A,골목상권,1000233,동일로139가길,1122,663,459
2016,4,A,골목상권,1000232,동일로130길,98,23,75
2016,4,A,골목상권,1000231,동일로123길,171,82,89
2016,4,A,골목상권,1000230,동일로112길,174,75,99
2016,4,A,골목상권,1000229,동일로101길,291,115,176
2016,4,A,골목상권,1000228,동일로100길,31,14,17
2016,4,A,골목상권,1000227,답십리로75길,99,53,46
2016,4,A,골목상권,1000226,공릉로2길,657,304,353
2016,4,A,골목상권,1000225,공릉로12가길,39,25,14
2016,4,A,골목상권,1000224,겸재로54길,116,58,58
2016,4,A,골목상권,1000223,겸재로36길,226,194,32
2016,4,A,골목상권,1000222,겸재로29길,435,187,248
2016,4,A,골목상권,1000221,휘경로3길,225,108,117
2016,4,A,골목상권,1000220,휘경로2길,7,3,4
2016,4,A,골목상권,1000219,휘경로23길,16,0,16
2016,4,A,골목상권,1000218,휘경로14길,104,42,62
2016,4,A,골목상권,1000217,한천로46길,391,131,260
2016,4,A,골목상권,1000216,한천로40길,316,160,156
2016,4,A,골목상권,1000215,한천로33길,74,30,44
2016,4,A,골목상권,1000214,한천로14길,621,371,250
2016,4,A,골목상권,1000213,천호대로97길,333,214,119
2016,4,A,골목상권,1000212,천호대로77길,2015,1067,948
2016,4,A,골목상권,1000211,천호대로45길,163,99,64
2016,4,A,골목상권,1000210,천호대로17길,2212,1415,797
2016,4,A,골목상권,1000209,천호대로12길,839,566,273
2016,4,A,골목상권,1000208,천장산로7길,1440,886,554
2016,4,A,골목상권,1000207,제기로5길,195,102,93
2016,4,A,골목상권,1000206,제기로21길,220,141,79
2016,4,A,골목상권,1000205,전농로4길,704,444,260
2016,4,A,골목상권,1000204,전농로3길,93,41,52
2016,4,A,골목상권,1000203,전농로29길,312,135,177
2016,4,A,골목상권,1000202,장한로8길,875,531,344
2016,4,A,골목상권,1000201,장한로5길,2868,2001,867
2016,4,A,골목상권,1000200,장한로27길,149,43,106
2016,4,A,골목상권,1000199,장한로27가길,383,180,203
2016,4,A,골목상권,1000198,장한로26길,592,286,306
2016,4,A,골목상권,1000197,장한로26가길,362,151,211
2016,4,A,골목상권,1000196,장한로25길,1071,467,604
2016,4,A,골목상권,1000195,장한로14길,184,154,30
2016,4,A,골목상권,1000194,이문로42길,263,108,155
2016,4,A,골목상권,1000193,왕산로43길,985,474,511
2016,4,A,골목상권,1000192,왕산로33길,153,103,50
2016,4,A,골목상권,1000191,왕산로32길,12,8,4
2016,4,A,골목상권,1000190,약령시로17길,277,137,140
2016,4,A,골목상권,1000189,서울시립대로4길,664,343,321
2016,4,A,골목상권,1000188,서울시립대로29길,246,137,109
2016,4,A,골목상권,1000187,서울시립대로16길,148,36,112
2016,4,A,골목상권,1000186,사가정로2길,85,65,20
2016,4,A,골목상권,1000185,사가정로23가길,102,60,42
2016,4,A,골목상권,1000184,사가정로13길,271,87,184
2016,4,A,골목상권,1000183,무학로45길,378,217,161
2016,4,A,골목상권,1000182,무학로16길,1141,1035,106
2016,4,A,골목상권,1000181,망우로21길,193,111,82
2016,4,A,골목상권,1000180,망우로18길,505,198,307
2016,4,A,골목상권,1000179,망우로18가길,71,30,41
2016,4,A,골목상권,1000178,답십리로72길,14,12,2
2016,4,A,골목상권,1000177,답십리로69길,909,392,517
2016,4,A,골목상권,1000176,답십리로68길,126,83,43
2016,4,A,골목상권,1000175,답십리로64길,349,201,148
2016,4,A,골목상권,1000174,답십리로63길,87,50,37
2016,4,A,골목상권,1000173,답십리로60길,11,7,4
2016,4,A,골목상권,1000172,답십리로56길,5,4,1
2016,4,A,골목상권,1000171,답십리로23길,7,6,1
2016,4,A,골목상권,1000170,난계로30길,156,109,47
2016,4,A,골목상권,1000168,경희대로3길,273,175,98
2016,4,A,골목상권,1000167,천호대로129길,238,79,159
2016,4,A,골목상권,1000166,천호대로123길,305,118,187
2016,4,A,골목상권,1000165,천호대로109길,1054,545,509
2016,4,A,골목상권,1000164,자양번영로3길,94,40,54
2016,4,A,골목상권,1000162,자양로50길,17,4,13
2016,4,A,골목상권,1000161,자양로45길,555,297,258
2016,4,A,골목상권,1000160,자양로26길,318,106,212
2016,4,A,골목상권,1000159,자양로15길,376,252,124
2016,4,A,골목상권,1000158,자양로11길,1405,698,707
2016,4,A,골목상권,1000157,용마산로3길,814,466,348
2016,4,A,골목상권,1000156,용마산로21길,139,55,84
2016,4,A,골목상권,1000155,아차산로78길,2663,1429,1234
2016,4,A,골목상권,1000154,아차산로65길,726,475,251
2016,4,A,골목상권,1000153,아차산로55길,389,189,200
2016,4,A,골목상권,1000152,아차산로51길,256,146,110
2016,4,A,골목상권,1000151,아차산로40길,489,288,201
2016,4,A,골목상권,1000150,면목로17길,244,160,84
2016,4,A,골목상권,1000149,뚝섬로64길,351,194,157
2016,4,A,골목상권,1000148,뚝섬로58길,188,63,125
2016,4,A,골목상권,1000147,뚝섬로54길,168,101,67
2016,4,A,골목상권,1000146,뚝섬로48길,796,331,465
2016,4,A,골목상권,1000145,뚝섬로24길,99,37,62
2016,4,A,골목상권,1000144,뚝섬로23길,109,69,40
2016,4,A,골목상권,1000143,동일로24길,8,3,5
2016,4,A,골목상권,1000142,동일로18길,168,68,100
2016,4,A,골목상권,1000141,능동로4길,248,107,141
2016,4,A,골목상권,1000140,능동로3길,209,97,112
2016,4,A,골목상권,1000139,능동로34길,924,516,408
2016,4,A,골목상권,1000138,능동로19길,323,202,121
2016,4,A,골목상권,1000137,능동로13길,352,115,237
2016,4,A,골목상권,1000136,긴고랑로9길,67,29,38
2016,4,A,골목상권,1000135,긴고랑로8길,218,195,23
2016,4,A,골목상권,1000134,긴고랑로7길,523,245,278
2016,4,A,골목상권,1000133,긴고랑로20길,542,250,292
2016,4,A,골목상권,1000132,광나루로52길,1649,843,806
2016,4,A,골목상권,1000131,광나루로40길,96,49,47
2016,4,A,골목상권,1000130,광나루로37길,303,184,119
2016,4,A,골목상권,1000129,광나루로36길,37,23,14
2016,4,A,골목상권,1000128,광나루로24길,59,30,29
2016,4,A,골목상권,1000127,광나루로12길,1010,568,442
2016,4,A,골목상권,1000126,한림말길,62,35,27
2016,4,A,골목상권,1000124,청계천로10나길,1810,1063,747
2016,4,A,골목상권,1000123,장터길,44,16,28
2016,4,A,골목상권,1000122,용답중앙길,93,52,41
2016,4,A,골목상권,1000121,용답29길,1871,946,925
2016,4,A,골목상권,1000120,왕십리로6길,1347,729,618
2016,4,A,골목상권,1000119,왕십리로31길,99,46,53
2016,4,A,골목상권,1000118,왕십리로26길,4367,2494,1873
2016,4,A,골목상권,1000117,왕십리로21길,174,54,120
2016,4,A,골목상권,1000116,왕십리로14길,2743,1994,749
2016,4,A,골목상권,1000115,아차산로5길,2285,1572,713
2016,4,A,골목상권,1000114,아차산로15길,4070,2933,1137
2016,4,A,골목상권,1000113,아차산로11길,3549,2306,1243
2016,4,A,골목상권,1000112,송정4가길,1062,500,562
2016,4,A,골목상권,1000111,송정12라길,284,183,101
2016,4,A,골목상권,1000110,성수일로6길,2471,1549,922
2016,4,A,골목상권,1000109,성수이로7길,416,266,150
2016,4,A,골목상권,1000108,성수이로18길,2204,1520,684
2016,4,A,골목상권,1000107,성덕정길,632,399,233
2016,4,A,골목상권,1000106,성덕정17길,219,119,100
2016,4,A,골목상권,1000105,서울숲2길,1426,823,603
2016,4,A,골목상권,1000104,상원길,1662,1127,535
2016,4,A,골목상권,1000103,상원12길,182,107,75
2016,4,A,골목상권,1000102,사근동길,31,17,14
2016,4,A,골목상권,1000101,무학봉길,3,3,0
2016,4,A,골목상권,1000100,무학봉28길,155,70,85
2016,4,A,골목상권,1000099,무학로6길,384,232,152
2016,4,A,골목상권,1000098,무수막길,118,54,64
2016,4,A,골목상권,1000097,매봉길,12,8,4
2016,4,A,골목상권,1000096,마조로1길,195,79,116
2016,4,A,골목상권,1000095,마조로16길,787,551,236
2016,4,A,골목상권,1000094,마장로39길,167,66,101
2016,4,A,골목상권,1000093,마장로27길,96,36,60
2016,4,A,골목상권,1000091,둘레9길,426,249,177
2016,4,A,골목상권,1000090,금호산길,420,153,267
2016,4,A,골목상권,1000089,금호산2길,35,15,20
2016,4,A,골목상권,1000088,고산자로6길,14618,5935,8683
2016,4,A,골목상권,1000087,후암로28길,199,85,114
2016,4,A,골목상권,1000086,효창원로39길,51,27,24
2016,4,A,골목상권,1000085,회나무로13길,62,36,26
2016,4,A,골목상권,1000084,한남대로20길,744,416,328
2016,4,A,골목상권,1000082,한강대로7길,598,399,199
2016,4,A,골목상권,1000081,한강대로62길,657,450,207
2016,4,A,골목상권,1000080,한강대로52길,1161,738,423
2016,4,A,골목상권,1000079,한강대로43길,4557,2880,1677
2016,4,A,골목상권,1000078,한강대로15길,1788,345,1443
2016,4,A,골목상권,1000077,한강대로104길,4287,3047,1240
2016,4,A,골목상권,1000076,청파로73길,1274,726,548
2016,4,A,골목상권,1000075,청파로71길,247,128,119
2016,4,A,골목상권,1000074,청파로47나길,121,80,41
2016,4,A,골목상권,1000073,청파로47길,819,397,422
2016,4,A,골목상권,1000072,장문로45길,72,11,61
2016,4,A,골목상권,1000071,이태원로54길,2204,1165,1039
2016,4,A,골목상권,1000070,이태원로27길,555,318,237
2016,4,A,골목상권,1000069,이촌로22길,224,140,84
2016,4,A,골목상권,1000068,원효로89길,935,758,177
2016,4,A,골목상권,1000067,원효로53길,723,423,300
2016,4,A,골목상권,1000066,원효로41길,2407,1698,709
2016,4,A,골목상권,1000065,원효로19길,956,669,287
2016,4,A,골목상권,1000064,우사단로4길,175,122,53
2016,4,A,골목상권,1000063,우사단로14길,1674,851,823
2016,4,A,골목상권,1000062,우사단로10길,60,30,30
2016,4,A,골목상권,1000061,신흥로20길,187,95,92
2016,4,A,골목상권,1000060,소월로20길,128,39,89
2016,4,A,골목상권,1000059,서빙고로71길,472,293,179
2016,4,A,골목상권,1000058,백범로90길,314,186,128
2016,4,A,골목상권,1000057,백범로79길,1059,642,417
2016,4,A,골목상권,1000056,두텁바위로1길,2649,1476,1173
2016,4,A,골목상권,1000055,대사관로34길,322,184,138
2016,4,A,골목상권,1000054,녹사평대로46길,59,46,13
2016,4,A,골목상권,1000053,녹사평대로40나길,55,32,23
2016,4,A,골목상권,1000052,녹사평대로32길,315,172,143
2016,4,A,골목상권,1000051,녹사평대로26길,2092,1145,947
2016,4,A,골목상권,1000050,녹사평대로11길,301,200,101
2016,4,A,골목상권,1000049,퇴계로90길,570,209,361
2016,4,A,골목상권,1000048,퇴계로8길,2379,1319,1060
2016,4,A,골목상권,1000047,퇴계로56길,1022,816,206
2016,4,A,골목상권,1000046,퇴계로46길,1934,785,1149
2016,4,A,골목상권,1000045,퇴계로18길,2880,1285,1595
2016,4,A,골목상권,1000044,퇴계로12길,953,434,519
2016,4,A,골목상권,1000043,청구로1길,211,107,104
2016,4,A,골목상권,1000042,청구로17길,1675,745,930
2016,4,A,골목상권,1000041,장충단로8길,4059,1289,2770
2016,4,A,골목상권,1000040,삼일대로4길,1005,599,406
2016,4,A,골목상권,1000039,명동길,36555,18129,18426
2016,4,A,골목상권,1000037,동호로20길,1014,446,568
2016,4,A,골목상권,1000036,동호로15길,4211,2228,1983
2016,4,A,골목상권,1000035,동호로11길,16,13,3
2016,4,A,골목상권,1000034,동호로10길,1473,644,829
2016,4,A,골목상권,1000033,다산로39길,1185,673,512
2016,4,A,골목상권,1000032,다산로38길,1495,758,737
2016,4,A,골목상권,1000031,다산로36길,65,42,23
2016,4,A,골목상권,1000030,다산로33길,412,196,216
2016,4,A,골목상권,1000029,난계로21길,210,140,70
2016,4,A,골목상권,1000028,난계로11길,1838,1064,774
2016,4,A,골목상권,1000027,필운대로1길,5,1,4
2016,4,A,골목상권,1000026,평창길,162,78,84
2016,4,A,골목상권,1000025,통일로12길,243,104,139
2016,4,A,골목상권,1000024,창신길,255,66,189
2016,4,A,골목상권,1000023,창신5길,7,3,4
2016,4,A,골목상권,1000022,창신2길,58,32,26
2016,4,A,골목상권,1000021,창경궁로35길,1426,405,1021
2016,4,A,골목상권,1000020,지봉로8길,153,79,74
2016,4,A,골목상권,1000019,종로65길,599,280,319
2016,4,A,골목상권,1000016,자하문로7길,473,255,218
2016,4,A,골목상권,1000015,이화장길,1960,932,1028
2016,4,A,골목상권,1000014,율곡로16길,96,84,12
2016,4,A,골목상권,1000013,율곡로10길,2312,1725,587
2016,4,A,골목상권,1000012,옥인길,472,201,271
2016,4,A,골목상권,1000011,숭인동길,19,9,10
2016,4,A,골목상권,1000010,성균관로5길,138,78,60
2016,4,A,골목상권,1000009,삼청로5길,413,153,260
2016,4,A,골목상권,1000008,북촌로5나길,1625,1122,503
2016,4,A,골목상권,1000007,북촌로5길,56,27,29
2016,4,A,골목상권,1000006,북촌로11길,18,10,8
2016,4,A,골목상권,1000005,백석동길,119,62,57
2016,4,A,골목상권,1000004,명륜길,20,12,8
2016,4,A,골목상권,1000003,돈화문로11가길,1079,571,508
2016,4,A,골목상권,1000001,계동길,809,345,464
2016,3,U,관광특구,1001496,강남 마이스 관광특구,20046,11439,8607
2016,3,U,관광특구,1001495,잠실 관광특구,26531,15664,10867
2016,3,U,관광특구,1001494,종로?청계 관광특구,30234,18431,11803
2016,3,U,관광특구,1001493,동대문패션타운 관광특구,10118,5826,4292
2016,3,U,관광특구,1001492,명동 남대문 북창동 다동 무교동 관광특구,165476,83367,82109
2016,3,U,관광특구,1001491,이태원 관광특구,5607,3207,2400
2016,3,R,전통시장,1001490,길동복조리시장,575,369,206
2016,3,R,전통시장,1001489,둔촌역전통시장,174,88,86
2016,3,R,전통시장,1001488,성내골목시장,7,2,5
2016,3,R,전통시장,1001487,천호시장,24,13,11
2016,3,R,전통시장,1001483,암사종합시장,715,317,398
2016,3,R,전통시장,1001482,고덕전통시장,388,374,14
2016,3,R,전통시장,1001481,명일골목시장,411,135,276
2016,3,R,전통시장,1001480,새마을시장,355,194,161
2016,3,R,전통시장,1001479,석촌시장,168,106,62
2016,3,R,전통시장,1001478,방이시장,674,431,243
2016,3,R,전통시장,1001477,마천시장,257,61,196
2016,3,R,전통시장,1001476,풍납시장,16,7,9
2016,3,R,전통시장,1001475,강남개포시장,35,30,5
2016,3,R,전통시장,1001474,도곡시장,516,228,288
2016,3,R,전통시장,1001471,영동전통시장,3202,2377,825
2016,3,R,전통시장,1001466,미성동도깨비시장,439,189,250
2016,3,R,전통시장,1001464,삼성동시장,107,46,61
2016,3,R,전통시장,1001463,신림중앙시장,13,8,5
2016,3,R,전통시장,1001462,강남골목시장,291,141,150
2016,3,R,전통시장,1001460,관악신사시장,315,253,62
2016,3,R,전통시장,1001459,신원시장,341,143,198
2016,3,R,전통시장,1001458,인헌시장,245,86,159
2016,3,R,전통시장,1001456,봉천현대시장,15,6,9
2016,3,R,전통시장,1001454,봉천제일종합시장,46,22,24
2016,3,R,전통시장,1001453,낙성대시장,17,10,7
2016,3,R,전통시장,1001452,중부시장,179,66,113
2016,3,R,전통시장,1001450,남성역골목시장,503,240,263
2016,3,R,전통시장,1001449,남성사계시장,1865,835,1030
2016,3,R,전통시장,1001448,흑석시장,182,72,110
2016,3,R,전통시장,1001447,상도4동도깨비골목시장,336,93,243
2016,3,R,전통시장,1001445,영도시장,72,31,41
2016,3,R,전통시장,1001441,본동인정시장,107,51,56
2016,3,R,전통시장,1001439,대림중앙시장,25,17,8
2016,3,R,전통시장,1001438,우리시장,12,5,7
2016,3,R,전통시장,1001437,영진시장A동,40,33,7
2016,3,R,전통시장,1001436,사러가시장,13,0,13
2016,3,R,전통시장,1001431,영등포청과시장,182,121,61
2016,3,R,전통시장,1001430,영등포전통시장,4070,2000,2070
2016,3,R,전통시장,1001429,은행나무시장,41,9,32
2016,3,R,전통시장,1001427,현대시장,57,18,39
2016,3,R,전통시장,1001424,남문시장,280,114,166
2016,3,R,전통시장,1001423,독산동 우시장,136,56,80
2016,3,R,전통시장,1001421,개봉중앙시장,7,3,4
2016,3,R,전통시장,1001419,가리봉시장,18,11,7
2016,3,R,전통시장,1001418,남구로시장,15,2,13
2016,3,R,전통시장,1001417,구로시장,50,20,30
2016,3,R,전통시장,1001415,방신전통시장,131,113,18
2016,3,R,전통시장,1001414,송화골목시장,503,187,316
2016,3,R,전통시장,1001413,까치산시장,35,23,12
2016,3,R,전통시장,1001411,남부골목시장,183,80,103
2016,3,R,전통시장,1001409,화곡중앙골목시장,2,2,0
2016,3,R,전통시장,1001407,등마루시장,815,463,352
2016,3,R,전통시장,1001406,신정3동골목시장,253,107,146
2016,3,R,전통시장,1001405,신정2동골목시장,9,7,2
2016,3,R,전통시장,1001402,신월6동골목시장,239,113,126
2016,3,R,전통시장,1001401,신곡종합시장,10,8,2
2016,3,R,전통시장,1001400,신월3동골목시장,54,18,36
2016,3,R,전통시장,1001399,경창시장,206,86,120
2016,3,R,전통시장,1001398,월정로시장,109,59,50
2016,3,R,전통시장,1001397,신영시장,50,23,27
2016,3,R,전통시장,1001396,목4동시장,232,76,156
2016,3,R,전통시장,1001395,목3동시장,701,340,361
2016,3,R,전통시장,1001394,목2동시장,211,99,112
2016,3,R,전통시장,1001393,마포농수산물시장,490,309,181
2016,3,R,전통시장,1001391,망원월드컵시장,13,9,4
2016,3,R,전통시장,1001390,망원시장,36,19,17
2016,3,R,전통시장,1001386,신수시장,123,97,26
2016,3,R,전통시장,1001385,아현시장,21,3,18
2016,3,R,전통시장,1001374,대림골목시장,300,94,206
2016,3,R,전통시장,1001367,상계중앙시장,30,15,15
2016,3,R,전통시장,1001364,방학동도깨비시장,125,50,75
2016,3,R,전통시장,1001363,쌍문역골목시장,71,34,37
2016,3,R,전통시장,1001361,신도봉시장,26,18,8
2016,3,R,전통시장,1001359,창동신창시장,137,61,76
2016,3,R,전통시장,1001358,수유북부시장,15,4,11
2016,3,R,전통시장,1001357,장미원골목시장,79,51,28
2016,3,R,전통시장,1001356,수유중앙시장,129,69,60
2016,3,R,전통시장,1001355,강북종합시장,64,28,36
2016,3,R,전통시장,1001354,우이시장,145,62,83
2016,3,R,전통시장,1001353,수유전통시장,453,136,317
2016,3,R,전통시장,1001352,번동북부골목시장,82,43,39
2016,3,R,전통시장,1001351,솔샘시장,103,41,62
2016,3,R,전통시장,1001349,방천골목시장,80,29,51
2016,3,R,전통시장,1001347,석관황금시장,26,14,12
2016,3,R,전통시장,1001343,장위전통시장,182,66,116
2016,3,R,전통시장,1001340,정릉시장,34,14,20
2016,3,R,전통시장,1001339,정릉아리랑시장,9,5,4
2016,3,R,전통시장,1001338,돈암제일시장,57,23,34
2016,3,R,전통시장,1001336,우림골목시장,215,104,111
2016,3,R,전통시장,1001335,묵1동도깨비시장,278,126,152
2016,3,R,전통시장,1001334,태능시장,4,3,1
2016,3,R,전통시장,1001333,중화제일시장,23,1,22
2016,3,R,전통시장,1001332,사가정시장,259,192,67
2016,3,R,전통시장,1001330,동원시장,70,30,40
2016,3,R,전통시장,1001329,동부골목시장,84,27,57
2016,3,R,전통시장,1001326,회기시장,140,65,75
2016,3,R,전통시장,1001323,답십리시장,27,11,16
2016,3,R,전통시장,1001321,답십리현대시장,86,71,15
2016,3,R,전통시장,1001319,청량리종합시장,9,6,3
2016,3,R,전통시장,1001317,청량리농수산물시장,19,15,4
2016,3,R,전통시장,1001316,서울약령시장,1360,835,525
2016,3,R,전통시장,1001313,청량리수산시장,248,120,128
2016,3,R,전통시장,1001310,구의시장,94,54,40
2016,3,R,전통시장,1001309,조양시장,79,42,37
2016,3,R,전통시장,1001308,영동교골목시장,29,23,6
2016,3,R,전통시장,1001307,능동로골목시장,242,220,22
2016,3,R,전통시장,1001304,자양골목시장,95,45,50
2016,3,R,전통시장,1001301,중곡제일시장,147,80,67
2016,3,R,전통시장,1001299,한아름시장,117,66,51
2016,3,R,전통시장,1001298,성동용답상가시장,280,147,133
2016,3,R,전통시장,1001297,뚝도시장,34,12,22
2016,3,R,전통시장,1001296,금남시장,19,10,9
2016,3,R,전통시장,1001295,행당시장,231,120,111
2016,3,R,전통시장,1001294,마장축산물시장,1598,1064,534
2016,3,R,전통시장,1001289,용문전통시장,38,23,15
2016,3,R,전통시장,1001286,후암시장,46,17,29
2016,3,R,전통시장,1001285,합동(새벽)시장,2326,1280,1046
2016,3,R,전통시장,1001284,서울중앙시장,251,175,76
2016,3,R,전통시장,1001283,백학시장,453,237,216
2016,3,R,전통시장,1001282,약수시장,1650,635,1015
2016,3,R,전통시장,1001281,청평화시장,2847,1825,1022
2016,3,R,전통시장,1001280,제일평화시장,474,292,182
2016,3,R,전통시장,1001278,남평화시장,185,114,71
2016,3,R,전통시장,1001277,방산종합시장,1884,1232,652
2016,3,R,전통시장,1001275,인현시장,1193,774,419
2016,3,R,전통시장,1001274,신중부시장,2473,1652,821
2016,3,R,전통시장,1001273,남대문시장,7144,3783,3361
2016,3,R,전통시장,1001271,동묘시장,914,592,322
2016,3,R,전통시장,1001270,창신골목시장,240,129,111
2016,3,R,전통시장,1001268,충신시장,352,202,150
2016,3,R,전통시장,1001267,종로신진시장,28,13,15
2016,3,R,전통시장,1001266,동대문종합시장,345,195,150
2016,3,R,전통시장,1001265,광장시장,209,147,62
2016,3,D,발달상권,1001263,서울 노원구 노원역_3,795,334,461
2016,3,D,발달상권,1001261,서울 노원구 노원역_1,941,286,655
2016,3,D,발달상권,1001260,창동역,2330,1516,814
2016,3,D,발달상권,1001259,서울 강북구 수유역_3,56,30,26
2016,3,D,발달상권,1001257,서울 강북구 수유역_2,4091,2122,1969
2016,3,D,발달상권,1001256,서울 강북구 수유역_1,109,86,23
2016,3,D,발달상권,1001255,서울 은평구 연신내역_3,618,193,425
2016,3,D,발달상권,1001254,서울 은평구 연신내역_2,411,167,244
2016,3,D,발달상권,1001253,서울 은평구 연신내역_1,67,33,34
2016,3,D,발달상권,1001252,서울 성북구 미아삼거리역_2,520,230,290
2016,3,D,발달상권,1001251,서울 강북구 미아삼거리역_1,514,187,327
2016,3,D,발달상권,1001250,서울 은평구 불광역_3,50,19,31
2016,3,D,발달상권,1001249,서울 은평구 불광역_2,61,24,37
2016,3,D,발달상권,1001248,서울 은평구 불광역_1,308,154,154
2016,3,D,발달상권,1001247,미아사거리_2,117,42,75
2016,3,D,발달상권,1001246,미아사거리_1,572,264,308
2016,3,D,발달상권,1001245,서울 성북구 성신여대입구역,4843,2996,1847
2016,3,D,발달상권,1001244,경희대학교,380,172,208
2016,3,D,발달상권,1001243,서울 성북구 안암역,85,52,33
2016,3,D,발달상권,1001242,혜화역 대학로_3,1728,832,896
2016,3,D,발달상권,1001241,혜화역 대학로_2,1503,868,635
2016,3,D,발달상권,1001240,혜화역 대학로_1,1293,659,634
2016,3,D,발달상권,1001239,디지털미디어시티,21972,13210,8762
2016,3,D,발달상권,1001238,서울 동대문구 청량리역,3131,1998,1133
2016,3,D,발달상권,1001236,서울 종로구 안국역_2,720,282,438
2016,3,D,발달상권,1001235,서울 종로구 안국역_1,11841,9691,2150
2016,3,D,발달상권,1001234,서울 종로구 경복궁역_1,208,78,130
2016,3,D,발달상권,1001233,서울 종로구 종로3가역_3,3166,1750,1416
2016,3,D,발달상권,1001232,서울 종로구 종로3가역_2,1851,1025,826
2016,3,D,발달상권,1001231,서울 동대문구 신설동역_2,4315,2150,2165
2016,3,D,발달상권,1001230,인사동,21657,13531,8126
2016,3,D,발달상권,1001229,서울 종로구 종로5가역_4,652,361,291
2016,3,D,발달상권,1001228,서울 종로구 종로5가역_3,5281,3577,1704
2016,3,D,발달상권,1001227,종로구청,15034,8637,6397
2016,3,D,발달상권,1001226,서울 종로구 종로5가역_2,18616,12530,6086
2016,3,D,발달상권,1001225,신설동역,736,436,300
2016,3,D,발달상권,1001224,서울 동대문구 신설동역_1,2,2,0
2016,3,D,발달상권,1001223,서울 종로구 광화문역_2,54301,33560,20741
2016,3,D,발달상권,1001222,동묘앞역,72,45,27
2016,3,D,발달상권,1001221,장안동사거리,549,269,280
2016,3,D,발달상권,1001220,서울 종로구 동대문역_2,1037,562,475
2016,3,D,발달상권,1001218,동대문시장_2,483,308,175
2016,3,D,발달상권,1001217,서울 종로구 종로5가역_1,53,39,14
2016,3,D,발달상권,1001216,서울 종로구 종로3가역_1,3404,1517,1887
2016,3,D,발달상권,1001215,서울 종로구 광화문역_1,2298,1532,766
2016,3,D,발달상권,1001214,종각역,20526,13301,7225
2016,3,D,발달상권,1001213,종각역 젊음의 거리,2127,953,1174
2016,3,D,발달상권,1001212,서대문구 서대문역_1,336,236,100
2016,3,D,발달상권,1001211,동대문시장_1,419,225,194
2016,3,D,발달상권,1001210,시청역_2,23204,14485,8719
2016,3,D,발달상권,1001209,서울시청,24480,11564,12916
2016,3,D,발달상권,1001208,서울 중구 을지로3가역_2,8112,5243,2869
2016,3,D,발달상권,1001207,서울 중구 신당역_2,1386,700,686
2016,3,D,발달상권,1001206,서대문구 서대문역_2,1978,1333,645
2016,3,D,발달상권,1001205,동대문역사문화공원역,4057,2884,1173
2016,3,D,발달상권,1001204,서울 중구 을지로3가역_1,14563,9846,4717
2016,3,D,발달상권,1001203,명동거리,25961,12077,13884
2016,3,D,발달상권,1001202,롯데백화점,40185,22885,17300
2016,3,D,발달상권,1001201,서울 중구 신당역_1,1061,700,361
2016,3,D,발달상권,1001200,북창동,7955,4897,3058
2016,3,D,발달상권,1001199,서울 중구 충무로역_2,14283,6360,7923
2016,3,D,발달상권,1001198,서울 강서구 송정역,638,434,204
2016,3,D,발달상권,1001197,장한평역_2,11886,9499,2387
2016,3,D,발달상권,1001196,시청역_1,54597,33424,21173
2016,3,D,발달상권,1001195,왕십리역_2,632,271,361
2016,3,D,발달상권,1001194,서울 강서구 발산역,722,439,283
2016,3,D,발달상권,1001193,장한평역_1,2380,1541,839
2016,3,D,발달상권,1001192,서울 중구 충무로역_1,3177,2208,969
2016,3,D,발달상권,1001190,장한평역,2290,1636,654
2016,3,D,발달상권,1001189,서울 중구 명동역,3538,1815,1723
2016,3,D,발달상권,1001188,장충동 족발거리,202,96,106
2016,3,D,발달상권,1001187,한양시장,265,122,143
2016,3,D,발달상권,1001186,서울 서대문구 이대역,1193,469,724
2016,3,D,발달상권,1001185,서울 서대문구 신촌역,2784,1133,1651
2016,3,D,발달상권,1001184,서울 마포구 홍대입구역_3,613,483,130
2016,3,D,발달상권,1001183,서울 마포구 홍대입구역_2,2969,1184,1785
2016,3,D,발달상권,1001182,홍익대학교 주변,15098,7653,7445
2016,3,D,발달상권,1001181,서울 광진구 군자역,173,102,71
2016,3,D,발달상권,1001180,신촌역,234,117,117
2016,3,D,발달상권,1001179,강서구청,3449,2238,1211
2016,3,D,발달상권,1001178,서울 마포구 홍대입구역_1,761,428,333
2016,3,D,발달상권,1001175,서울 강동구 고덕역,494,286,208
2016,3,D,발달상권,1001173,서울 강동구 명일역,831,332,499
2016,3,D,발달상권,1001172,어린이대공원역,137,97,40
2016,3,D,발달상권,1001171,서울 마포구 공덕역_2,4006,2374,1632
2016,3,D,발달상권,1001170,공덕역,6900,4303,2597
2016,3,D,발달상권,1001169,서울 용산구 숙대입구역,4381,3124,1257
2016,3,D,발달상권,1001168,남영역,14123,6269,7854
2016,3,D,발달상권,1001167,서울 마포구 공덕역_1,4623,2285,2338
2016,3,D,발달상권,1001166,서울 마포구 마포역_2,1189,688,501
2016,3,D,발달상권,1001165,서울 광진구 건대입구역_2,2799,1012,1787
2016,3,D,발달상권,1001164,서울 마포구 마포역_1,11310,6860,4450
2016,3,D,발달상권,1001163,서울 강동구 천호역_2,3917,1936,1981
2016,3,D,발달상권,1001162,서울 광진구 건대입구역_1,934,468,466
2016,3,D,발달상권,1001161,건대입구역,680,366,314
2016,3,D,발달상권,1001160,서울 광진구 구의역,892,541,351
2016,3,D,발달상권,1001159,서울 강동구 천호역,1001,471,530
2016,3,D,발달상권,1001158,당산역_2,4872,3024,1848
2016,3,D,발달상권,1001156,서울 강동구 길동역,1287,771,516
2016,3,D,발달상권,1001155,용산 전자상가_5,2352,1729,623
2016,3,D,발달상권,1001153,당산역_1,1115,704,411
2016,3,D,발달상권,1001152,서울 광진구 강변역,2149,1745,404
2016,3,D,발달상권,1001151,용산 전자상가_3,2465,1790,675
2016,3,D,발달상권,1001150,서울 용산구 이태원역,664,404,260
2016,3,D,발달상권,1001149,한남오거리,660,339,321
2016,3,D,발달상권,1001147,용산 전자상가_2,476,384,92
2016,3,D,발달상권,1001146,용산구청,111,77,34
2016,3,D,발달상권,1001145,용산 전자상가_1,8184,6283,1901
2016,3,D,발달상권,1001144,국회의사당역_2,39424,22686,16738
2016,3,D,발달상권,1001143,서울 용산구 신용산역,421,189,232
2016,3,D,발달상권,1001142,국회의사당역_1,5727,4405,1322
2016,3,D,발달상권,1001141,압구정 로데오거리_2,15390,6274,9116
2016,3,D,발달상권,1001140,서울 강남구 압구정역,10297,4759,5538
2016,3,D,발달상권,1001139,서울 영등포구 영등포구청역,3709,1148,2561
2016,3,D,발달상권,1001138,압구정 로데오거리_1,7482,2458,5024
2016,3,D,발달상권,1001137,서울 강동구 둔촌동역,51,15,36
2016,3,D,발달상권,1001136,오목교역,205,95,110
2016,3,D,발달상권,1001135,신사동 가로수길,21557,9956,11601
2016,3,D,발달상권,1001134,서울 영등포구 여의도역_2,47838,31761,16077
2016,3,D,발달상권,1001133,청담사거리_3,1396,477,919
2016,3,D,발달상권,1001132,영등포유통상가,2089,1325,764
2016,3,D,발달상권,1001131,청담역_2,1321,973,348
2016,3,D,발달상권,1001130,청담역_1,183,144,39
2016,3,D,발달상권,1001129,청담사거리_2,1021,789,232
2016,3,D,발달상권,1001127,서울 영등포구 여의도역_1,53750,31826,21924
2016,3,D,발달상권,1001125,학동사거리_2,2906,1637,1269
2016,3,D,발달상권,1001124,서울 영등포구 영등포시장역,345,269,76
2016,3,D,발달상권,1001123,학동사거리_1,3996,2033,1963
2016,3,D,발달상권,1001122,여의도 시범아파트앞,2358,1498,860
2016,3,D,발달상권,1001121,영등포역_3,866,523,343
2016,3,D,발달상권,1001120,도산공원사거리_1,9853,5820,4033
2016,3,D,발달상권,1001119,영등포역_2,1144,617,527
2016,3,D,발달상권,1001118,문래동 주민센터,73,62,11
2016,3,D,발달상권,1001117,강남구 신사역_2,7569,4927,2642
2016,3,D,발달상권,1001115,서울 강남구 강남구청역_2,4207,2578,1629
2016,3,D,발달상권,1001114,강남구 신사역_1,2543,1143,1400
2016,3,D,발달상권,1001113,서울 동작구 노량진1동_1,35,25,10
2016,3,D,발달상권,1001112,서울 강남구 학동역_3,9168,5243,3925
2016,3,D,발달상권,1001111,서울 강남구 강남구청역_1,3281,1934,1347
2016,3,D,발달상권,1001110,잠실역,5769,4481,1288
2016,3,D,발달상권,1001109,강남구 논현역_4,8954,4014,4940
2016,3,D,발달상권,1001108,학동역,1382,580,802
2016,3,D,발달상권,1001107,방이동 먹자골목,5324,3410,1914
2016,3,D,발달상권,1001106,서울 강남구 학동역_2,5416,2806,2610
2016,3,D,발달상권,1001105,서울 동작구 노량진역,3688,2139,1549
2016,3,D,발달상권,1001104,삼성역_3,8497,4889,3608
2016,3,D,발달상권,1001103,코엑스,20046,11439,8607
2016,3,D,발달상권,1001102,서울 강남구 학동역_1,5819,3549,2270
2016,3,D,발달상권,1001101,선정릉역_2,6757,4307,2450
2016,3,D,발달상권,1001100,강남구 논현역_3,1443,825,618
2016,3,D,발달상권,1001099,포스코사거리_2,7031,4529,2502
2016,3,D,발달상권,1001098,포스코사거리_1,50503,33686,16817
2016,3,D,발달상권,1001097,잠실역 롯데월드,3211,1556,1655
2016,3,D,발달상권,1001096,신도림역,3695,1978,1717
2016,3,D,발달상권,1001095,강남구 논현역_2,8085,3879,4206
2016,3,D,발달상권,1001094,선정릉역_1,1691,1175,516
2016,3,D,발달상권,1001093,신천역,6044,3337,2707
2016,3,D,발달상권,1001092,강남구 논현역_1,2919,1972,947
2016,3,D,발달상권,1001091,삼성역_2,17802,10478,7324
2016,3,D,발달상권,1001090,삼정역_2,2897,1333,1564
2016,3,D,발달상권,1001089,삼정역_1,2922,1585,1337
2016,3,D,발달상권,1001088,삼성역_1,28332,18672,9660
2016,3,D,발달상권,1001087,서울 강남구 선릉역_2,8118,5167,2951
2016,3,D,발달상권,1001086,고속터미널역,15694,4794,10900
2016,3,D,발달상권,1001085,서울 서초구 강남역,34388,19466,14922
2016,3,D,발달상권,1001084,서울 강남구 선릉역_1,19187,8328,10859
2016,3,D,발달상권,1001082,선릉역_2,20136,10500,9636
2016,3,D,발달상권,1001081,서울 강남구 역삼역_2,27877,21730,6147
2016,3,D,발달상권,1001080,서울 송파구 석촌역_1,40,29,11
2016,3,D,발달상권,1001078,서울 강남구 강남역_2,5698,3455,2243
2016,3,D,발달상권,1001077,선릉역_1,53428,28804,24624
2016,3,D,발달상권,1001076,구로역,166,94,72
2016,3,D,발달상권,1001075,역삼역_2,4539,2595,1944
2016,3,D,발달상권,1001074,대림역_2,7108,5395,1713
2016,3,D,발달상권,1001073,서울 강남구 역삼역_1,26029,16394,9635
2016,3,D,발달상권,1001072,신대방삼거리역,318,153,165
2016,3,D,발달상권,1001071,서울 강남구 한티역,1294,472,822
2016,3,D,발달상권,1001070,은마아파트입구사거리_4,88,53,35
2016,3,D,발달상권,1001067,오류동역,1498,745,753
2016,3,D,발달상권,1001066,서울 강남구 강남역,39309,18457,20852
2016,3,D,발달상권,1001063,교대역_4,5523,3103,2420
2016,3,D,발달상권,1001062,서울 강남구 강남역_1,135251,99401,35850
2016,3,D,발달상권,1001061,방배동카페골목,111,46,65
2016,3,D,발달상권,1001060,가락시장,16121,10273,5848
2016,3,D,발달상권,1001059,교대역_3,4445,2739,1706
2016,3,D,발달상권,1001058,역삼역_1,1900,995,905
2016,3,D,발달상권,1001057,교대역_2,3480,2209,1271
2016,3,D,발달상권,1001056,서울 송파구 가락시장역,5463,3550,1913
2016,3,D,발달상권,1001055,서울 서초구 서초역,11982,5047,6935
2016,3,D,발달상권,1001054,서울 강남구 대치역_2,1459,885,574
2016,3,D,발달상권,1001052,뱅뱅사거리_2,23947,15478,8469
2016,3,D,발달상권,1001051,보라매공원,14120,8125,5995
2016,3,D,발달상권,1001050,교대역_1,12965,7837,5128
2016,3,D,발달상권,1001049,개봉동 현대아파트 인근,155,71,84
2016,3,D,발달상권,1001048,뱅뱅사거리,10344,7168,3176
2016,3,D,발달상권,1001047,뱅뱅사거리_1,10136,7186,2950
2016,3,D,발달상권,1001046,서울 관악구 신림역_4,908,435,473
2016,3,D,발달상권,1001045,동작구 총신대입구역_1,222,105,117
2016,3,D,발달상권,1001044,양재역_3,3451,2396,1055
2016,3,D,발달상권,1001043,동작구 총신대입구역_2,855,371,484
2016,3,D,발달상권,1001042,서울 서초구 남부터미널역_3,1627,934,693
2016,3,D,발달상권,1001041,서울 강남구 수서역,19118,10909,8209
2016,3,D,발달상권,1001039,서울 서초구 남부터미널역_2,11278,5503,5775
2016,3,D,발달상권,1001038,구로디지탈1단지,65663,42167,23496
2016,3,D,발달상권,1001037,양재역,131,65,66
2016,3,D,발달상권,1001035,매봉역,467,214,253
2016,3,D,발달상권,1001034,서울 서초구 방배역,3751,2232,1519
2016,3,D,발달상권,1001033,서울 서초구 남부터미널역_1,705,499,206
2016,3,D,발달상권,1001032,서울 관악구 신림역_2,29,14,15
2016,3,D,발달상권,1001031,서울 관악구 신림역_1,2031,937,1094
2016,3,D,발달상권,1001030,양재역_2,8514,4724,3790
2016,3,D,발달상권,1001029,양재역_1,1015,711,304
2016,3,D,발달상권,1001028,서울 관악구 서울대입구역_2,41,4,37
2016,3,D,발달상권,1001027,가산디지털단지역_3,31705,19052,12653
2016,3,D,발달상권,1001026,구로디지털단지역,1970,1281,689
2016,3,D,발달상권,1001025,서울 관악구 서울대입구역_1,1989,862,1127
2016,3,D,발달상권,1001024,관악구 사당역_1,3906,1662,2244
2016,3,D,발달상권,1001023,가산디지털단지역_2,62635,37372,25263
2016,3,D,발달상권,1001022,관악구 사당역_2,366,193,173
2016,3,D,발달상권,1001021,가산디지털단지역_1,25352,17226,8126
2016,3,D,발달상권,1001020,장지역,4269,2696,1573
2016,3,D,발달상권,1001019,포이사거리_1,5742,3131,2611
2016,3,D,발달상권,1001018,포이사거리_2,7962,5385,2577
2016,3,D,발달상권,1001016,서울 관악구 대학동_1,86,51,35
2016,3,D,발달상권,1001015,서울 금천구 독산1동_1,3069,2113,956
2016,3,D,발달상권,1001013,양재 화물트럭터미널앞_2,232,128,104
2016,3,D,발달상권,1001012,양재 화물트럭터미널앞_1,4230,3308,922
2016,3,D,발달상권,1001011,서울 금천구 시흥1동_4,922,471,451
2016,3,A,골목상권,1001010,풍성로37가길,40,18,22
2016,3,A,골목상권,1001009,천호옛길,579,387,192
2016,3,A,골목상권,1001008,천호옛14길,621,303,318
2016,3,A,골목상권,1001007,천호대로219길,919,543,376
2016,3,A,골목상권,1001006,천호대로197길,19,4,15
2016,3,A,골목상권,1001005,천호대로187길,866,506,360
2016,3,A,골목상권,1001004,천호대로170길,404,165,239
2016,3,A,골목상권,1001003,천호대로162길,1214,858,356
2016,3,A,골목상권,1001002,천중로51길,432,233,199
2016,3,A,골목상권,1001001,천중로39길,582,210,372
2016,3,A,골목상권,1001000,진황도로47길,1154,580,574
2016,3,A,골목상권,1000999,진황도로27길,471,285,186
2016,3,A,골목상권,1000998,올림픽로98길,47,23,24
2016,3,A,골목상권,1000997,올림픽로80길,2,1,1
2016,3,A,골목상권,1000995,올림픽로77길,9,5,4
2016,3,A,골목상권,1000994,올림픽로71길,424,318,106
2016,3,A,골목상권,1000993,올림픽로48길,5694,3495,2199
2016,3,A,골목상권,1000992,양재대로96길,1374,833,541
2016,3,A,골목상권,1000991,양재대로95길,647,353,294
2016,3,A,골목상권,1000990,양재대로91길,1128,621,507
2016,3,A,골목상권,1000989,양재대로133길,317,118,199
2016,3,A,골목상권,1000988,양재대로124길,606,370,236
2016,3,A,골목상권,1000987,양재대로116길,219,89,130
2016,3,A,골목상권,1000986,양재대로101길,1197,688,509
2016,3,A,골목상권,1000985,암사길,361,166,195
2016,3,A,골목상권,1000984,성안로3길,1519,945,574
2016,3,A,골목상권,1000983,성내로5길,1081,569,512
2016,3,A,골목상권,1000982,상일로5길,61,34,27
2016,3,A,골목상권,1000981,상암로5길,482,207,275
2016,3,A,골목상권,1000980,상암로51길,751,328,423
2016,3,A,골목상권,1000979,상암로4길,265,211,54
2016,3,A,골목상권,1000978,상암로14길,427,268,159
2016,3,A,골목상권,1000977,명일로13길,121,49,72
2016,3,A,골목상권,1000976,동남로85길,120,61,59
2016,3,A,골목상권,1000975,동남로82길,7,3,4
2016,3,A,골목상권,1000974,동남로65길,97,34,63
2016,3,A,골목상권,1000973,구천면로42길,393,197,196
2016,3,A,골목상권,1000972,구천면로41길,604,256,348
2016,3,A,골목상권,1000971,구천면로36길,71,43,28
2016,3,A,골목상권,1000969,고덕로25길,14,11,3
2016,3,A,골목상권,1000968,고덕로10길,198,94,104
2016,3,A,골목상권,1000967,강동대로53길,913,504,409
2016,3,A,골목상권,1000966,풍성로25길,768,286,482
2016,3,A,골목상권,1000965,오금로46길,1362,697,665
2016,3,A,골목상권,1000964,오금로36길,1366,1044,322
2016,3,A,골목상권,1000963,오금로11길,2199,1417,782
2016,3,A,골목상권,1000962,양재대로72길,715,408,307
2016,3,A,골목상권,1000961,양재대로71길,1273,766,507
2016,3,A,골목상권,1000960,양재대로64길,1539,621,918
2016,3,A,골목상권,1000959,양재대로62길,6359,3876,2483
2016,3,A,골목상권,1000958,송파대로30길,1712,1098,614
2016,3,A,골목상권,1000957,송이로36길,1992,1427,565
2016,3,A,골목상권,1000956,송이로32길,784,432,352
2016,3,A,골목상권,1000955,송이로23길,1236,759,477
2016,3,A,골목상권,1000954,삼전로13길,1647,841,806
2016,3,A,골목상권,1000953,백제고분로50길,3316,1663,1653
2016,3,A,골목상권,1000952,백제고분로46길,1777,1145,632
2016,3,A,골목상권,1000951,백제고분로45길,522,333,189
2016,3,A,골목상권,1000950,백제고분로42길,137,78,59
2016,3,A,골목상권,1000949,백제고분로39길,1517,1076,441
2016,3,A,골목상권,1000948,백제고분로34길,1708,1117,591
2016,3,A,골목상권,1000947,백제고분로33길,845,534,311
2016,3,A,골목상권,1000946,백제고분로32길,1074,450,624
2016,3,A,골목상권,1000945,백제고분로31길,343,224,119
2016,3,A,골목상권,1000944,백제고분로22길,1064,638,426
2016,3,A,골목상권,1000943,백제고분로21길,195,137,58
2016,3,A,골목상권,1000942,마천로51길,132,57,75
2016,3,A,골목상권,1000941,동남로20길,163,97,66
2016,3,A,골목상권,1000940,거마로20길,429,196,233
2016,3,A,골목상권,1000939,학동로77길,2909,1526,1383
2016,3,A,골목상권,1000938,학동로6길,1873,944,929
2016,3,A,골목상권,1000937,학동로56길,963,537,426
2016,3,A,골목상권,1000936,학동로38길,6427,4169,2258
2016,3,A,골목상권,1000935,테헤란로81길,606,227,379
2016,3,A,골목상권,1000934,일원로9길,528,289,239
2016,3,A,골목상권,1000933,일원로3길,213,105,108
2016,3,A,골목상권,1000932,영동대로65길,3111,1826,1285
2016,3,A,골목상권,1000931,영동대로112길,727,479,248
2016,3,A,골목상권,1000930,언주로81길,9018,4188,4830
2016,3,A,골목상권,1000929,압구정로2길,2656,1413,1243
2016,3,A,골목상권,1000928,선릉로18길,441,245,196
2016,3,A,골목상권,1000927,선릉로146길,1877,990,887
2016,3,A,골목상권,1000926,선릉로133길,178,101,77
2016,3,A,골목상권,1000925,선릉로132길,1069,569,500
2016,3,A,골목상권,1000924,선릉로121길,1668,900,768
2016,3,A,골목상권,1000923,삼성로75길,2587,1405,1182
2016,3,A,골목상권,1000922,삼성로69길,316,156,160
2016,3,A,골목상권,1000921,삼성로64길,591,282,309
2016,3,A,골목상권,1000920,삼성로63길,144,68,76
2016,3,A,골목상권,1000919,삼성로57길,905,289,616
2016,3,A,골목상권,1000918,삼성로147길,813,341,472
2016,3,A,골목상권,1000917,삼성로115길,258,163,95
2016,3,A,골목상권,1000916,봉은사로68길,273,140,133
2016,3,A,골목상권,1000915,봉은사로57길,664,459,205
2016,3,A,골목상권,1000914,봉은사로43길,1041,710,331
2016,3,A,골목상권,1000913,봉은사로29길,133,89,44
2016,3,A,골목상권,1000912,봉은사로109길,308,165,143
2016,3,A,골목상권,1000911,도산대로89길,2682,1022,1660
2016,3,A,골목상권,1000910,도산대로81길,4615,1460,3155
2016,3,A,골목상권,1000909,도산대로50길,2783,1921,862
2016,3,A,골목상권,1000908,도산대로38길,169,91,78
2016,3,A,골목상권,1000907,도산대로30길,2822,1293,1529
2016,3,A,골목상권,1000906,도산대로23길,1630,954,676
2016,3,A,골목상권,1000905,도산대로15길,1746,803,943
2016,3,A,골목상권,1000904,도곡로37길,3317,2176,1141
2016,3,A,골목상권,1000903,논현로8길,757,412,345
2016,3,A,골목상권,1000902,논현로63길,10414,3017,7397
2016,3,A,골목상권,1000901,논현로28길,11409,8220,3189
2016,3,A,골목상권,1000900,논현로26길,6914,4249,2665
2016,3,A,골목상권,1000898,논현로139길,2484,1249,1235
2016,3,A,골목상권,1000897,논현로123길,94,58,36
2016,3,A,골목상권,1000896,논현로115길,2727,1437,1290
2016,3,A,골목상권,1000895,논현로10길,2586,1706,880
2016,3,A,골목상권,1000894,논현로106길,2706,1568,1138
2016,3,A,골목상권,1000893,남부순환로365길,179,125,54
2016,3,A,골목상권,1000891,개포로28길,285,211,74
2016,3,A,골목상권,1000890,개포로20길,4155,2340,1815
2016,3,A,골목상권,1000889,개포로17길,2693,1748,945
2016,3,A,골목상권,1000888,강남대로140길,4658,2553,2105
2016,3,A,골목상권,1000887,강남대로136길,1232,692,540
2016,3,A,골목상권,1000886,강남대로118길,588,324,264
2016,3,A,골목상권,1000885,서초중앙로8길,5709,4262,1447
2016,3,A,골목상권,1000884,방배중앙로21길,2175,687,1488
2016,3,A,골목상권,1000883,효령로72길,215,126,89
2016,3,A,골목상권,1000882,효령로34길,20,17,3
2016,3,A,골목상권,1000881,효령로31길,1487,868,619
2016,3,A,골목상권,1000880,효령로23길,714,419,295
2016,3,A,골목상권,1000879,청두곶길,1955,1286,669
2016,3,A,골목상권,1000878,주흥길,325,208,117
2016,3,A,골목상권,1000877,주흥15길,1681,1092,589
2016,3,A,골목상권,1000876,언남길,1984,1453,531
2016,3,A,골목상권,1000875,신반포로45길,403,267,136
2016,3,A,골목상권,1000874,서초대로8길,335,211,124
2016,3,A,골목상권,1000873,서초대로64길,487,346,141
2016,3,A,골목상권,1000872,서초대로4길,612,433,179
2016,3,A,골목상권,1000871,서초대로25길,3372,2037,1335
2016,3,A,골목상권,1000870,서초대로23길,515,307,208
2016,3,A,골목상권,1000869,서초대로15길,1241,586,655
2016,3,A,골목상권,1000868,사평대로57길,174,65,109
2016,3,A,골목상권,1000867,사평대로26길,17,12,5
2016,3,A,골목상권,1000866,사평대로22길,1437,866,571
2016,3,A,골목상권,1000865,사임당로17길,1735,1118,617
2016,3,A,골목상권,1000864,방배로42길,164,83,81
2016,3,A,골목상권,1000863,방배로35길,2444,1537,907
2016,3,A,골목상권,1000862,방배로18길,89,47,42
2016,3,A,골목상권,1000861,반포대로9길,707,461,246
2016,3,A,골목상권,1000860,바우뫼로39길,2074,1304,770
2016,3,A,골목상권,1000859,마방로2길,3901,2503,1398
2016,3,A,골목상권,1000858,방배천로4안길,1268,796,472
2016,3,A,골목상권,1000857,동산로19길,1325,887,438
2016,3,A,골목상권,1000856,동산로10길,2542,1320,1222
2016,3,A,골목상권,1000855,동광로39길,44,25,19
2016,3,A,골목상권,1000854,동광로1길,1203,722,481
2016,3,A,골목상권,1000853,동광로12길,808,543,265
2016,3,A,골목상권,1000852,논현로27길,3645,2610,1035
2016,3,A,골목상권,1000851,논현로1길,630,403,227
2016,3,A,골목상권,1000850,남부순환로339길,12012,5296,6716
2016,3,A,골목상권,1000849,남부순환로325길,7827,3987,3840
2016,3,A,골목상권,1000848,남부순환로317길,1509,1051,458
2016,3,A,골목상권,1000847,고무래로8길,6926,3725,3201
2016,3,A,골목상권,1000846,강남대로8길,3167,2154,1013
2016,3,A,골목상권,1000845,강남대로34길,995,656,339
2016,3,A,골목상권,1000844,강남대로23길,5889,4134,1755
2016,3,A,골목상권,1000843,소담길,23,5,18
2016,3,A,골목상권,1000842,원신길,307,116,191
2016,3,A,골목상권,1000840,양산길,424,297,127
2016,3,A,골목상권,1000839,호암로24길,660,260,400
2016,3,A,골목상권,1000838,호암로20길,40,28,12
2016,3,A,골목상권,1000837,행운길,19,3,16
2016,3,A,골목상권,1000836,행운1길,99,59,40
2016,3,A,골목상권,1000835,청림3길,72,35,37
2016,3,A,골목상권,1000834,청룡길,175,119,56
2016,3,A,골목상권,1000833,청룡8길,35,15,20
2016,3,A,골목상권,1000832,중앙길,283,101,182
2016,3,A,골목상권,1000831,조원중앙로2길,1135,779,356
2016,3,A,골목상권,1000830,조원로18길,1087,553,534
2016,3,A,골목상권,1000829,조원로10길,263,122,141
2016,3,A,골목상권,1000828,장군봉2길,295,128,167
2016,3,A,골목상권,1000827,장군봉1길,91,14,77
2016,3,A,골목상권,1000826,인헌길,84,39,45
2016,3,A,골목상권,1000825,은천로25길,268,81,187
2016,3,A,골목상권,1000824,양녕로6길,833,502,331
2016,3,A,골목상권,1000823,신원로3길,33,22,11
2016,3,A,골목상권,1000822,신사로20길,57,29,28
2016,3,A,골목상권,1000820,신림로64길,207,112,95
2016,3,A,골목상권,1000819,신림로48길,74,36,38
2016,3,A,골목상권,1000818,신림로38길,56,30,26
2016,3,A,골목상권,1000817,신림로28길,327,221,106
2016,3,A,골목상권,1000816,신림로11길,453,412,41
2016,3,A,골목상권,1000815,신림동길,344,198,146
2016,3,A,골목상권,1000814,승방길,553,360,193
2016,3,A,골목상권,1000813,서림7길,267,100,167
2016,3,A,골목상권,1000812,봉천로33길,370,236,134
2016,3,A,골목상권,1000811,봉천로13길,294,86,208
2016,3,A,골목상권,1000810,복은길,188,69,119
2016,3,A,골목상권,1000809,법원단지길,2,1,1
2016,3,A,골목상권,1000808,법원단지9길,91,35,56
2016,3,A,골목상권,1000807,미성5길,62,36,26
2016,3,A,골목상권,1000806,대학길,79,34,45
2016,3,A,골목상권,1000805,대학14길,12,2,10
2016,3,A,골목상권,1000804,당곡길,340,157,183
2016,3,A,골목상권,1000803,남현길,237,87,150
2016,3,A,골목상권,1000802,남현3길,455,274,181
2016,3,A,골목상권,1000801,남현2길,1,0,1
2016,3,A,골목상권,1000800,남부순환로248길,268,140,128
2016,3,A,골목상권,1000799,남부순환로234길,125,81,44
2016,3,A,골목상권,1000798,남부순환로172길,1670,917,753
2016,3,A,골목상권,1000797,남부순환로161길,19,5,14
2016,3,A,골목상권,1000796,남부순환로151길,109,63,46
2016,3,A,골목상권,1000795,남부순환로142길,69,32,37
2016,3,A,골목상권,1000794,난향길,174,50,124
2016,3,A,골목상권,1000793,난우길,421,178,243
2016,3,A,골목상권,1000792,난곡로74길,151,63,88
2016,3,A,골목상권,1000791,난곡로34길,24,7,17
2016,3,A,골목상권,1000790,난곡로26길,112,43,69
2016,3,A,골목상권,1000789,난곡로24길,36,15,21
2016,3,A,골목상권,1000788,낙성대역길,738,474,264
2016,3,A,골목상권,1000787,국회단지길,548,242,306
2016,3,A,골목상권,1000786,구암길,81,32,49
2016,3,A,골목상권,1000785,관천로22길,21,10,11
2016,3,A,골목상권,1000784,관천로15길,149,82,67
2016,3,A,골목상권,1000783,관악로30길,179,65,114
2016,3,A,골목상권,1000782,관악로28길,144,73,71
2016,3,A,골목상권,1000781,관악로14길,407,216,191
2016,3,A,골목상권,1000780,관악로10길,230,157,73
2016,3,A,골목상권,1000779,흑석로9길,198,82,116
2016,3,A,골목상권,1000778,흑석로13길,138,18,120
2016,3,A,골목상권,1000777,장승배기로27길,41,19,22
2016,3,A,골목상권,1000776,장승배기로19길,9,5,4
2016,3,A,골목상권,1000774,여의대방로46길,411,137,274
2016,3,A,골목상권,1000773,여의대방로24길,16038,7509,8529
2016,3,A,골목상권,1000772,여의대방로22카길,290,118,172
2016,3,A,골목상권,1000771,여의대방로22나길,128,49,79
2016,3,A,골목상권,1000770,여의대방로22길,202,114,88
2016,3,A,골목상권,1000769,양녕로26길,132,63,69
2016,3,A,골목상권,1000768,신대방길,109,73,36
2016,3,A,골목상권,1000767,성대로29길,2,2,0
2016,3,A,골목상권,1000766,성대로1길,329,131,198
2016,3,A,골목상권,1000765,서달로8가길,228,105,123
2016,3,A,골목상권,1000763,서달로14길,34,14,20
2016,3,A,골목상권,1000762,서달로10길,78,30,48
2016,3,A,골목상권,1000761,상도로62길,165,59,106
2016,3,A,골목상권,1000760,상도로61길,47,23,24
2016,3,A,골목상권,1000759,상도로47길,61,44,17
2016,3,A,골목상권,1000758,상도로37길,1968,961,1007
2016,3,A,골목상권,1000757,상도로15길,271,118,153
2016,3,A,골목상권,1000756,사당로8길,122,63,59
2016,3,A,골목상권,1000755,사당로30길,305,209,96
2016,3,A,골목상권,1000754,사당로2차길,142,94,48
2016,3,A,골목상권,1000753,사당로29길,17,14,3
2016,3,A,골목상권,1000752,사당로26길,253,136,117
2016,3,A,골목상권,1000751,사당로23나길,164,41,123
2016,3,A,골목상권,1000750,사당로23길,16,12,4
2016,3,A,골목상권,1000749,사당로20길,168,124,44
2016,3,A,골목상권,1000748,사당로16길,129,38,91
2016,3,A,골목상권,1000747,사당로16가길,792,486,306
2016,3,A,골목상권,1000746,만양로8길,77,35,42
2016,3,A,골목상권,1000745,만양로14길,353,146,207
2016,3,A,골목상권,1000744,등용로14길,627,446,181
2016,3,A,골목상권,1000743,동작대로7길,1860,759,1101
2016,3,A,골목상권,1000742,동작대로35길,258,92,166
2016,3,A,골목상권,1000741,동작대로33길,116,56,60
2016,3,A,골목상권,1000740,동작대로29길,35,18,17
2016,3,A,골목상권,1000739,동작대로17길,1315,689,626
2016,3,A,골목상권,1000738,대방동2길,461,225,236
2016,3,A,골목상권,1000737,대방동27길,137,80,57
2016,3,A,골목상권,1000736,노량진로6길,107,31,76
2016,3,A,골목상권,1000735,국사봉길,39,6,33
2016,3,A,골목상권,1000734,국사봉2길,110,71,39
2016,3,A,골목상권,1000733,국사봉1길,14,8,6
2016,3,A,골목상권,1000732,영신로9길,423,181,242
2016,3,A,골목상권,1000731,영등포로84길,345,85,260
2016,3,A,골목상권,1000730,영등포로80길,60,32,28
2016,3,A,골목상권,1000729,영등포로62길,4,3,1
2016,3,A,골목상권,1000728,영등포로35길,79,59,20
2016,3,A,골목상권,1000727,영등포로27길,343,208,135
2016,3,A,골목상권,1000724,여의대방로43나길,2319,1843,476
2016,3,A,골목상권,1000723,여의대방로39길,8,6,2
2016,3,A,골목상권,1000722,여의대방로35길,789,415,374
2016,3,A,골목상권,1000721,양평로28길,555,437,118
2016,3,A,골목상권,1000720,양평로22라길,53,34,19
2016,3,A,골목상권,1000719,양평로19길,4235,3399,836
2016,3,A,골목상권,1000718,신길로60길,431,188,243
2016,3,A,골목상권,1000717,신길로42길,369,186,183
2016,3,A,골목상권,1000716,신길로42가길,100,36,64
2016,3,A,골목상권,1000715,신길로39길,102,51,51
2016,3,A,골목상권,1000714,신길로17길,45,29,16
2016,3,A,골목상권,1000713,선유서로28길,570,272,298
2016,3,A,골목상권,1000712,선유서로25길,2403,1728,675
2016,3,A,골목상권,1000711,선유서로24길,160,88,72
2016,3,A,골목상권,1000710,선유로55길,2311,1401,910
2016,3,A,골목상권,1000709,디지털로74길,56,35,21
2016,3,A,골목상권,1000708,디지털로57길,5,1,4
2016,3,A,골목상권,1000707,디지털로37길,235,110,125
2016,3,A,골목상권,1000706,도신로62길,179,52,127
2016,3,A,골목상권,1000705,도신로60길,65,16,49
2016,3,A,골목상권,1000704,도신로29길,95,41,54
2016,3,A,골목상권,1000703,도신로15길,74,31,43
2016,3,A,골목상권,1000702,도림천로21길,95,41,54
2016,3,A,골목상권,1000701,도림로63길,33,22,11
2016,3,A,골목상권,1000700,도림로147길,1672,1212,460
2016,3,A,골목상권,1000699,도림로112길,22,10,12
2016,3,A,골목상권,1000698,대림로8길,1801,579,1222
2016,3,A,골목상권,1000697,대림로7길,15,5,10
2016,3,A,골목상권,1000696,대림로44길,45,27,18
2016,3,A,골목상권,1000695,대림로34길,186,73,113
2016,3,A,골목상권,1000694,대림로31길,744,351,393
2016,3,A,골목상권,1000693,대림로29길,1604,781,823
2016,3,A,골목상권,1000692,대림로22길,337,189,148
2016,3,A,골목상권,1000691,당산로46길,3600,1974,1626
2016,3,A,골목상권,1000690,당산로38길,296,230,66
2016,3,A,골목상권,1000689,당산로37길,3683,2251,1432
2016,3,A,골목상권,1000688,당산로31길,4027,2270,1757
2016,3,A,골목상권,1000687,국회대로56길,1651,1077,574
2016,3,A,골목상권,1000686,경인로90길,325,198,127
2016,3,A,골목상권,1000685,경인로80길,1594,1154,440
2016,3,A,골목상권,1000684,경인로77길,643,428,215
2016,3,A,골목상권,1000683,가마산로61길,168,60,108
2016,3,A,골목상권,1000682,시흥대로94길,769,399,370
2016,3,A,골목상권,1000681,시흥대로84길,176,69,107
2016,3,A,골목상권,1000680,시흥대로68길,414,136,278
2016,3,A,골목상권,1000679,시흥대로63길,2796,1466,1330
2016,3,A,골목상권,1000678,시흥대로62가길,438,126,312
2016,3,A,골목상권,1000677,시흥대로36길,360,210,150
2016,3,A,골목상권,1000676,시흥대로22길,509,357,152
2016,3,A,골목상권,1000675,시흥대로153길,610,321,289
2016,3,A,골목상권,1000674,시흥대로150길,565,256,309
2016,3,A,골목상권,1000673,시흥대로141길,648,398,250
2016,3,A,골목상권,1000672,시흥대로138길,14,8,6
2016,3,A,골목상권,1000671,시흥대로120길,618,413,205
2016,3,A,골목상권,1000670,벚꽃로56길,1878,1261,617
2016,3,A,골목상권,1000669,범안로17길,121,75,46
2016,3,A,골목상권,1000668,범안로11길,1144,906,238
2016,3,A,골목상권,1000667,문성로5길,146,43,103
2016,3,A,골목상권,1000666,독산로85길,78,26,52
2016,3,A,골목상권,1000665,독산로78다길,229,103,126
2016,3,A,골목상권,1000664,독산로70길,4,3,1
2016,3,A,골목상권,1000663,독산로64길,148,39,109
2016,3,A,골목상권,1000662,독산로50길,89,32,57
2016,3,A,골목상권,1000661,독산로40길,52,15,37
2016,3,A,골목상권,1000660,독산로108길,760,344,416
2016,3,A,골목상권,1000659,남부순환로112길,10,6,4
2016,3,A,골목상권,1000658,금하로24길,172,58,114
2016,3,A,골목상권,1000657,금하로1길,62,31,31
2016,3,A,골목상권,1000656,금하로14길,10,5,5
2016,3,A,골목상권,1000655,가산로5길,535,416,119
2016,3,A,골목상권,1000654,가산로3길,2487,1908,579
2016,3,A,골목상권,1000653,중앙로1길,1496,1036,460
2016,3,A,골목상권,1000652,중앙로15길,98,45,53
2016,3,A,골목상권,1000651,우마길,32,22,10
2016,3,A,골목상권,1000650,오류로8길,244,117,127
2016,3,A,골목상권,1000649,신도림로13길,741,555,186
2016,3,A,골목상권,1000648,새말로18길,1043,452,591
2016,3,A,골목상권,1000647,부일로1길,787,649,138
2016,3,A,골목상권,1000646,부일로15길,176,158,18
2016,3,A,골목상권,1000645,부일로11길,25,9,16
2016,3,A,골목상권,1000644,디지털로32길,1234,631,603
2016,3,A,골목상권,1000643,디지털로32가길,7161,5077,2084
2016,3,A,골목상권,1000642,디지털로27길,390,255,135
2016,3,A,골목상권,1000641,도림로6길,104,42,62
2016,3,A,골목상권,1000640,도림로12길,104,42,62
2016,3,A,골목상권,1000639,남부순환로97길,270,94,176
2016,3,A,골목상권,1000638,구로중앙로8길,227,85,142
2016,3,A,골목상권,1000637,구로중앙로7길,179,58,121
2016,3,A,골목상권,1000636,구로중앙로42길,779,578,201
2016,3,A,골목상권,1000635,구로중앙로34길,716,336,380
2016,3,A,골목상권,1000634,구로중앙로28길,3018,1504,1514
2016,3,A,골목상권,1000633,구로중앙로19길,8,5,3
2016,3,A,골목상권,1000632,구로동로8길,155,51,104
2016,3,A,골목상권,1000631,구로동로7길,157,63,94
2016,3,A,골목상권,1000630,구로동로42길,26,17,9
2016,3,A,골목상권,1000629,구로동로41길,450,275,175
2016,3,A,골목상권,1000628,구로동로38길,58,31,27
2016,3,A,골목상권,1000627,구로동로28길,165,73,92
2016,3,A,골목상권,1000626,구로동로15길,23,2,21
2016,3,A,골목상권,1000625,공원로6가길,324,237,87
2016,3,A,골목상권,1000624,고척로52길,234,76,158
2016,3,A,골목상권,1000623,고척로27다길,227,87,140
2016,3,A,골목상권,1000622,고척로27길,241,99,142
2016,3,A,골목상권,1000621,고척로21나길,248,62,186
2016,3,A,골목상권,1000620,경인로47길,831,470,361
2016,3,A,골목상권,1000619,경인로35길,276,116,160
2016,3,A,골목상권,1000618,경인로31길,49,16,33
2016,3,A,골목상권,1000617,경인로15길,134,64,70
2016,3,A,골목상권,1000616,개봉로3길,315,182,133
2016,3,A,골목상권,1000615,개봉로2길,460,123,337
2016,3,A,골목상권,1000614,개봉로23가길,935,534,401
2016,3,A,골목상권,1000613,개봉로20길,119,69,50
2016,3,A,골목상권,1000612,개봉로1길,51,24,27
2016,3,A,골목상권,1000611,개봉로17다길,142,69,73
2016,3,A,골목상권,1000610,개봉로17길,777,360,417
2016,3,A,골목상권,1000609,개봉로11길,58,15,43
2016,3,A,골목상권,1000608,화곡로64길,2765,1476,1289
2016,3,A,골목상권,1000607,화곡로59길,495,190,305
2016,3,A,골목상권,1000606,화곡로44나길,815,699,116
2016,3,A,골목상권,1000605,화곡로31길,1126,414,712
2016,3,A,골목상권,1000604,화곡로20길,512,319,193
2016,3,A,골목상권,1000603,화곡로13길,256,80,176
2016,3,A,골목상권,1000602,초원로16길,451,179,272
2016,3,A,골목상권,1000601,초록마을로8길,167,30,137
2016,3,A,골목상권,1000600,초록마을로3길,52,28,24
2016,3,A,골목상권,1000599,월정로20길,4,3,1
2016,3,A,골목상권,1000598,우장산로6길,310,192,118
2016,3,A,골목상권,1000597,양천로73가길,1387,905,482
2016,3,A,골목상권,1000596,양천로71길,216,135,81
2016,3,A,골목상권,1000595,양천로49길,747,606,141
2016,3,A,골목상권,1000594,양천로26길,114,46,68
2016,3,A,골목상권,1000593,양천로24길,270,124,146
2016,3,A,골목상권,1000592,양천로24가길,694,282,412
2016,3,A,골목상권,1000591,양천로14길,341,203,138
2016,3,A,골목상권,1000590,방화대로6라길,762,484,278
2016,3,A,골목상권,1000589,방화대로21길,752,445,307
2016,3,A,골목상권,1000588,등촌로5길,10,3,7
2016,3,A,골목상권,1000587,등촌로55길,462,326,136
2016,3,A,골목상권,1000586,등촌로51길,12,9,3
2016,3,A,골목상권,1000585,등촌로39길,61,21,40
2016,3,A,골목상권,1000584,등촌로13길,186,98,88
2016,3,A,골목상권,1000583,남부순환로11길,440,307,133
2016,3,A,골목상권,1000582,까치산로4길,122,47,75
2016,3,A,골목상권,1000581,국회대로7길,368,219,149
2016,3,A,골목상권,1000580,공항대로8길,178,75,103
2016,3,A,골목상권,1000579,공항대로61길,230,149,81
2016,3,A,골목상권,1000578,공항대로59다길,873,641,232
2016,3,A,골목상권,1000577,공항대로59길,1046,713,333
2016,3,A,골목상권,1000576,공항대로55길,953,663,290
2016,3,A,골목상권,1000575,공항대로42길,6,3,3
2016,3,A,골목상권,1000574,공항대로38길,267,147,120
2016,3,A,골목상권,1000573,곰달래로60길,569,299,270
2016,3,A,골목상권,1000572,곰달래로53길,54,18,36
2016,3,A,골목상권,1000571,곰달래로47길,37,17,20
2016,3,A,골목상권,1000570,곰달래로31길,9,8,1
2016,3,A,골목상권,1000569,곰달래로25길,598,238,360
2016,3,A,골목상권,1000568,개화동로25길,666,429,237
2016,3,A,골목상권,1000567,개화동로23길,99,64,35
2016,3,A,골목상권,1000566,강서로8길,275,87,188
2016,3,A,골목상권,1000565,강서로5라길,285,162,123
2016,3,A,골목상권,1000564,강서로5나길,107,62,45
2016,3,A,골목상권,1000563,강서로5가길,51,26,25
2016,3,A,골목상권,1000562,강서로47라길,82,43,39
2016,3,A,골목상권,1000561,강서로47길,405,205,200
2016,3,A,골목상권,1000560,강서로45다길,909,438,471
2016,3,A,골목상권,1000559,강서로45길,131,64,67
2016,3,A,골목상권,1000558,강서로35길,174,104,70
2016,3,A,골목상권,1000557,강서로29길,300,159,141
2016,3,A,골목상권,1000556,강서로18길,21,11,10
2016,3,A,골목상권,1000555,강서로17가길,110,49,61
2016,3,A,골목상권,1000554,강서로15길,250,133,117
2016,3,A,골목상권,1000553,가로공원로80길,58,27,31
2016,3,A,골목상권,1000552,가로공원로76가길,17,7,10
2016,3,A,골목상권,1000551,화곡로4길,239,90,149
2016,3,A,골목상권,1000550,화곡로3길,175,65,110
2016,3,A,골목상권,1000549,지양로7길,230,72,158
2016,3,A,골목상권,1000548,중앙로55길,352,185,167
2016,3,A,골목상권,1000547,중앙로51길,140,82,58
2016,3,A,골목상권,1000546,중앙로47길,126,26,100
2016,3,A,골목상권,1000545,중앙로45길,155,54,101
2016,3,A,골목상권,1000544,중앙로36길,2,2,0
2016,3,A,골목상권,1000543,중앙로32길,571,267,304
2016,3,A,골목상권,1000542,중앙로25길,250,77,173
2016,3,A,골목상권,1000541,은행정로7길,480,161,319
2016,3,A,골목상권,1000539,오목로5길,285,161,124
2016,3,A,골목상권,1000538,오목로3길,461,431,30
2016,3,A,골목상권,1000537,오목로30길,178,90,88
2016,3,A,골목상권,1000536,오목로23길,798,451,347
2016,3,A,골목상권,1000535,신월로20길,204,81,123
2016,3,A,골목상권,1000534,신월로15길,766,358,408
2016,3,A,골목상권,1000533,신목로6길,273,150,123
2016,3,A,골목상권,1000532,신목로5길,952,342,610
2016,3,A,골목상권,1000531,신목로2길,106,51,55
2016,3,A,골목상권,1000530,목동중앙서로8가길,171,98,73
2016,3,A,골목상권,1000529,목동중앙서로7길,262,91,171
2016,3,A,골목상권,1000528,목동중앙북로8길,365,109,256
2016,3,A,골목상권,1000527,목동중앙북로16길,280,89,191
2016,3,A,골목상권,1000526,목동중앙본로7길,104,40,64
2016,3,A,골목상권,1000525,목동중앙로3길,99,55,44
2016,3,A,골목상권,1000524,목동중앙로13나길,261,190,71
2016,3,A,골목상권,1000523,목동중앙남로3가길,591,397,194
2016,3,A,골목상권,1000522,목동로9길,2352,1541,811
2016,3,A,골목상권,1000521,목동로19길,1012,376,636
2016,3,A,골목상권,1000519,목동동로12길,429,168,261
2016,3,A,골목상권,1000518,목동남로4길,10,4,6
2016,3,A,골목상권,1000517,남부순환로88길,308,118,190
2016,3,A,골목상권,1000516,남부순환로79길,467,339,128
2016,3,A,골목상권,1000515,남부순환로70길,550,355,195
2016,3,A,골목상권,1000514,남부순환로58길,286,120,166
2016,3,A,골목상권,1000513,남부순환로40길,19,10,9
2016,3,A,골목상권,1000512,남부순환로33길,1176,932,244
2016,3,A,골목상권,1000511,곰달래로5길,42,25,17
2016,3,A,골목상권,1000510,곰달래로3길,395,209,186
2016,3,A,골목상권,1000509,곰달래로2길,285,168,117
2016,3,A,골목상권,1000508,곰달래로10길,316,229,87
2016,3,A,골목상권,1000507,가로공원로58길,93,21,72
2016,3,A,골목상권,1000506,효창원로93길,105,52,53
2016,3,A,골목상권,1000505,토정로37길,108,46,62
2016,3,A,골목상권,1000504,월드컵로8길,1586,894,692
2016,3,A,골목상권,1000503,월드컵로7길,4,2,2
2016,3,A,골목상권,1000502,월드컵로36길,124,40,84
2016,3,A,골목상권,1000501,월드컵로25길,310,175,135
2016,3,A,골목상권,1000500,월드컵로19길,545,240,305
2016,3,A,골목상권,1000499,월드컵로16길,3824,1925,1899
2016,3,A,골목상권,1000498,월드컵로11길,213,77,136
2016,3,A,골목상권,1000497,월드컵로10길,1635,890,745
2016,3,A,골목상권,1000496,와우산로3길,161,96,65
2016,3,A,골목상권,1000495,와우산로29길,151,75,76
2016,3,A,골목상권,1000494,와우산로29가길,18,6,12
2016,3,A,골목상권,1000493,양화진길,456,321,135
2016,3,A,골목상권,1000492,양화로1길,3931,1880,2051
2016,3,A,골목상권,1000491,양화로11길,384,245,139
2016,3,A,골목상권,1000490,신촌로30길,30,15,15
2016,3,A,골목상권,1000489,신촌로28가길,110,45,65
2016,3,A,골목상권,1000488,신촌로12길,1258,624,634
2016,3,A,골목상권,1000487,숭문길,1094,609,485
2016,3,A,골목상권,1000486,숭문8길,116,68,48
2016,3,A,골목상권,1000485,성지3길,449,253,196
2016,3,A,골목상권,1000484,성산로4길,1805,1124,681
2016,3,A,골목상권,1000483,성미산로32길,407,187,220
2016,3,A,골목상권,1000482,성미산로1길,671,493,178
2016,3,A,골목상권,1000481,성미산로11길,987,669,318
2016,3,A,골목상권,1000480,백범로16길,549,300,249
2016,3,A,골목상권,1000479,방울내로9안길,298,170,128
2016,3,A,골목상권,1000478,모래내로7길,240,127,113
2016,3,A,골목상권,1000477,매봉산로2길,2147,1477,670
2016,3,A,골목상권,1000476,망원로2길,156,90,66
2016,3,A,골목상권,1000475,망원로11길,992,537,455
2016,3,A,골목상권,1000474,만리재옛길,1550,645,905
2016,3,A,골목상권,1000473,마포대로4길,153,89,64
2016,3,A,골목상권,1000472,마포대로20길,1147,594,553
2016,3,A,골목상권,1000471,마포대로12길,62,35,27
2016,3,A,골목상권,1000470,동교로38길,241,106,135
2016,3,A,골목상권,1000469,동교로27길,3478,1557,1921
2016,3,A,골목상권,1000468,동교로25길,474,217,257
2016,3,A,골목상권,1000467,동교로19길,4637,2937,1700
2016,3,A,골목상권,1000466,동교로17길,794,410,384
2016,3,A,골목상권,1000465,독막로8길,318,148,170
2016,3,A,골목상권,1000464,독막로32길,462,188,274
2016,3,A,골목상권,1000463,독막로22길,76,39,37
2016,3,A,골목상권,1000462,도화길,1008,506,502
2016,3,A,골목상권,1000461,도화4길,374,116,258
2016,3,A,골목상권,1000460,대흥로28길,56,45,11
2016,3,A,골목상권,1000459,대흥로21길,491,100,391
2016,3,A,골목상권,1000458,광성로6길,110,70,40
2016,3,A,골목상권,1000457,홍제내길,110,62,48
2016,3,A,골목상권,1000456,홍연길,93,54,39
2016,3,A,골목상권,1000455,통일로39길,10,9,1
2016,3,A,골목상권,1000454,통일로37길,362,138,224
2016,3,A,골목상권,1000453,통일로11길,13,11,2
2016,3,A,골목상권,1000452,충정로6길,15682,8745,6937
2016,3,A,골목상권,1000451,충정로4길,3034,2041,993
2016,3,A,골목상권,1000450,증가로6길,200,71,129
2016,3,A,골목상권,1000449,증가로23나길,467,231,236
2016,3,A,골목상권,1000448,증가로20가길,265,99,166
2016,3,A,골목상권,1000447,증가로10길,168,92,76
2016,3,A,골목상권,1000446,응암로1길,353,246,107
2016,3,A,골목상권,1000445,연희로10길,89,60,29
2016,3,A,골목상권,1000444,신촌로37길,146,63,83
2016,3,A,골목상권,1000443,수색로8길,2424,2315,109
2016,3,A,골목상권,1000442,세무서길,333,122,211
2016,3,A,골목상권,1000440,세검정로1길,294,162,132
2016,3,A,골목상권,1000439,북아현로4길,431,110,321
2016,3,A,골목상권,1000438,모래내로15길,93,25,68
2016,3,A,골목상권,1000437,명지대길,354,236,118
2016,3,A,골목상권,1000436,독립문로8길,803,305,498
2016,3,A,골목상권,1000435,가재울로6길,8,6,2
2016,3,A,골목상권,1000434,통일로92길,80,37,43
2016,3,A,골목상권,1000433,통일로87길,230,107,123
2016,3,A,골목상권,1000432,통일로78길,216,62,154
2016,3,A,골목상권,1000430,진흥로1길,480,134,346
2016,3,A,골목상권,1000429,진흥로12길,464,192,272
2016,3,A,골목상권,1000428,증산서길,555,289,266
2016,3,A,골목상권,1000427,증산로9길,106,36,70
2016,3,A,골목상권,1000426,증산로5길,756,395,361
2016,3,A,골목상권,1000425,증산로21길,264,171,93
2016,3,A,골목상권,1000424,증산로17길,786,417,369
2016,3,A,골목상권,1000423,증산로15길,195,78,117
2016,3,A,골목상권,1000422,증산로13길,74,39,35
2016,3,A,골목상권,1000421,응암로34길,72,47,25
2016,3,A,골목상권,1000420,응암로22길,152,52,100
2016,3,A,골목상권,1000419,응암로14길,372,120,252
2016,3,A,골목상권,1000418,응암로13길,289,121,168
2016,3,A,골목상권,1000417,응암로12길,212,98,114
2016,3,A,골목상권,1000416,은평로8길,275,137,138
2016,3,A,골목상권,1000415,은평로3길,285,80,205
2016,3,A,골목상권,1000414,은평로20길,23,9,14
2016,3,A,골목상권,1000413,은평로13길,513,332,181
2016,3,A,골목상권,1000412,은평로10길,322,194,128
2016,3,A,골목상권,1000411,연서로5길,58,21,37
2016,3,A,골목상권,1000410,연서로41길,241,76,165
2016,3,A,골목상권,1000409,연서로3길,110,39,71
2016,3,A,골목상권,1000408,연서로34길,131,36,95
2016,3,A,골목상권,1000407,연서로33길,26,9,17
2016,3,A,골목상권,1000406,연서로29길,333,127,206
2016,3,A,골목상권,1000405,연서로28길,736,330,406
2016,3,A,골목상권,1000404,연서로27길,64,30,34
2016,3,A,골목상권,1000403,연서로21길,298,189,109
2016,3,A,골목상권,1000402,연서로17길,1070,327,743
2016,3,A,골목상권,1000401,연서로16길,283,107,176
2016,3,A,골목상권,1000400,연서로13길,695,223,472
2016,3,A,골목상권,1000399,연서로11길,239,115,124
2016,3,A,골목상권,1000398,역말로9길,21,16,5
2016,3,A,골목상권,1000397,수색로18길,24,11,13
2016,3,A,골목상권,1000396,서오릉로8길,16,1,15
2016,3,A,골목상권,1000395,서오릉로21길,467,142,325
2016,3,A,골목상권,1000394,불광천길,160,75,85
2016,3,A,골목상권,1000393,갈현로7길,969,266,703
2016,3,A,골목상권,1000392,갈현로41길,79,29,50
2016,3,A,골목상권,1000391,갈현로33길,32,8,24
2016,3,A,골목상권,1000390,갈현로1길,140,60,80
2016,3,A,골목상권,1000389,가좌로7길,47,21,26
2016,3,A,골목상권,1000388,한글비석로44길,459,250,209
2016,3,A,골목상권,1000387,한글비석로24길,395,156,239
2016,3,A,골목상권,1000386,한글비석로22길,773,318,455
2016,3,A,골목상권,1000385,석계로1길,107,67,40
2016,3,A,골목상권,1000384,상계로9가길,367,115,252
2016,3,A,골목상권,1000382,상계로12길,17,10,7
2016,3,A,골목상권,1000381,동일로242길,403,282,121
2016,3,A,골목상권,1000380,동일로192길,464,198,266
2016,3,A,골목상권,1000379,동일로173가길,2426,1343,1083
2016,3,A,골목상권,1000378,공릉로58길,104,45,59
2016,3,A,골목상권,1000377,해등로16길,78,60,18
2016,3,A,골목상권,1000376,우이천로4다길,193,109,84
2016,3,A,골목상권,1000375,우이천로32길,113,62,51
2016,3,A,골목상권,1000374,시루봉로23길,42,18,24
2016,3,A,골목상권,1000373,삼양로144길,67,47,20
2016,3,A,골목상권,1000372,방학로6가길,222,137,85
2016,3,A,골목상권,1000371,방학로5길,118,72,46
2016,3,A,골목상권,1000370,방학로15길,348,228,120
2016,3,A,골목상권,1000369,방학로10길,126,47,79
2016,3,A,골목상권,1000367,도봉산4길,328,285,43
2016,3,A,골목상권,1000366,도봉로181길,217,99,118
2016,3,A,골목상권,1000365,도봉로169나길,275,116,159
2016,3,A,골목상권,1000364,도봉로156길,261,133,128
2016,3,A,골목상권,1000363,도봉로152가길,426,384,42
2016,3,A,골목상권,1000362,도봉로147길,594,339,255
2016,3,A,골목상권,1000360,도봉로114길,471,163,308
2016,3,A,골목상권,1000359,도봉로109길,21,7,14
2016,3,A,골목상권,1000358,도당로29길,888,521,367
2016,3,A,골목상권,1000357,도당로19길,187,82,105
2016,3,A,골목상권,1000356,도당로13바길,203,81,122
2016,3,A,골목상권,1000355,도당로13가길,162,65,97
2016,3,A,골목상권,1000354,덕릉로60길,65,36,29
2016,3,A,골목상권,1000353,노해로63다길,593,251,342
2016,3,A,골목상권,1000352,노해로60길,309,123,186
2016,3,A,골목상권,1000351,한천로140길,91,46,45
2016,3,A,골목상권,1000350,한천로139가길,39,21,18
2016,3,A,골목상권,1000349,한천로132길,335,131,204
2016,3,A,골목상권,1000348,한천로130길,286,133,153
2016,3,A,골목상권,1000347,한천로124나길,87,41,46
2016,3,A,골목상권,1000346,한천로109길,624,282,342
2016,3,A,골목상권,1000345,인수봉로79길,178,44,134
2016,3,A,골목상권,1000344,인수봉로72길,86,41,45
2016,3,A,골목상권,1000343,인수봉로56길,10,1,9
2016,3,A,골목상권,1000342,오패산로67길,591,300,291
2016,3,A,골목상권,1000341,오패산로52길,91,27,64
2016,3,A,골목상권,1000339,수유로12길,303,208,95
2016,3,A,골목상권,1000338,솔샘로65길,519,228,291
2016,3,A,골목상권,1000337,솔매로50길,687,273,414
2016,3,A,골목상권,1000336,솔매로45길,202,90,112
2016,3,A,골목상권,1000335,솔매로41길,80,22,58
2016,3,A,골목상권,1000334,삼양로93길,16,4,12
2016,3,A,골목상권,1000333,삼양로77길,401,139,262
2016,3,A,골목상권,1000332,삼양로54길,7,4,3
2016,3,A,골목상권,1000331,삼양로41길,355,172,183
2016,3,A,골목상권,1000329,삼양로24길,83,36,47
2016,3,A,골목상권,1000328,삼양로20길,131,48,83
2016,3,A,골목상권,1000327,삼각산로28길,730,401,329
2016,3,A,골목상권,1000326,도봉로99길,165,85,80
2016,3,A,골목상권,1000325,도봉로8길,267,186,81
2016,3,A,골목상권,1000324,도봉로76길,389,211,178
2016,3,A,골목상권,1000323,도봉로67길,5,3,2
2016,3,A,골목상권,1000322,도봉로45길,118,72,46
2016,3,A,골목상권,1000321,도봉로18길,357,169,188
2016,3,A,골목상권,1000320,도봉로13길,27,9,18
2016,3,A,골목상권,1000319,덕릉로41길,740,599,141
2016,3,A,골목상권,1000318,덕릉로40길,892,692,200
2016,3,A,골목상권,1000317,노해로33길,31,12,19
2016,3,A,골목상권,1000315,노해로17길,255,82,173
2016,3,A,골목상권,1000314,화랑로40길,161,85,76
2016,3,A,골목상권,1000313,화랑로32길,440,314,126
2016,3,A,골목상권,1000312,화랑로1길,180,103,77
2016,3,A,골목상권,1000311,화랑로19길,476,251,225
2016,3,A,골목상권,1000310,화랑로14길,56,25,31
2016,3,A,골목상권,1000309,화랑로13길,84,41,43
2016,3,A,골목상권,1000308,한천로76길,139,82,57
2016,3,A,골목상권,1000307,한천로101가길,49,31,18
2016,3,A,골목상권,1000306,창경궁로43길,25,13,12
2016,3,A,골목상권,1000305,지봉로20길,98,61,37
2016,3,A,골목상권,1000304,종암로5길,118,85,33
2016,3,A,골목상권,1000303,종암로24가길,270,136,134
2016,3,A,골목상권,1000302,종암로21길,143,60,83
2016,3,A,골목상권,1000301,종암로19길,385,114,271
2016,3,A,골목상권,1000300,종암로16길,81,36,45
2016,3,A,골목상권,1000299,정릉로8길,194,106,88
2016,3,A,골목상권,1000298,정릉로27길,232,107,125
2016,3,A,골목상권,1000296,장위로50길,934,527,407
2016,3,A,골목상권,1000295,장월로1길,442,192,250
2016,3,A,골목상권,1000294,인촌로6길,2404,1232,1172
2016,3,A,골목상권,1000293,인촌로5길,27,4,23
2016,3,A,골목상권,1000292,인촌로24길,190,124,66
2016,3,A,골목상권,1000291,개운사길,3203,1989,1214
2016,3,A,골목상권,1000290,인촌로1길,143,101,42
2016,3,A,골목상권,1000289,인촌로17가길,3096,1161,1935
2016,3,A,골목상권,1000288,오패산로4길,601,194,407
2016,3,A,골목상권,1000287,오패산로3길,1138,656,482
2016,3,A,골목상권,1000286,오패산로19길,44,17,27
2016,3,A,골목상권,1000285,안암로5길,596,357,239
2016,3,A,골목상권,1000284,아리랑로4길,624,224,400
2016,3,A,골목상권,1000283,솔샘로6길,158,74,84
2016,3,A,골목상권,1000282,성북로8길,49,25,24
2016,3,A,골목상권,1000281,삼양로8길,87,46,41
2016,3,A,골목상권,1000280,삼선교로16가길,686,397,289
2016,3,A,골목상권,1000279,삼선교로10다길,116,48,68
2016,3,A,골목상권,1000278,삼선교로10길,225,101,124
2016,3,A,골목상권,1000277,보문로32길,949,387,562
2016,3,A,골목상권,1000276,보문로31길,745,324,421
2016,3,A,골목상권,1000274,보문로13길,780,461,319
2016,3,A,골목상권,1000273,보국문로16길,296,194,102
2016,3,A,골목상권,1000270,동소문로26가길,301,165,136
2016,3,A,골목상권,1000269,동소문로15길,62,35,27
2016,3,A,골목상권,1000268,동소문로13길,545,280,265
2016,3,A,골목상권,1000267,돌곶이로8길,236,104,132
2016,3,A,골목상권,1000266,돌곶이로41길,45,22,23
2016,3,A,골목상권,1000265,돌곶이로28길,163,96,67
2016,3,A,골목상권,1000264,돌곶이로27길,61,32,29
2016,3,A,골목상권,1000263,돌곶이로22길,97,48,49
2016,3,A,골목상권,1000261,길음로7길,10,7,3
2016,3,A,골목상권,1000260,중랑천로10길,777,406,371
2016,3,A,골목상권,1000259,용마산로94길,441,265,176
2016,3,A,골목상권,1000258,용마산로118길,567,275,292
2016,3,A,골목상권,1000257,용마산로112길,280,130,150
2016,3,A,골목상권,1000256,용마산로100길,454,312,142
2016,3,A,골목상권,1000255,신내로7가길,274,80,194
2016,3,A,골목상권,1000254,사가정로54길,107,36,71
2016,3,A,골목상권,1000253,사가정로42길,62,23,39
2016,3,A,골목상권,1000252,봉화산로56길,587,171,416
2016,3,A,골목상권,1000251,봉화산로4길,397,141,256
2016,3,A,골목상권,1000250,봉화산로30길,389,243,146
2016,3,A,골목상권,1000249,봉우재로33길,94,41,53
2016,3,A,골목상권,1000248,면목로78길,302,167,135
2016,3,A,골목상권,1000247,면목로56길,225,167,58
2016,3,A,골목상권,1000246,면목로55길,434,128,306
2016,3,A,골목상권,1000245,면목로49길,540,171,369
2016,3,A,골목상권,1000244,면목로48길,117,58,59
2016,3,A,골목상권,1000243,면목로45길,71,32,39
2016,3,A,골목상권,1000242,면목로33길,377,141,236
2016,3,A,골목상권,1000241,면목로21길,33,24,9
2016,3,A,골목상권,1000240,망우로73길,9,4,5
2016,3,A,골목상권,1000239,망우로68길,77,32,45
2016,3,A,골목상권,1000238,동일로163길,107,68,39
2016,3,A,골목상권,1000237,동일로157길,200,98,102
2016,3,A,골목상권,1000236,동일로149길,1134,830,304
2016,3,A,골목상권,1000235,동일로140길,225,93,132
2016,3,A,골목상권,1000234,동일로139길,62,36,26
2016,3,A,골목상권,1000233,동일로139가길,1169,690,479
2016,3,A,골목상권,1000232,동일로130길,97,22,75
2016,3,A,골목상권,1000231,동일로123길,162,83,79
2016,3,A,골목상권,1000230,동일로112길,171,81,90
2016,3,A,골목상권,1000229,동일로101길,300,118,182
2016,3,A,골목상권,1000228,동일로100길,31,14,17
2016,3,A,골목상권,1000227,답십리로75길,93,53,40
2016,3,A,골목상권,1000226,공릉로2길,637,303,334
2016,3,A,골목상권,1000225,공릉로12가길,47,32,15
2016,3,A,골목상권,1000224,겸재로54길,108,55,53
2016,3,A,골목상권,1000223,겸재로36길,232,193,39
2016,3,A,골목상권,1000222,겸재로29길,451,193,258
2016,3,A,골목상권,1000221,휘경로3길,236,116,120
2016,3,A,골목상권,1000220,휘경로2길,6,2,4
2016,3,A,골목상권,1000219,휘경로23길,16,0,16
2016,3,A,골목상권,1000218,휘경로14길,105,46,59
2016,3,A,골목상권,1000217,한천로46길,397,129,268
2016,3,A,골목상권,1000216,한천로40길,327,175,152
2016,3,A,골목상권,1000215,한천로33길,75,30,45
2016,3,A,골목상권,1000214,한천로14길,648,393,255
2016,3,A,골목상권,1000213,천호대로97길,338,216,122
2016,3,A,골목상권,1000212,천호대로77길,2018,1030,988
2016,3,A,골목상권,1000211,천호대로45길,163,102,61
2016,3,A,골목상권,1000210,천호대로17길,2136,1376,760
2016,3,A,골목상권,1000209,천호대로12길,837,565,272
2016,3,A,골목상권,1000208,천장산로7길,1419,882,537
2016,3,A,골목상권,1000207,제기로5길,192,105,87
2016,3,A,골목상권,1000206,제기로21길,212,140,72
2016,3,A,골목상권,1000205,전농로4길,681,431,250
2016,3,A,골목상권,1000204,전농로3길,106,50,56
2016,3,A,골목상권,1000203,전농로29길,319,155,164
2016,3,A,골목상권,1000202,장한로8길,818,498,320
2016,3,A,골목상권,1000201,장한로5길,2892,2019,873
2016,3,A,골목상권,1000200,장한로27길,162,49,113
2016,3,A,골목상권,1000199,장한로27가길,413,192,221
2016,3,A,골목상권,1000198,장한로26길,576,282,294
2016,3,A,골목상권,1000197,장한로26가길,387,155,232
2016,3,A,골목상권,1000196,장한로25길,1040,457,583
2016,3,A,골목상권,1000195,장한로14길,188,161,27
2016,3,A,골목상권,1000194,이문로42길,241,96,145
2016,3,A,골목상권,1000193,왕산로43길,965,477,488
2016,3,A,골목상권,1000192,왕산로33길,164,112,52
2016,3,A,골목상권,1000191,왕산로32길,12,8,4
2016,3,A,골목상권,1000190,약령시로17길,265,132,133
2016,3,A,골목상권,1000189,서울시립대로4길,656,340,316
2016,3,A,골목상권,1000188,서울시립대로29길,246,144,102
2016,3,A,골목상권,1000187,서울시립대로16길,145,29,116
2016,3,A,골목상권,1000186,사가정로2길,81,61,20
2016,3,A,골목상권,1000185,사가정로23가길,117,69,48
2016,3,A,골목상권,1000184,사가정로13길,280,91,189
2016,3,A,골목상권,1000183,무학로45길,371,213,158
2016,3,A,골목상권,1000182,무학로16길,1120,1004,116
2016,3,A,골목상권,1000181,망우로21길,190,106,84
2016,3,A,골목상권,1000180,망우로18길,512,199,313
2016,3,A,골목상권,1000179,망우로18가길,59,22,37
2016,3,A,골목상권,1000178,답십리로72길,14,12,2
2016,3,A,골목상권,1000177,답십리로69길,871,392,479
2016,3,A,골목상권,1000176,답십리로68길,157,101,56
2016,3,A,골목상권,1000175,답십리로64길,349,204,145
2016,3,A,골목상권,1000174,답십리로63길,112,70,42
2016,3,A,골목상권,1000173,답십리로60길,15,9,6
2016,3,A,골목상권,1000172,답십리로56길,5,4,1
2016,3,A,골목상권,1000171,답십리로23길,7,6,1
2016,3,A,골목상권,1000170,난계로30길,171,120,51
2016,3,A,골목상권,1000168,경희대로3길,267,168,99
2016,3,A,골목상권,1000167,천호대로129길,437,157,280
2016,3,A,골목상권,1000166,천호대로123길,311,120,191
2016,3,A,골목상권,1000165,천호대로109길,1067,562,505
2016,3,A,골목상권,1000164,자양번영로3길,91,39,52
2016,3,A,골목상권,1000162,자양로50길,19,5,14
2016,3,A,골목상권,1000161,자양로45길,549,298,251
2016,3,A,골목상권,1000160,자양로26길,312,94,218
2016,3,A,골목상권,1000159,자양로15길,355,241,114
2016,3,A,골목상권,1000158,자양로11길,1325,664,661
2016,3,A,골목상권,1000157,용마산로3길,830,463,367
2016,3,A,골목상권,1000156,용마산로21길,141,58,83
2016,3,A,골목상권,1000155,아차산로78길,2677,1460,1217
2016,3,A,골목상권,1000154,아차산로65길,717,466,251
2016,3,A,골목상권,1000153,아차산로55길,411,205,206
2016,3,A,골목상권,1000152,아차산로51길,270,156,114
2016,3,A,골목상권,1000151,아차산로40길,495,289,206
2016,3,A,골목상권,1000150,면목로17길,235,156,79
2016,3,A,골목상권,1000149,뚝섬로64길,304,156,148
2016,3,A,골목상권,1000148,뚝섬로58길,189,68,121
2016,3,A,골목상권,1000147,뚝섬로54길,270,202,68
2016,3,A,골목상권,1000146,뚝섬로48길,811,341,470
2016,3,A,골목상권,1000145,뚝섬로24길,100,37,63
2016,3,A,골목상권,1000144,뚝섬로23길,102,65,37
2016,3,A,골목상권,1000143,동일로24길,8,4,4
2016,3,A,골목상권,1000142,동일로18길,177,71,106
2016,3,A,골목상권,1000141,능동로4길,249,115,134
2016,3,A,골목상권,1000140,능동로3길,246,101,145
2016,3,A,골목상권,1000139,능동로34길,936,518,418
2016,3,A,골목상권,1000138,능동로19길,345,220,125
2016,3,A,골목상권,1000137,능동로13길,334,106,228
2016,3,A,골목상권,1000136,긴고랑로9길,62,29,33
2016,3,A,골목상권,1000135,긴고랑로8길,233,210,23
2016,3,A,골목상권,1000134,긴고랑로7길,542,260,282
2016,3,A,골목상권,1000133,긴고랑로20길,541,248,293
2016,3,A,골목상권,1000132,광나루로52길,1717,850,867
2016,3,A,골목상권,1000131,광나루로40길,97,49,48
2016,3,A,골목상권,1000130,광나루로37길,271,155,116
2016,3,A,골목상권,1000129,광나루로36길,37,26,11
2016,3,A,골목상권,1000128,광나루로24길,67,34,33
2016,3,A,골목상권,1000127,광나루로12길,958,532,426
2016,3,A,골목상권,1000126,한림말길,65,39,26
2016,3,A,골목상권,1000124,청계천로10나길,1805,1076,729
2016,3,A,골목상권,1000123,장터길,44,17,27
2016,3,A,골목상권,1000122,용답중앙길,96,57,39
2016,3,A,골목상권,1000121,용답29길,1913,985,928
2016,3,A,골목상권,1000120,왕십리로6길,1293,709,584
2016,3,A,골목상권,1000119,왕십리로31길,108,52,56
2016,3,A,골목상권,1000118,왕십리로26길,4178,2349,1829
2016,3,A,골목상권,1000117,왕십리로21길,163,53,110
2016,3,A,골목상권,1000116,왕십리로14길,2536,1936,600
2016,3,A,골목상권,1000115,아차산로5길,2220,1513,707
2016,3,A,골목상권,1000114,아차산로15길,3980,2863,1117
2016,3,A,골목상권,1000113,아차산로11길,3339,2207,1132
2016,3,A,골목상권,1000112,송정4가길,1037,481,556
2016,3,A,골목상권,1000111,송정12라길,272,182,90
2016,3,A,골목상권,1000110,성수일로6길,3034,1722,1312
2016,3,A,골목상권,1000109,성수이로7길,378,249,129
2016,3,A,골목상권,1000108,성수이로18길,2216,1566,650
2016,3,A,골목상권,1000107,성덕정길,612,380,232
2016,3,A,골목상권,1000106,성덕정17길,230,122,108
2016,3,A,골목상권,1000105,서울숲2길,1331,757,574
2016,3,A,골목상권,1000104,상원길,1736,1181,555
2016,3,A,골목상권,1000103,상원12길,181,106,75
2016,3,A,골목상권,1000102,사근동길,31,17,14
2016,3,A,골목상권,1000101,무학봉길,3,3,0
2016,3,A,골목상권,1000100,무학봉28길,165,77,88
2016,3,A,골목상권,1000099,무학로6길,367,217,150
2016,3,A,골목상권,1000098,무수막길,113,48,65
2016,3,A,골목상권,1000097,매봉길,22,14,8
2016,3,A,골목상권,1000096,마조로1길,198,74,124
2016,3,A,골목상권,1000095,마조로16길,782,545,237
2016,3,A,골목상권,1000094,마장로39길,145,60,85
2016,3,A,골목상권,1000093,마장로27길,99,37,62
2016,3,A,골목상권,1000091,둘레9길,411,239,172
2016,3,A,골목상권,1000090,금호산길,393,145,248
2016,3,A,골목상권,1000089,금호산2길,38,18,20
2016,3,A,골목상권,1000088,고산자로6길,14987,6213,8774
2016,3,A,골목상권,1000087,후암로28길,189,77,112
2016,3,A,골목상권,1000086,효창원로39길,54,36,18
2016,3,A,골목상권,1000085,회나무로13길,56,35,21
2016,3,A,골목상권,1000084,한남대로20길,687,385,302
2016,3,A,골목상권,1000082,한강대로7길,585,405,180
2016,3,A,골목상권,1000081,한강대로62길,624,419,205
2016,3,A,골목상권,1000080,한강대로52길,1177,761,416
2016,3,A,골목상권,1000079,한강대로43길,4653,2995,1658
2016,3,A,골목상권,1000078,한강대로15길,1889,381,1508
2016,3,A,골목상권,1000077,한강대로104길,4222,3010,1212
2016,3,A,골목상권,1000076,청파로73길,1310,743,567
2016,3,A,골목상권,1000075,청파로71길,218,112,106
2016,3,A,골목상권,1000074,청파로47나길,119,79,40
2016,3,A,골목상권,1000073,청파로47길,820,379,441
2016,3,A,골목상권,1000072,장문로45길,77,10,67
2016,3,A,골목상권,1000071,이태원로54길,2167,1070,1097
2016,3,A,골목상권,1000070,이태원로27길,530,297,233
2016,3,A,골목상권,1000069,이촌로22길,213,131,82
2016,3,A,골목상권,1000068,원효로89길,941,755,186
2016,3,A,골목상권,1000067,원효로53길,750,451,299
2016,3,A,골목상권,1000066,원효로41길,2387,1688,699
2016,3,A,골목상권,1000065,원효로19길,961,686,275
2016,3,A,골목상권,1000064,우사단로4길,168,121,47
2016,3,A,골목상권,1000063,우사단로14길,1640,877,763
2016,3,A,골목상권,1000062,우사단로10길,56,30,26
2016,3,A,골목상권,1000061,신흥로20길,196,94,102
2016,3,A,골목상권,1000060,소월로20길,128,40,88
2016,3,A,골목상권,1000059,서빙고로71길,448,261,187
2016,3,A,골목상권,1000058,백범로90길,307,179,128
2016,3,A,골목상권,1000057,백범로79길,1079,663,416
2016,3,A,골목상권,1000056,두텁바위로1길,2562,1438,1124
2016,3,A,골목상권,1000055,대사관로34길,325,181,144
2016,3,A,골목상권,1000054,녹사평대로46길,47,36,11
2016,3,A,골목상권,1000053,녹사평대로40나길,54,33,21
2016,3,A,골목상권,1000052,녹사평대로32길,291,149,142
2016,3,A,골목상권,1000051,녹사평대로26길,2105,1184,921
2016,3,A,골목상권,1000050,녹사평대로11길,294,196,98
2016,3,A,골목상권,1000049,퇴계로90길,473,193,280
2016,3,A,골목상권,1000048,퇴계로8길,2543,1350,1193
2016,3,A,골목상권,1000047,퇴계로56길,1022,814,208
2016,3,A,골목상권,1000046,퇴계로46길,1953,811,1142
2016,3,A,골목상권,1000045,퇴계로18길,2885,1316,1569
2016,3,A,골목상권,1000044,퇴계로12길,975,436,539
2016,3,A,골목상권,1000043,청구로1길,203,98,105
2016,3,A,골목상권,1000042,청구로17길,1677,780,897
2016,3,A,골목상권,1000041,장충단로8길,3984,1228,2756
2016,3,A,골목상권,1000040,삼일대로4길,959,574,385
2016,3,A,골목상권,1000039,명동길,36879,18411,18468
2016,3,A,골목상권,1000037,동호로20길,981,491,490
2016,3,A,골목상권,1000036,동호로15길,4133,2223,1910
2016,3,A,골목상권,1000035,동호로11길,20,16,4
2016,3,A,골목상권,1000034,동호로10길,1446,646,800
2016,3,A,골목상권,1000033,다산로39길,1166,667,499
2016,3,A,골목상권,1000032,다산로38길,1480,755,725
2016,3,A,골목상권,1000031,다산로36길,53,31,22
2016,3,A,골목상권,1000030,다산로33길,384,198,186
2016,3,A,골목상권,1000029,난계로21길,219,147,72
2016,3,A,골목상권,1000028,난계로11길,1884,1070,814
2016,3,A,골목상권,1000027,필운대로1길,5,1,4
2016,3,A,골목상권,1000026,평창길,157,68,89
2016,3,A,골목상권,1000025,통일로12길,241,107,134
2016,3,A,골목상권,1000024,창신길,246,63,183
2016,3,A,골목상권,1000023,창신5길,6,3,3
2016,3,A,골목상권,1000022,창신2길,52,30,22
2016,3,A,골목상권,1000021,창경궁로35길,1426,410,1016
2016,3,A,골목상권,1000020,지봉로8길,155,83,72
2016,3,A,골목상권,1000019,종로65길,628,281,347
2016,3,A,골목상권,1000016,자하문로7길,495,283,212
2016,3,A,골목상권,1000015,이화장길,1863,908,955
2016,3,A,골목상권,1000014,율곡로16길,11,7,4
2016,3,A,골목상권,1000013,율곡로10길,2334,1735,599
2016,3,A,골목상권,1000012,옥인길,490,209,281
2016,3,A,골목상권,1000011,숭인동길,19,8,11
2016,3,A,골목상권,1000010,성균관로5길,132,73,59
2016,3,A,골목상권,1000009,삼청로5길,436,164,272
2016,3,A,골목상권,1000008,북촌로5나길,1569,1093,476
2016,3,A,골목상권,1000007,북촌로5길,50,24,26
2016,3,A,골목상권,1000006,북촌로11길,19,11,8
2016,3,A,골목상권,1000005,백석동길,119,60,59
2016,3,A,골목상권,1000004,명륜길,16,10,6
2016,3,A,골목상권,1000003,돈화문로11가길,1074,566,508
2016,3,A,골목상권,1000001,계동길,844,375,469
2016,2,U,관광특구,1001496,강남 마이스 관광특구,20046,11439,8607
2016,2,U,관광특구,1001495,잠실 관광특구,26531,15664,10867
2016,2,U,관광특구,1001494,종로?청계 관광특구,30234,18431,11803
2016,2,U,관광특구,1001493,동대문패션타운 관광특구,10118,5826,4292
2016,2,U,관광특구,1001492,명동 남대문 북창동 다동 무교동 관광특구,165476,83367,82109
2016,2,U,관광특구,1001491,이태원 관광특구,5607,3207,2400
2016,2,R,전통시장,1001490,길동복조리시장,575,369,206
2016,2,R,전통시장,1001489,둔촌역전통시장,174,88,86
2016,2,R,전통시장,1001488,성내골목시장,7,2,5
2016,2,R,전통시장,1001487,천호시장,24,13,11
2016,2,R,전통시장,1001483,암사종합시장,715,317,398
2016,2,R,전통시장,1001482,고덕전통시장,388,374,14
2016,2,R,전통시장,1001481,명일골목시장,411,135,276
2016,2,R,전통시장,1001480,새마을시장,355,194,161
2016,2,R,전통시장,1001479,석촌시장,168,106,62
2016,2,R,전통시장,1001478,방이시장,674,431,243
2016,2,R,전통시장,1001477,마천시장,257,61,196
2016,2,R,전통시장,1001476,풍납시장,16,7,9
2016,2,R,전통시장,1001475,강남개포시장,35,30,5
2016,2,R,전통시장,1001474,도곡시장,516,228,288
2016,2,R,전통시장,1001471,영동전통시장,3202,2377,825
2016,2,R,전통시장,1001466,미성동도깨비시장,439,189,250
2016,2,R,전통시장,1001464,삼성동시장,107,46,61
2016,2,R,전통시장,1001463,신림중앙시장,13,8,5
2016,2,R,전통시장,1001462,강남골목시장,291,141,150
2016,2,R,전통시장,1001460,관악신사시장,315,253,62
2016,2,R,전통시장,1001459,신원시장,341,143,198
2016,2,R,전통시장,1001458,인헌시장,245,86,159
2016,2,R,전통시장,1001456,봉천현대시장,15,6,9
2016,2,R,전통시장,1001454,봉천제일종합시장,46,22,24
2016,2,R,전통시장,1001453,낙성대시장,17,10,7
2016,2,R,전통시장,1001452,중부시장,179,66,113
2016,2,R,전통시장,1001450,남성역골목시장,503,240,263
2016,2,R,전통시장,1001449,남성사계시장,1865,835,1030
2016,2,R,전통시장,1001448,흑석시장,182,72,110
2016,2,R,전통시장,1001447,상도4동도깨비골목시장,336,93,243
2016,2,R,전통시장,1001445,영도시장,72,31,41
2016,2,R,전통시장,1001441,본동인정시장,107,51,56
2016,2,R,전통시장,1001439,대림중앙시장,25,17,8
2016,2,R,전통시장,1001438,우리시장,12,5,7
2016,2,R,전통시장,1001437,영진시장A동,40,33,7
2016,2,R,전통시장,1001436,사러가시장,13,0,13
2016,2,R,전통시장,1001431,영등포청과시장,182,121,61
2016,2,R,전통시장,1001430,영등포전통시장,4070,2000,2070
2016,2,R,전통시장,1001429,은행나무시장,41,9,32
2016,2,R,전통시장,1001427,현대시장,57,18,39
2016,2,R,전통시장,1001424,남문시장,280,114,166
2016,2,R,전통시장,1001423,독산동 우시장,136,56,80
2016,2,R,전통시장,1001421,개봉중앙시장,7,3,4
2016,2,R,전통시장,1001419,가리봉시장,18,11,7
2016,2,R,전통시장,1001418,남구로시장,15,2,13
2016,2,R,전통시장,1001417,구로시장,50,20,30
2016,2,R,전통시장,1001415,방신전통시장,131,113,18
2016,2,R,전통시장,1001414,송화골목시장,503,187,316
2016,2,R,전통시장,1001413,까치산시장,35,23,12
2016,2,R,전통시장,1001411,남부골목시장,183,80,103
2016,2,R,전통시장,1001409,화곡중앙골목시장,2,2,0
2016,2,R,전통시장,1001407,등마루시장,815,463,352
2016,2,R,전통시장,1001406,신정3동골목시장,253,107,146
2016,2,R,전통시장,1001405,신정2동골목시장,9,7,2
2016,2,R,전통시장,1001402,신월6동골목시장,239,113,126
2016,2,R,전통시장,1001401,신곡종합시장,10,8,2
2016,2,R,전통시장,1001400,신월3동골목시장,54,18,36
2016,2,R,전통시장,1001399,경창시장,206,86,120
2016,2,R,전통시장,1001398,월정로시장,109,59,50
2016,2,R,전통시장,1001397,신영시장,50,23,27
2016,2,R,전통시장,1001396,목4동시장,232,76,156
2016,2,R,전통시장,1001395,목3동시장,701,340,361
2016,2,R,전통시장,1001394,목2동시장,211,99,112
2016,2,R,전통시장,1001393,마포농수산물시장,490,309,181
2016,2,R,전통시장,1001391,망원월드컵시장,13,9,4
2016,2,R,전통시장,1001390,망원시장,36,19,17
2016,2,R,전통시장,1001386,신수시장,123,97,26
2016,2,R,전통시장,1001385,아현시장,21,3,18
2016,2,R,전통시장,1001374,대림골목시장,300,94,206
2016,2,R,전통시장,1001367,상계중앙시장,30,15,15
2016,2,R,전통시장,1001364,방학동도깨비시장,125,50,75
2016,2,R,전통시장,1001363,쌍문역골목시장,71,34,37
2016,2,R,전통시장,1001361,신도봉시장,26,18,8
2016,2,R,전통시장,1001359,창동신창시장,137,61,76
2016,2,R,전통시장,1001358,수유북부시장,15,4,11
2016,2,R,전통시장,1001357,장미원골목시장,79,51,28
2016,2,R,전통시장,1001356,수유중앙시장,129,69,60
2016,2,R,전통시장,1001355,강북종합시장,64,28,36
2016,2,R,전통시장,1001354,우이시장,145,62,83
2016,2,R,전통시장,1001353,수유전통시장,453,136,317
2016,2,R,전통시장,1001352,번동북부골목시장,82,43,39
2016,2,R,전통시장,1001351,솔샘시장,103,41,62
2016,2,R,전통시장,1001349,방천골목시장,80,29,51
2016,2,R,전통시장,1001347,석관황금시장,26,14,12
2016,2,R,전통시장,1001343,장위전통시장,182,66,116
2016,2,R,전통시장,1001340,정릉시장,34,14,20
2016,2,R,전통시장,1001339,정릉아리랑시장,9,5,4
2016,2,R,전통시장,1001338,돈암제일시장,57,23,34
2016,2,R,전통시장,1001336,우림골목시장,215,104,111
2016,2,R,전통시장,1001335,묵1동도깨비시장,278,126,152
2016,2,R,전통시장,1001334,태능시장,4,3,1
2016,2,R,전통시장,1001333,중화제일시장,23,1,22
2016,2,R,전통시장,1001332,사가정시장,259,192,67
2016,2,R,전통시장,1001330,동원시장,70,30,40
2016,2,R,전통시장,1001329,동부골목시장,84,27,57
2016,2,R,전통시장,1001326,회기시장,140,65,75
2016,2,R,전통시장,1001323,답십리시장,27,11,16
2016,2,R,전통시장,1001321,답십리현대시장,86,71,15
2016,2,R,전통시장,1001319,청량리종합시장,9,6,3
2016,2,R,전통시장,1001317,청량리농수산물시장,19,15,4
2016,2,R,전통시장,1001316,서울약령시장,1360,835,525
2016,2,R,전통시장,1001313,청량리수산시장,248,120,128
2016,2,R,전통시장,1001310,구의시장,94,54,40
2016,2,R,전통시장,1001309,조양시장,79,42,37
2016,2,R,전통시장,1001308,영동교골목시장,29,23,6
2016,2,R,전통시장,1001307,능동로골목시장,242,220,22
2016,2,R,전통시장,1001304,자양골목시장,95,45,50
2016,2,R,전통시장,1001301,중곡제일시장,147,80,67
2016,2,R,전통시장,1001299,한아름시장,117,66,51
2016,2,R,전통시장,1001298,성동용답상가시장,280,147,133
2016,2,R,전통시장,1001297,뚝도시장,34,12,22
2016,2,R,전통시장,1001296,금남시장,19,10,9
2016,2,R,전통시장,1001295,행당시장,231,120,111
2016,2,R,전통시장,1001294,마장축산물시장,1598,1064,534
2016,2,R,전통시장,1001289,용문전통시장,38,23,15
2016,2,R,전통시장,1001286,후암시장,46,17,29
2016,2,R,전통시장,1001285,합동(새벽)시장,2326,1280,1046
2016,2,R,전통시장,1001284,서울중앙시장,251,175,76
2016,2,R,전통시장,1001283,백학시장,453,237,216
2016,2,R,전통시장,1001282,약수시장,1650,635,1015
2016,2,R,전통시장,1001281,청평화시장,2847,1825,1022
2016,2,R,전통시장,1001280,제일평화시장,474,292,182
2016,2,R,전통시장,1001278,남평화시장,185,114,71
2016,2,R,전통시장,1001277,방산종합시장,1884,1232,652
2016,2,R,전통시장,1001275,인현시장,1193,774,419
2016,2,R,전통시장,1001274,신중부시장,2473,1652,821
2016,2,R,전통시장,1001273,남대문시장,7144,3783,3361
2016,2,R,전통시장,1001271,동묘시장,914,592,322
2016,2,R,전통시장,1001270,창신골목시장,240,129,111
2016,2,R,전통시장,1001268,충신시장,352,202,150
2016,2,R,전통시장,1001267,종로신진시장,28,13,15
2016,2,R,전통시장,1001266,동대문종합시장,345,195,150
2016,2,R,전통시장,1001265,광장시장,209,147,62
2016,2,D,발달상권,1001263,서울 노원구 노원역_3,795,334,461
2016,2,D,발달상권,1001261,서울 노원구 노원역_1,941,286,655
2016,2,D,발달상권,1001260,창동역,2330,1516,814
2016,2,D,발달상권,1001259,서울 강북구 수유역_3,56,30,26
2016,2,D,발달상권,1001257,서울 강북구 수유역_2,4091,2122,1969
2016,2,D,발달상권,1001256,서울 강북구 수유역_1,109,86,23
2016,2,D,발달상권,1001255,서울 은평구 연신내역_3,618,193,425
2016,2,D,발달상권,1001254,서울 은평구 연신내역_2,411,167,244
2016,2,D,발달상권,1001253,서울 은평구 연신내역_1,67,33,34
2016,2,D,발달상권,1001252,서울 성북구 미아삼거리역_2,520,230,290
2016,2,D,발달상권,1001251,서울 강북구 미아삼거리역_1,514,187,327
2016,2,D,발달상권,1001250,서울 은평구 불광역_3,50,19,31
2016,2,D,발달상권,1001249,서울 은평구 불광역_2,61,24,37
2016,2,D,발달상권,1001248,서울 은평구 불광역_1,308,154,154
2016,2,D,발달상권,1001247,미아사거리_2,117,42,75
2016,2,D,발달상권,1001246,미아사거리_1,572,264,308
2016,2,D,발달상권,1001245,서울 성북구 성신여대입구역,4843,2996,1847
2016,2,D,발달상권,1001244,경희대학교,380,172,208
2016,2,D,발달상권,1001243,서울 성북구 안암역,85,52,33
2016,2,D,발달상권,1001242,혜화역 대학로_3,1728,832,896
2016,2,D,발달상권,1001241,혜화역 대학로_2,1503,868,635
2016,2,D,발달상권,1001240,혜화역 대학로_1,1293,659,634
2016,2,D,발달상권,1001239,디지털미디어시티,21972,13210,8762
2016,2,D,발달상권,1001238,서울 동대문구 청량리역,3131,1998,1133
2016,2,D,발달상권,1001236,서울 종로구 안국역_2,720,282,438
2016,2,D,발달상권,1001235,서울 종로구 안국역_1,11841,9691,2150
2016,2,D,발달상권,1001234,서울 종로구 경복궁역_1,208,78,130
2016,2,D,발달상권,1001233,서울 종로구 종로3가역_3,3166,1750,1416
2016,2,D,발달상권,1001232,서울 종로구 종로3가역_2,1851,1025,826
2016,2,D,발달상권,1001231,서울 동대문구 신설동역_2,4315,2150,2165
2016,2,D,발달상권,1001230,인사동,21657,13531,8126
2016,2,D,발달상권,1001229,서울 종로구 종로5가역_4,652,361,291
2016,2,D,발달상권,1001228,서울 종로구 종로5가역_3,5281,3577,1704
2016,2,D,발달상권,1001227,종로구청,15034,8637,6397
2016,2,D,발달상권,1001226,서울 종로구 종로5가역_2,18616,12530,6086
2016,2,D,발달상권,1001225,신설동역,736,436,300
2016,2,D,발달상권,1001224,서울 동대문구 신설동역_1,2,2,0
2016,2,D,발달상권,1001223,서울 종로구 광화문역_2,54301,33560,20741
2016,2,D,발달상권,1001222,동묘앞역,72,45,27
2016,2,D,발달상권,1001221,장안동사거리,549,269,280
2016,2,D,발달상권,1001220,서울 종로구 동대문역_2,1037,562,475
2016,2,D,발달상권,1001218,동대문시장_2,483,308,175
2016,2,D,발달상권,1001217,서울 종로구 종로5가역_1,53,39,14
2016,2,D,발달상권,1001216,서울 종로구 종로3가역_1,3404,1517,1887
2016,2,D,발달상권,1001215,서울 종로구 광화문역_1,2298,1532,766
2016,2,D,발달상권,1001214,종각역,20526,13301,7225
2016,2,D,발달상권,1001213,종각역 젊음의 거리,2127,953,1174
2016,2,D,발달상권,1001212,서대문구 서대문역_1,336,236,100
2016,2,D,발달상권,1001211,동대문시장_1,419,225,194
2016,2,D,발달상권,1001210,시청역_2,23204,14485,8719
2016,2,D,발달상권,1001209,서울시청,24480,11564,12916
2016,2,D,발달상권,1001208,서울 중구 을지로3가역_2,8112,5243,2869
2016,2,D,발달상권,1001207,서울 중구 신당역_2,1386,700,686
2016,2,D,발달상권,1001206,서대문구 서대문역_2,1978,1333,645
2016,2,D,발달상권,1001205,동대문역사문화공원역,4057,2884,1173
2016,2,D,발달상권,1001204,서울 중구 을지로3가역_1,14563,9846,4717
2016,2,D,발달상권,1001203,명동거리,25961,12077,13884
2016,2,D,발달상권,1001202,롯데백화점,40185,22885,17300
2016,2,D,발달상권,1001201,서울 중구 신당역_1,1061,700,361
2016,2,D,발달상권,1001200,북창동,7955,4897,3058
2016,2,D,발달상권,1001199,서울 중구 충무로역_2,14283,6360,7923
2016,2,D,발달상권,1001198,서울 강서구 송정역,638,434,204
2016,2,D,발달상권,1001197,장한평역_2,11886,9499,2387
2016,2,D,발달상권,1001196,시청역_1,54597,33424,21173
2016,2,D,발달상권,1001195,왕십리역_2,632,271,361
2016,2,D,발달상권,1001194,서울 강서구 발산역,722,439,283
2016,2,D,발달상권,1001193,장한평역_1,2380,1541,839
2016,2,D,발달상권,1001192,서울 중구 충무로역_1,3177,2208,969
2016,2,D,발달상권,1001190,장한평역,2290,1636,654
2016,2,D,발달상권,1001189,서울 중구 명동역,3538,1815,1723
2016,2,D,발달상권,1001188,장충동 족발거리,202,96,106
2016,2,D,발달상권,1001187,한양시장,265,122,143
2016,2,D,발달상권,1001186,서울 서대문구 이대역,1193,469,724
2016,2,D,발달상권,1001185,서울 서대문구 신촌역,2784,1133,1651
2016,2,D,발달상권,1001184,서울 마포구 홍대입구역_3,613,483,130
2016,2,D,발달상권,1001183,서울 마포구 홍대입구역_2,2969,1184,1785
2016,2,D,발달상권,1001182,홍익대학교 주변,15098,7653,7445
2016,2,D,발달상권,1001181,서울 광진구 군자역,173,102,71
2016,2,D,발달상권,1001180,신촌역,234,117,117
2016,2,D,발달상권,1001179,강서구청,3449,2238,1211
2016,2,D,발달상권,1001178,서울 마포구 홍대입구역_1,761,428,333
2016,2,D,발달상권,1001175,서울 강동구 고덕역,494,286,208
2016,2,D,발달상권,1001173,서울 강동구 명일역,831,332,499
2016,2,D,발달상권,1001172,어린이대공원역,137,97,40
2016,2,D,발달상권,1001171,서울 마포구 공덕역_2,4006,2374,1632
2016,2,D,발달상권,1001170,공덕역,6900,4303,2597
2016,2,D,발달상권,1001169,서울 용산구 숙대입구역,4381,3124,1257
2016,2,D,발달상권,1001168,남영역,14123,6269,7854
2016,2,D,발달상권,1001167,서울 마포구 공덕역_1,4623,2285,2338
2016,2,D,발달상권,1001166,서울 마포구 마포역_2,1189,688,501
2016,2,D,발달상권,1001165,서울 광진구 건대입구역_2,2799,1012,1787
2016,2,D,발달상권,1001164,서울 마포구 마포역_1,11310,6860,4450
2016,2,D,발달상권,1001163,서울 강동구 천호역_2,3917,1936,1981
2016,2,D,발달상권,1001162,서울 광진구 건대입구역_1,934,468,466
2016,2,D,발달상권,1001161,건대입구역,680,366,314
2016,2,D,발달상권,1001160,서울 광진구 구의역,892,541,351
2016,2,D,발달상권,1001159,서울 강동구 천호역,1001,471,530
2016,2,D,발달상권,1001158,당산역_2,4872,3024,1848
2016,2,D,발달상권,1001156,서울 강동구 길동역,1287,771,516
2016,2,D,발달상권,1001155,용산 전자상가_5,2352,1729,623
2016,2,D,발달상권,1001153,당산역_1,1115,704,411
2016,2,D,발달상권,1001152,서울 광진구 강변역,2149,1745,404
2016,2,D,발달상권,1001151,용산 전자상가_3,2465,1790,675
2016,2,D,발달상권,1001150,서울 용산구 이태원역,664,404,260
2016,2,D,발달상권,1001149,한남오거리,660,339,321
2016,2,D,발달상권,1001147,용산 전자상가_2,476,384,92
2016,2,D,발달상권,1001146,용산구청,111,77,34
2016,2,D,발달상권,1001145,용산 전자상가_1,8184,6283,1901
2016,2,D,발달상권,1001144,국회의사당역_2,39424,22686,16738
2016,2,D,발달상권,1001143,서울 용산구 신용산역,421,189,232
2016,2,D,발달상권,1001142,국회의사당역_1,5727,4405,1322
2016,2,D,발달상권,1001141,압구정 로데오거리_2,15390,6274,9116
2016,2,D,발달상권,1001140,서울 강남구 압구정역,10297,4759,5538
2016,2,D,발달상권,1001139,서울 영등포구 영등포구청역,3709,1148,2561
2016,2,D,발달상권,1001138,압구정 로데오거리_1,7482,2458,5024
2016,2,D,발달상권,1001137,서울 강동구 둔촌동역,51,15,36
2016,2,D,발달상권,1001136,오목교역,205,95,110
2016,2,D,발달상권,1001135,신사동 가로수길,21557,9956,11601
2016,2,D,발달상권,1001134,서울 영등포구 여의도역_2,47838,31761,16077
2016,2,D,발달상권,1001133,청담사거리_3,1396,477,919
2016,2,D,발달상권,1001132,영등포유통상가,2089,1325,764
2016,2,D,발달상권,1001131,청담역_2,1321,973,348
2016,2,D,발달상권,1001130,청담역_1,183,144,39
2016,2,D,발달상권,1001129,청담사거리_2,1021,789,232
2016,2,D,발달상권,1001127,서울 영등포구 여의도역_1,53750,31826,21924
2016,2,D,발달상권,1001125,학동사거리_2,2906,1637,1269
2016,2,D,발달상권,1001124,서울 영등포구 영등포시장역,345,269,76
2016,2,D,발달상권,1001123,학동사거리_1,3996,2033,1963
2016,2,D,발달상권,1001122,여의도 시범아파트앞,2358,1498,860
2016,2,D,발달상권,1001121,영등포역_3,866,523,343
2016,2,D,발달상권,1001120,도산공원사거리_1,9853,5820,4033
2016,2,D,발달상권,1001119,영등포역_2,1144,617,527
2016,2,D,발달상권,1001118,문래동 주민센터,73,62,11
2016,2,D,발달상권,1001117,강남구 신사역_2,7569,4927,2642
2016,2,D,발달상권,1001115,서울 강남구 강남구청역_2,4207,2578,1629
2016,2,D,발달상권,1001114,강남구 신사역_1,2543,1143,1400
2016,2,D,발달상권,1001113,서울 동작구 노량진1동_1,35,25,10
2016,2,D,발달상권,1001112,서울 강남구 학동역_3,9168,5243,3925
2016,2,D,발달상권,1001111,서울 강남구 강남구청역_1,3281,1934,1347
2016,2,D,발달상권,1001110,잠실역,5769,4481,1288
2016,2,D,발달상권,1001109,강남구 논현역_4,8954,4014,4940
2016,2,D,발달상권,1001108,학동역,1382,580,802
2016,2,D,발달상권,1001107,방이동 먹자골목,5324,3410,1914
2016,2,D,발달상권,1001106,서울 강남구 학동역_2,5416,2806,2610
2016,2,D,발달상권,1001105,서울 동작구 노량진역,3688,2139,1549
2016,2,D,발달상권,1001104,삼성역_3,8497,4889,3608
2016,2,D,발달상권,1001103,코엑스,20046,11439,8607
2016,2,D,발달상권,1001102,서울 강남구 학동역_1,5819,3549,2270
2016,2,D,발달상권,1001101,선정릉역_2,6757,4307,2450
2016,2,D,발달상권,1001100,강남구 논현역_3,1443,825,618
2016,2,D,발달상권,1001099,포스코사거리_2,7031,4529,2502
2016,2,D,발달상권,1001098,포스코사거리_1,50503,33686,16817
2016,2,D,발달상권,1001097,잠실역 롯데월드,3211,1556,1655
2016,2,D,발달상권,1001096,신도림역,3695,1978,1717
2016,2,D,발달상권,1001095,강남구 논현역_2,8085,3879,4206
2016,2,D,발달상권,1001094,선정릉역_1,1691,1175,516
2016,2,D,발달상권,1001093,신천역,6044,3337,2707
2016,2,D,발달상권,1001092,강남구 논현역_1,2919,1972,947
2016,2,D,발달상권,1001091,삼성역_2,17802,10478,7324
2016,2,D,발달상권,1001090,삼정역_2,2897,1333,1564
2016,2,D,발달상권,1001089,삼정역_1,2922,1585,1337
2016,2,D,발달상권,1001088,삼성역_1,28332,18672,9660
2016,2,D,발달상권,1001087,서울 강남구 선릉역_2,8118,5167,2951
2016,2,D,발달상권,1001086,고속터미널역,15694,4794,10900
2016,2,D,발달상권,1001085,서울 서초구 강남역,34388,19466,14922
2016,2,D,발달상권,1001084,서울 강남구 선릉역_1,19187,8328,10859
2016,2,D,발달상권,1001082,선릉역_2,20136,10500,9636
2016,2,D,발달상권,1001081,서울 강남구 역삼역_2,27877,21730,6147
2016,2,D,발달상권,1001080,서울 송파구 석촌역_1,40,29,11
2016,2,D,발달상권,1001078,서울 강남구 강남역_2,5698,3455,2243
2016,2,D,발달상권,1001077,선릉역_1,53428,28804,24624
2016,2,D,발달상권,1001076,구로역,166,94,72
2016,2,D,발달상권,1001075,역삼역_2,4539,2595,1944
2016,2,D,발달상권,1001074,대림역_2,7108,5395,1713
2016,2,D,발달상권,1001073,서울 강남구 역삼역_1,26029,16394,9635
2016,2,D,발달상권,1001072,신대방삼거리역,318,153,165
2016,2,D,발달상권,1001071,서울 강남구 한티역,1294,472,822
2016,2,D,발달상권,1001070,은마아파트입구사거리_4,88,53,35
2016,2,D,발달상권,1001067,오류동역,1498,745,753
2016,2,D,발달상권,1001066,서울 강남구 강남역,39309,18457,20852
2016,2,D,발달상권,1001063,교대역_4,5523,3103,2420
2016,2,D,발달상권,1001062,서울 강남구 강남역_1,135251,99401,35850
2016,2,D,발달상권,1001061,방배동카페골목,111,46,65
2016,2,D,발달상권,1001060,가락시장,16121,10273,5848
2016,2,D,발달상권,1001059,교대역_3,4445,2739,1706
2016,2,D,발달상권,1001058,역삼역_1,1900,995,905
2016,2,D,발달상권,1001057,교대역_2,3480,2209,1271
2016,2,D,발달상권,1001056,서울 송파구 가락시장역,5463,3550,1913
2016,2,D,발달상권,1001055,서울 서초구 서초역,11982,5047,6935
2016,2,D,발달상권,1001054,서울 강남구 대치역_2,1459,885,574
2016,2,D,발달상권,1001052,뱅뱅사거리_2,23947,15478,8469
2016,2,D,발달상권,1001051,보라매공원,14120,8125,5995
2016,2,D,발달상권,1001050,교대역_1,12965,7837,5128
2016,2,D,발달상권,1001049,개봉동 현대아파트 인근,155,71,84
2016,2,D,발달상권,1001048,뱅뱅사거리,10344,7168,3176
2016,2,D,발달상권,1001047,뱅뱅사거리_1,10136,7186,2950
2016,2,D,발달상권,1001046,서울 관악구 신림역_4,908,435,473
2016,2,D,발달상권,1001045,동작구 총신대입구역_1,222,105,117
2016,2,D,발달상권,1001044,양재역_3,3451,2396,1055
2016,2,D,발달상권,1001043,동작구 총신대입구역_2,855,371,484
2016,2,D,발달상권,1001042,서울 서초구 남부터미널역_3,1627,934,693
2016,2,D,발달상권,1001041,서울 강남구 수서역,19118,10909,8209
2016,2,D,발달상권,1001039,서울 서초구 남부터미널역_2,11278,5503,5775
2016,2,D,발달상권,1001038,구로디지탈1단지,65663,42167,23496
2016,2,D,발달상권,1001037,양재역,131,65,66
2016,2,D,발달상권,1001035,매봉역,467,214,253
2016,2,D,발달상권,1001034,서울 서초구 방배역,3751,2232,1519
2016,2,D,발달상권,1001033,서울 서초구 남부터미널역_1,705,499,206
2016,2,D,발달상권,1001032,서울 관악구 신림역_2,29,14,15
2016,2,D,발달상권,1001031,서울 관악구 신림역_1,2031,937,1094
2016,2,D,발달상권,1001030,양재역_2,8514,4724,3790
2016,2,D,발달상권,1001029,양재역_1,1015,711,304
2016,2,D,발달상권,1001028,서울 관악구 서울대입구역_2,41,4,37
2016,2,D,발달상권,1001027,가산디지털단지역_3,31705,19052,12653
2016,2,D,발달상권,1001026,구로디지털단지역,1970,1281,689
2016,2,D,발달상권,1001025,서울 관악구 서울대입구역_1,1989,862,1127
2016,2,D,발달상권,1001024,관악구 사당역_1,3906,1662,2244
2016,2,D,발달상권,1001023,가산디지털단지역_2,62635,37372,25263
2016,2,D,발달상권,1001022,관악구 사당역_2,366,193,173
2016,2,D,발달상권,1001021,가산디지털단지역_1,25352,17226,8126
2016,2,D,발달상권,1001020,장지역,4269,2696,1573
2016,2,D,발달상권,1001019,포이사거리_1,5742,3131,2611
2016,2,D,발달상권,1001018,포이사거리_2,7962,5385,2577
2016,2,D,발달상권,1001016,서울 관악구 대학동_1,86,51,35
2016,2,D,발달상권,1001015,서울 금천구 독산1동_1,3069,2113,956
2016,2,D,발달상권,1001013,양재 화물트럭터미널앞_2,232,128,104
2016,2,D,발달상권,1001012,양재 화물트럭터미널앞_1,4230,3308,922
2016,2,D,발달상권,1001011,서울 금천구 시흥1동_4,922,471,451
2016,2,A,골목상권,1001010,풍성로37가길,40,18,22
2016,2,A,골목상권,1001009,천호옛길,579,387,192
2016,2,A,골목상권,1001008,천호옛14길,621,303,318
2016,2,A,골목상권,1001007,천호대로219길,919,543,376
2016,2,A,골목상권,1001006,천호대로197길,19,4,15
2016,2,A,골목상권,1001005,천호대로187길,866,506,360
2016,2,A,골목상권,1001004,천호대로170길,404,165,239
2016,2,A,골목상권,1001003,천호대로162길,1214,858,356
2016,2,A,골목상권,1001002,천중로51길,432,233,199
2016,2,A,골목상권,1001001,천중로39길,582,210,372
2016,2,A,골목상권,1001000,진황도로47길,1154,580,574
2016,2,A,골목상권,1000999,진황도로27길,471,285,186
2016,2,A,골목상권,1000998,올림픽로98길,47,23,24
2016,2,A,골목상권,1000997,올림픽로80길,2,1,1
2016,2,A,골목상권,1000995,올림픽로77길,9,5,4
2016,2,A,골목상권,1000994,올림픽로71길,424,318,106
2016,2,A,골목상권,1000993,올림픽로48길,5694,3495,2199
2016,2,A,골목상권,1000992,양재대로96길,1374,833,541
2016,2,A,골목상권,1000991,양재대로95길,647,353,294
2016,2,A,골목상권,1000990,양재대로91길,1128,621,507
2016,2,A,골목상권,1000989,양재대로133길,317,118,199
2016,2,A,골목상권,1000988,양재대로124길,606,370,236
2016,2,A,골목상권,1000987,양재대로116길,219,89,130
2016,2,A,골목상권,1000986,양재대로101길,1197,688,509
2016,2,A,골목상권,1000985,암사길,361,166,195
2016,2,A,골목상권,1000984,성안로3길,1519,945,574
2016,2,A,골목상권,1000983,성내로5길,1081,569,512
2016,2,A,골목상권,1000982,상일로5길,61,34,27
2016,2,A,골목상권,1000981,상암로5길,482,207,275
2016,2,A,골목상권,1000980,상암로51길,751,328,423
2016,2,A,골목상권,1000979,상암로4길,265,211,54
2016,2,A,골목상권,1000978,상암로14길,427,268,159
2016,2,A,골목상권,1000977,명일로13길,121,49,72
2016,2,A,골목상권,1000976,동남로85길,120,61,59
2016,2,A,골목상권,1000975,동남로82길,7,3,4
2016,2,A,골목상권,1000974,동남로65길,97,34,63
2016,2,A,골목상권,1000973,구천면로42길,393,197,196
2016,2,A,골목상권,1000972,구천면로41길,604,256,348
2016,2,A,골목상권,1000971,구천면로36길,71,43,28
2016,2,A,골목상권,1000969,고덕로25길,14,11,3
2016,2,A,골목상권,1000968,고덕로10길,198,94,104
2016,2,A,골목상권,1000967,강동대로53길,913,504,409
2016,2,A,골목상권,1000966,풍성로25길,768,286,482
2016,2,A,골목상권,1000965,오금로46길,1362,697,665
2016,2,A,골목상권,1000964,오금로36길,1366,1044,322
2016,2,A,골목상권,1000963,오금로11길,2199,1417,782
2016,2,A,골목상권,1000962,양재대로72길,715,408,307
2016,2,A,골목상권,1000961,양재대로71길,1273,766,507
2016,2,A,골목상권,1000960,양재대로64길,1539,621,918
2016,2,A,골목상권,1000959,양재대로62길,6359,3876,2483
2016,2,A,골목상권,1000958,송파대로30길,1712,1098,614
2016,2,A,골목상권,1000957,송이로36길,1992,1427,565
2016,2,A,골목상권,1000956,송이로32길,784,432,352
2016,2,A,골목상권,1000955,송이로23길,1236,759,477
2016,2,A,골목상권,1000954,삼전로13길,1647,841,806
2016,2,A,골목상권,1000953,백제고분로50길,3316,1663,1653
2016,2,A,골목상권,1000952,백제고분로46길,1777,1145,632
2016,2,A,골목상권,1000951,백제고분로45길,522,333,189
2016,2,A,골목상권,1000950,백제고분로42길,137,78,59
2016,2,A,골목상권,1000949,백제고분로39길,1517,1076,441
2016,2,A,골목상권,1000948,백제고분로34길,1708,1117,591
2016,2,A,골목상권,1000947,백제고분로33길,845,534,311
2016,2,A,골목상권,1000946,백제고분로32길,1074,450,624
2016,2,A,골목상권,1000945,백제고분로31길,343,224,119
2016,2,A,골목상권,1000944,백제고분로22길,1064,638,426
2016,2,A,골목상권,1000943,백제고분로21길,195,137,58
2016,2,A,골목상권,1000942,마천로51길,132,57,75
2016,2,A,골목상권,1000941,동남로20길,163,97,66
2016,2,A,골목상권,1000940,거마로20길,429,196,233
2016,2,A,골목상권,1000939,학동로77길,2909,1526,1383
2016,2,A,골목상권,1000938,학동로6길,1873,944,929
2016,2,A,골목상권,1000937,학동로56길,963,537,426
2016,2,A,골목상권,1000936,학동로38길,6427,4169,2258
2016,2,A,골목상권,1000935,테헤란로81길,606,227,379
2016,2,A,골목상권,1000934,일원로9길,528,289,239
2016,2,A,골목상권,1000933,일원로3길,213,105,108
2016,2,A,골목상권,1000932,영동대로65길,3111,1826,1285
2016,2,A,골목상권,1000931,영동대로112길,727,479,248
2016,2,A,골목상권,1000930,언주로81길,9018,4188,4830
2016,2,A,골목상권,1000929,압구정로2길,2656,1413,1243
2016,2,A,골목상권,1000928,선릉로18길,441,245,196
2016,2,A,골목상권,1000927,선릉로146길,1877,990,887
2016,2,A,골목상권,1000926,선릉로133길,178,101,77
2016,2,A,골목상권,1000925,선릉로132길,1069,569,500
2016,2,A,골목상권,1000924,선릉로121길,1668,900,768
2016,2,A,골목상권,1000923,삼성로75길,2587,1405,1182
2016,2,A,골목상권,1000922,삼성로69길,316,156,160
2016,2,A,골목상권,1000921,삼성로64길,591,282,309
2016,2,A,골목상권,1000920,삼성로63길,144,68,76
2016,2,A,골목상권,1000919,삼성로57길,905,289,616
2016,2,A,골목상권,1000918,삼성로147길,813,341,472
2016,2,A,골목상권,1000917,삼성로115길,258,163,95
2016,2,A,골목상권,1000916,봉은사로68길,273,140,133
2016,2,A,골목상권,1000915,봉은사로57길,664,459,205
2016,2,A,골목상권,1000914,봉은사로43길,1041,710,331
2016,2,A,골목상권,1000913,봉은사로29길,133,89,44
2016,2,A,골목상권,1000912,봉은사로109길,308,165,143
2016,2,A,골목상권,1000911,도산대로89길,2682,1022,1660
2016,2,A,골목상권,1000910,도산대로81길,4615,1460,3155
2016,2,A,골목상권,1000909,도산대로50길,2783,1921,862
2016,2,A,골목상권,1000908,도산대로38길,169,91,78
2016,2,A,골목상권,1000907,도산대로30길,2822,1293,1529
2016,2,A,골목상권,1000906,도산대로23길,1630,954,676
2016,2,A,골목상권,1000905,도산대로15길,1746,803,943
2016,2,A,골목상권,1000904,도곡로37길,3317,2176,1141
2016,2,A,골목상권,1000903,논현로8길,757,412,345
2016,2,A,골목상권,1000902,논현로63길,10414,3017,7397
2016,2,A,골목상권,1000901,논현로28길,11409,8220,3189
2016,2,A,골목상권,1000900,논현로26길,6914,4249,2665
2016,2,A,골목상권,1000898,논현로139길,2484,1249,1235
2016,2,A,골목상권,1000897,논현로123길,94,58,36
2016,2,A,골목상권,1000896,논현로115길,2727,1437,1290
2016,2,A,골목상권,1000895,논현로10길,2586,1706,880
2016,2,A,골목상권,1000894,논현로106길,2706,1568,1138
2016,2,A,골목상권,1000893,남부순환로365길,179,125,54
2016,2,A,골목상권,1000891,개포로28길,285,211,74
2016,2,A,골목상권,1000890,개포로20길,4155,2340,1815
2016,2,A,골목상권,1000889,개포로17길,2693,1748,945
2016,2,A,골목상권,1000888,강남대로140길,4658,2553,2105
2016,2,A,골목상권,1000887,강남대로136길,1232,692,540
2016,2,A,골목상권,1000886,강남대로118길,588,324,264
2016,2,A,골목상권,1000885,서초중앙로8길,5709,4262,1447
2016,2,A,골목상권,1000884,방배중앙로21길,2175,687,1488
2016,2,A,골목상권,1000883,효령로72길,215,126,89
2016,2,A,골목상권,1000882,효령로34길,20,17,3
2016,2,A,골목상권,1000881,효령로31길,1487,868,619
2016,2,A,골목상권,1000880,효령로23길,714,419,295
2016,2,A,골목상권,1000879,청두곶길,1955,1286,669
2016,2,A,골목상권,1000878,주흥길,325,208,117
2016,2,A,골목상권,1000877,주흥15길,1681,1092,589
2016,2,A,골목상권,1000876,언남길,1984,1453,531
2016,2,A,골목상권,1000875,신반포로45길,403,267,136
2016,2,A,골목상권,1000874,서초대로8길,335,211,124
2016,2,A,골목상권,1000873,서초대로64길,487,346,141
2016,2,A,골목상권,1000872,서초대로4길,612,433,179
2016,2,A,골목상권,1000871,서초대로25길,3372,2037,1335
2016,2,A,골목상권,1000870,서초대로23길,515,307,208
2016,2,A,골목상권,1000869,서초대로15길,1241,586,655
2016,2,A,골목상권,1000868,사평대로57길,174,65,109
2016,2,A,골목상권,1000867,사평대로26길,17,12,5
2016,2,A,골목상권,1000866,사평대로22길,1437,866,571
2016,2,A,골목상권,1000865,사임당로17길,1735,1118,617
2016,2,A,골목상권,1000864,방배로42길,164,83,81
2016,2,A,골목상권,1000863,방배로35길,2444,1537,907
2016,2,A,골목상권,1000862,방배로18길,89,47,42
2016,2,A,골목상권,1000861,반포대로9길,707,461,246
2016,2,A,골목상권,1000860,바우뫼로39길,2074,1304,770
2016,2,A,골목상권,1000859,마방로2길,3901,2503,1398
2016,2,A,골목상권,1000858,방배천로4안길,1268,796,472
2016,2,A,골목상권,1000857,동산로19길,1325,887,438
2016,2,A,골목상권,1000856,동산로10길,2542,1320,1222
2016,2,A,골목상권,1000855,동광로39길,44,25,19
2016,2,A,골목상권,1000854,동광로1길,1203,722,481
2016,2,A,골목상권,1000853,동광로12길,808,543,265
2016,2,A,골목상권,1000852,논현로27길,3645,2610,1035
2016,2,A,골목상권,1000851,논현로1길,630,403,227
2016,2,A,골목상권,1000850,남부순환로339길,12012,5296,6716
2016,2,A,골목상권,1000849,남부순환로325길,7827,3987,3840
2016,2,A,골목상권,1000848,남부순환로317길,1509,1051,458
2016,2,A,골목상권,1000847,고무래로8길,6926,3725,3201
2016,2,A,골목상권,1000846,강남대로8길,3167,2154,1013
2016,2,A,골목상권,1000845,강남대로34길,995,656,339
2016,2,A,골목상권,1000844,강남대로23길,5889,4134,1755
2016,2,A,골목상권,1000843,소담길,23,5,18
2016,2,A,골목상권,1000842,원신길,307,116,191
2016,2,A,골목상권,1000840,양산길,424,297,127
2016,2,A,골목상권,1000839,호암로24길,660,260,400
2016,2,A,골목상권,1000838,호암로20길,40,28,12
2016,2,A,골목상권,1000837,행운길,19,3,16
2016,2,A,골목상권,1000836,행운1길,99,59,40
2016,2,A,골목상권,1000835,청림3길,72,35,37
2016,2,A,골목상권,1000834,청룡길,175,119,56
2016,2,A,골목상권,1000833,청룡8길,35,15,20
2016,2,A,골목상권,1000832,중앙길,283,101,182
2016,2,A,골목상권,1000831,조원중앙로2길,1135,779,356
2016,2,A,골목상권,1000830,조원로18길,1087,553,534
2016,2,A,골목상권,1000829,조원로10길,263,122,141
2016,2,A,골목상권,1000828,장군봉2길,295,128,167
2016,2,A,골목상권,1000827,장군봉1길,91,14,77
2016,2,A,골목상권,1000826,인헌길,84,39,45
2016,2,A,골목상권,1000825,은천로25길,268,81,187
2016,2,A,골목상권,1000824,양녕로6길,833,502,331
2016,2,A,골목상권,1000823,신원로3길,33,22,11
2016,2,A,골목상권,1000822,신사로20길,57,29,28
2016,2,A,골목상권,1000820,신림로64길,207,112,95
2016,2,A,골목상권,1000819,신림로48길,74,36,38
2016,2,A,골목상권,1000818,신림로38길,56,30,26
2016,2,A,골목상권,1000817,신림로28길,327,221,106
2016,2,A,골목상권,1000816,신림로11길,453,412,41
2016,2,A,골목상권,1000815,신림동길,344,198,146
2016,2,A,골목상권,1000814,승방길,553,360,193
2016,2,A,골목상권,1000813,서림7길,267,100,167
2016,2,A,골목상권,1000812,봉천로33길,370,236,134
2016,2,A,골목상권,1000811,봉천로13길,294,86,208
2016,2,A,골목상권,1000810,복은길,188,69,119
2016,2,A,골목상권,1000809,법원단지길,2,1,1
2016,2,A,골목상권,1000808,법원단지9길,91,35,56
2016,2,A,골목상권,1000807,미성5길,62,36,26
2016,2,A,골목상권,1000806,대학길,79,34,45
2016,2,A,골목상권,1000805,대학14길,12,2,10
2016,2,A,골목상권,1000804,당곡길,340,157,183
2016,2,A,골목상권,1000803,남현길,237,87,150
2016,2,A,골목상권,1000802,남현3길,455,274,181
2016,2,A,골목상권,1000801,남현2길,1,0,1
2016,2,A,골목상권,1000800,남부순환로248길,268,140,128
2016,2,A,골목상권,1000799,남부순환로234길,125,81,44
2016,2,A,골목상권,1000798,남부순환로172길,1670,917,753
2016,2,A,골목상권,1000797,남부순환로161길,19,5,14
2016,2,A,골목상권,1000796,남부순환로151길,109,63,46
2016,2,A,골목상권,1000795,남부순환로142길,69,32,37
2016,2,A,골목상권,1000794,난향길,174,50,124
2016,2,A,골목상권,1000793,난우길,421,178,243
2016,2,A,골목상권,1000792,난곡로74길,151,63,88
2016,2,A,골목상권,1000791,난곡로34길,24,7,17
2016,2,A,골목상권,1000790,난곡로26길,112,43,69
2016,2,A,골목상권,1000789,난곡로24길,36,15,21
2016,2,A,골목상권,1000788,낙성대역길,738,474,264
2016,2,A,골목상권,1000787,국회단지길,548,242,306
2016,2,A,골목상권,1000786,구암길,81,32,49
2016,2,A,골목상권,1000785,관천로22길,21,10,11
2016,2,A,골목상권,1000784,관천로15길,149,82,67
2016,2,A,골목상권,1000783,관악로30길,179,65,114
2016,2,A,골목상권,1000782,관악로28길,144,73,71
2016,2,A,골목상권,1000781,관악로14길,407,216,191
2016,2,A,골목상권,1000780,관악로10길,230,157,73
2016,2,A,골목상권,1000779,흑석로9길,198,82,116
2016,2,A,골목상권,1000778,흑석로13길,138,18,120
2016,2,A,골목상권,1000777,장승배기로27길,41,19,22
2016,2,A,골목상권,1000776,장승배기로19길,9,5,4
2016,2,A,골목상권,1000774,여의대방로46길,411,137,274
2016,2,A,골목상권,1000773,여의대방로24길,16038,7509,8529
2016,2,A,골목상권,1000772,여의대방로22카길,290,118,172
2016,2,A,골목상권,1000771,여의대방로22나길,128,49,79
2016,2,A,골목상권,1000770,여의대방로22길,202,114,88
2016,2,A,골목상권,1000769,양녕로26길,132,63,69
2016,2,A,골목상권,1000768,신대방길,109,73,36
2016,2,A,골목상권,1000767,성대로29길,2,2,0
2016,2,A,골목상권,1000766,성대로1길,329,131,198
2016,2,A,골목상권,1000765,서달로8가길,228,105,123
2016,2,A,골목상권,1000763,서달로14길,34,14,20
2016,2,A,골목상권,1000762,서달로10길,78,30,48
2016,2,A,골목상권,1000761,상도로62길,165,59,106
2016,2,A,골목상권,1000760,상도로61길,47,23,24
2016,2,A,골목상권,1000759,상도로47길,61,44,17
2016,2,A,골목상권,1000758,상도로37길,1968,961,1007
2016,2,A,골목상권,1000757,상도로15길,271,118,153
2016,2,A,골목상권,1000756,사당로8길,122,63,59
2016,2,A,골목상권,1000755,사당로30길,305,209,96
2016,2,A,골목상권,1000754,사당로2차길,142,94,48
2016,2,A,골목상권,1000753,사당로29길,17,14,3
2016,2,A,골목상권,1000752,사당로26길,253,136,117
2016,2,A,골목상권,1000751,사당로23나길,164,41,123
2016,2,A,골목상권,1000750,사당로23길,16,12,4
2016,2,A,골목상권,1000749,사당로20길,168,124,44
2016,2,A,골목상권,1000748,사당로16길,129,38,91
2016,2,A,골목상권,1000747,사당로16가길,792,486,306
2016,2,A,골목상권,1000746,만양로8길,77,35,42
2016,2,A,골목상권,1000745,만양로14길,353,146,207
2016,2,A,골목상권,1000744,등용로14길,627,446,181
2016,2,A,골목상권,1000743,동작대로7길,1860,759,1101
2016,2,A,골목상권,1000742,동작대로35길,258,92,166
2016,2,A,골목상권,1000741,동작대로33길,116,56,60
2016,2,A,골목상권,1000740,동작대로29길,35,18,17
2016,2,A,골목상권,1000739,동작대로17길,1315,689,626
2016,2,A,골목상권,1000738,대방동2길,461,225,236
2016,2,A,골목상권,1000737,대방동27길,137,80,57
2016,2,A,골목상권,1000736,노량진로6길,107,31,76
2016,2,A,골목상권,1000735,국사봉길,39,6,33
2016,2,A,골목상권,1000734,국사봉2길,110,71,39
2016,2,A,골목상권,1000733,국사봉1길,14,8,6
2016,2,A,골목상권,1000732,영신로9길,423,181,242
2016,2,A,골목상권,1000731,영등포로84길,345,85,260
2016,2,A,골목상권,1000730,영등포로80길,60,32,28
2016,2,A,골목상권,1000729,영등포로62길,4,3,1
2016,2,A,골목상권,1000728,영등포로35길,79,59,20
2016,2,A,골목상권,1000727,영등포로27길,343,208,135
2016,2,A,골목상권,1000724,여의대방로43나길,2319,1843,476
2016,2,A,골목상권,1000723,여의대방로39길,8,6,2
2016,2,A,골목상권,1000722,여의대방로35길,789,415,374
2016,2,A,골목상권,1000721,양평로28길,555,437,118
2016,2,A,골목상권,1000720,양평로22라길,53,34,19
2016,2,A,골목상권,1000719,양평로19길,4235,3399,836
2016,2,A,골목상권,1000718,신길로60길,431,188,243
2016,2,A,골목상권,1000717,신길로42길,369,186,183
2016,2,A,골목상권,1000716,신길로42가길,100,36,64
2016,2,A,골목상권,1000715,신길로39길,102,51,51
2016,2,A,골목상권,1000714,신길로17길,45,29,16
2016,2,A,골목상권,1000713,선유서로28길,570,272,298
2016,2,A,골목상권,1000712,선유서로25길,2403,1728,675
2016,2,A,골목상권,1000711,선유서로24길,160,88,72
2016,2,A,골목상권,1000710,선유로55길,2311,1401,910
2016,2,A,골목상권,1000709,디지털로74길,56,35,21
2016,2,A,골목상권,1000708,디지털로57길,5,1,4
2016,2,A,골목상권,1000707,디지털로37길,235,110,125
2016,2,A,골목상권,1000706,도신로62길,179,52,127
2016,2,A,골목상권,1000705,도신로60길,65,16,49
2016,2,A,골목상권,1000704,도신로29길,95,41,54
2016,2,A,골목상권,1000703,도신로15길,74,31,43
2016,2,A,골목상권,1000702,도림천로21길,95,41,54
2016,2,A,골목상권,1000701,도림로63길,33,22,11
2016,2,A,골목상권,1000700,도림로147길,1672,1212,460
2016,2,A,골목상권,1000699,도림로112길,22,10,12
2016,2,A,골목상권,1000698,대림로8길,1801,579,1222
2016,2,A,골목상권,1000697,대림로7길,15,5,10
2016,2,A,골목상권,1000696,대림로44길,45,27,18
2016,2,A,골목상권,1000695,대림로34길,186,73,113
2016,2,A,골목상권,1000694,대림로31길,744,351,393
2016,2,A,골목상권,1000693,대림로29길,1604,781,823
2016,2,A,골목상권,1000692,대림로22길,337,189,148
2016,2,A,골목상권,1000691,당산로46길,3600,1974,1626
2016,2,A,골목상권,1000690,당산로38길,296,230,66
2016,2,A,골목상권,1000689,당산로37길,3683,2251,1432
2016,2,A,골목상권,1000688,당산로31길,4027,2270,1757
2016,2,A,골목상권,1000687,국회대로56길,1651,1077,574
2016,2,A,골목상권,1000686,경인로90길,325,198,127
2016,2,A,골목상권,1000685,경인로80길,1594,1154,440
2016,2,A,골목상권,1000684,경인로77길,643,428,215
2016,2,A,골목상권,1000683,가마산로61길,168,60,108
2016,2,A,골목상권,1000682,시흥대로94길,769,399,370
2016,2,A,골목상권,1000681,시흥대로84길,176,69,107
2016,2,A,골목상권,1000680,시흥대로68길,414,136,278
2016,2,A,골목상권,1000679,시흥대로63길,2796,1466,1330
2016,2,A,골목상권,1000678,시흥대로62가길,438,126,312
2016,2,A,골목상권,1000677,시흥대로36길,360,210,150
2016,2,A,골목상권,1000676,시흥대로22길,509,357,152
2016,2,A,골목상권,1000675,시흥대로153길,610,321,289
2016,2,A,골목상권,1000674,시흥대로150길,565,256,309
2016,2,A,골목상권,1000673,시흥대로141길,648,398,250
2016,2,A,골목상권,1000672,시흥대로138길,14,8,6
2016,2,A,골목상권,1000671,시흥대로120길,618,413,205
2016,2,A,골목상권,1000670,벚꽃로56길,1878,1261,617
2016,2,A,골목상권,1000669,범안로17길,121,75,46
2016,2,A,골목상권,1000668,범안로11길,1144,906,238
2016,2,A,골목상권,1000667,문성로5길,146,43,103
2016,2,A,골목상권,1000666,독산로85길,78,26,52
2016,2,A,골목상권,1000665,독산로78다길,229,103,126
2016,2,A,골목상권,1000664,독산로70길,4,3,1
2016,2,A,골목상권,1000663,독산로64길,148,39,109
2016,2,A,골목상권,1000662,독산로50길,89,32,57
2016,2,A,골목상권,1000661,독산로40길,52,15,37
2016,2,A,골목상권,1000660,독산로108길,760,344,416
2016,2,A,골목상권,1000659,남부순환로112길,10,6,4
2016,2,A,골목상권,1000658,금하로24길,172,58,114
2016,2,A,골목상권,1000657,금하로1길,62,31,31
2016,2,A,골목상권,1000656,금하로14길,10,5,5
2016,2,A,골목상권,1000655,가산로5길,535,416,119
2016,2,A,골목상권,1000654,가산로3길,2487,1908,579
2016,2,A,골목상권,1000653,중앙로1길,1496,1036,460
2016,2,A,골목상권,1000652,중앙로15길,98,45,53
2016,2,A,골목상권,1000651,우마길,32,22,10
2016,2,A,골목상권,1000650,오류로8길,244,117,127
2016,2,A,골목상권,1000649,신도림로13길,741,555,186
2016,2,A,골목상권,1000648,새말로18길,1043,452,591
2016,2,A,골목상권,1000647,부일로1길,787,649,138
2016,2,A,골목상권,1000646,부일로15길,176,158,18
2016,2,A,골목상권,1000645,부일로11길,25,9,16
2016,2,A,골목상권,1000644,디지털로32길,1234,631,603
2016,2,A,골목상권,1000643,디지털로32가길,7161,5077,2084
2016,2,A,골목상권,1000642,디지털로27길,390,255,135
2016,2,A,골목상권,1000641,도림로6길,104,42,62
2016,2,A,골목상권,1000640,도림로12길,104,42,62
2016,2,A,골목상권,1000639,남부순환로97길,270,94,176
2016,2,A,골목상권,1000638,구로중앙로8길,227,85,142
2016,2,A,골목상권,1000637,구로중앙로7길,179,58,121
2016,2,A,골목상권,1000636,구로중앙로42길,779,578,201
2016,2,A,골목상권,1000635,구로중앙로34길,716,336,380
2016,2,A,골목상권,1000634,구로중앙로28길,3018,1504,1514
2016,2,A,골목상권,1000633,구로중앙로19길,8,5,3
2016,2,A,골목상권,1000632,구로동로8길,155,51,104
2016,2,A,골목상권,1000631,구로동로7길,157,63,94
2016,2,A,골목상권,1000630,구로동로42길,26,17,9
2016,2,A,골목상권,1000629,구로동로41길,450,275,175
2016,2,A,골목상권,1000628,구로동로38길,58,31,27
2016,2,A,골목상권,1000627,구로동로28길,165,73,92
2016,2,A,골목상권,1000626,구로동로15길,23,2,21
2016,2,A,골목상권,1000625,공원로6가길,324,237,87
2016,2,A,골목상권,1000624,고척로52길,234,76,158
2016,2,A,골목상권,1000623,고척로27다길,227,87,140
2016,2,A,골목상권,1000622,고척로27길,241,99,142
2016,2,A,골목상권,1000621,고척로21나길,248,62,186
2016,2,A,골목상권,1000620,경인로47길,831,470,361
2016,2,A,골목상권,1000619,경인로35길,276,116,160
2016,2,A,골목상권,1000618,경인로31길,49,16,33
2016,2,A,골목상권,1000617,경인로15길,134,64,70
2016,2,A,골목상권,1000616,개봉로3길,315,182,133
2016,2,A,골목상권,1000615,개봉로2길,460,123,337
2016,2,A,골목상권,1000614,개봉로23가길,935,534,401
2016,2,A,골목상권,1000613,개봉로20길,119,69,50
2016,2,A,골목상권,1000612,개봉로1길,51,24,27
2016,2,A,골목상권,1000611,개봉로17다길,142,69,73
2016,2,A,골목상권,1000610,개봉로17길,777,360,417
2016,2,A,골목상권,1000609,개봉로11길,58,15,43
2016,2,A,골목상권,1000608,화곡로64길,2765,1476,1289
2016,2,A,골목상권,1000607,화곡로59길,495,190,305
2016,2,A,골목상권,1000606,화곡로44나길,815,699,116
2016,2,A,골목상권,1000605,화곡로31길,1126,414,712
2016,2,A,골목상권,1000604,화곡로20길,512,319,193
2016,2,A,골목상권,1000603,화곡로13길,256,80,176
2016,2,A,골목상권,1000602,초원로16길,451,179,272
2016,2,A,골목상권,1000601,초록마을로8길,167,30,137
2016,2,A,골목상권,1000600,초록마을로3길,52,28,24
2016,2,A,골목상권,1000599,월정로20길,4,3,1
2016,2,A,골목상권,1000598,우장산로6길,310,192,118
2016,2,A,골목상권,1000597,양천로73가길,1387,905,482
2016,2,A,골목상권,1000596,양천로71길,216,135,81
2016,2,A,골목상권,1000595,양천로49길,747,606,141
2016,2,A,골목상권,1000594,양천로26길,114,46,68
2016,2,A,골목상권,1000593,양천로24길,270,124,146
2016,2,A,골목상권,1000592,양천로24가길,694,282,412
2016,2,A,골목상권,1000591,양천로14길,341,203,138
2016,2,A,골목상권,1000590,방화대로6라길,762,484,278
2016,2,A,골목상권,1000589,방화대로21길,752,445,307
2016,2,A,골목상권,1000588,등촌로5길,10,3,7
2016,2,A,골목상권,1000587,등촌로55길,462,326,136
2016,2,A,골목상권,1000586,등촌로51길,12,9,3
2016,2,A,골목상권,1000585,등촌로39길,61,21,40
2016,2,A,골목상권,1000584,등촌로13길,186,98,88
2016,2,A,골목상권,1000583,남부순환로11길,440,307,133
2016,2,A,골목상권,1000582,까치산로4길,122,47,75
2016,2,A,골목상권,1000581,국회대로7길,368,219,149
2016,2,A,골목상권,1000580,공항대로8길,178,75,103
2016,2,A,골목상권,1000579,공항대로61길,230,149,81
2016,2,A,골목상권,1000578,공항대로59다길,873,641,232
2016,2,A,골목상권,1000577,공항대로59길,1046,713,333
2016,2,A,골목상권,1000576,공항대로55길,953,663,290
2016,2,A,골목상권,1000575,공항대로42길,6,3,3
2016,2,A,골목상권,1000574,공항대로38길,267,147,120
2016,2,A,골목상권,1000573,곰달래로60길,569,299,270
2016,2,A,골목상권,1000572,곰달래로53길,54,18,36
2016,2,A,골목상권,1000571,곰달래로47길,37,17,20
2016,2,A,골목상권,1000570,곰달래로31길,9,8,1
2016,2,A,골목상권,1000569,곰달래로25길,598,238,360
2016,2,A,골목상권,1000568,개화동로25길,666,429,237
2016,2,A,골목상권,1000567,개화동로23길,99,64,35
2016,2,A,골목상권,1000566,강서로8길,275,87,188
2016,2,A,골목상권,1000565,강서로5라길,285,162,123
2016,2,A,골목상권,1000564,강서로5나길,107,62,45
2016,2,A,골목상권,1000563,강서로5가길,51,26,25
2016,2,A,골목상권,1000562,강서로47라길,82,43,39
2016,2,A,골목상권,1000561,강서로47길,405,205,200
2016,2,A,골목상권,1000560,강서로45다길,909,438,471
2016,2,A,골목상권,1000559,강서로45길,131,64,67
2016,2,A,골목상권,1000558,강서로35길,174,104,70
2016,2,A,골목상권,1000557,강서로29길,300,159,141
2016,2,A,골목상권,1000556,강서로18길,21,11,10
2016,2,A,골목상권,1000555,강서로17가길,110,49,61
2016,2,A,골목상권,1000554,강서로15길,250,133,117
2016,2,A,골목상권,1000553,가로공원로80길,58,27,31
2016,2,A,골목상권,1000552,가로공원로76가길,17,7,10
2016,2,A,골목상권,1000551,화곡로4길,239,90,149
2016,2,A,골목상권,1000550,화곡로3길,175,65,110
2016,2,A,골목상권,1000549,지양로7길,230,72,158
2016,2,A,골목상권,1000548,중앙로55길,352,185,167
2016,2,A,골목상권,1000547,중앙로51길,140,82,58
2016,2,A,골목상권,1000546,중앙로47길,126,26,100
2016,2,A,골목상권,1000545,중앙로45길,155,54,101
2016,2,A,골목상권,1000544,중앙로36길,2,2,0
2016,2,A,골목상권,1000543,중앙로32길,571,267,304
2016,2,A,골목상권,1000542,중앙로25길,250,77,173
2016,2,A,골목상권,1000541,은행정로7길,480,161,319
2016,2,A,골목상권,1000539,오목로5길,285,161,124
2016,2,A,골목상권,1000538,오목로3길,461,431,30
2016,2,A,골목상권,1000537,오목로30길,178,90,88
2016,2,A,골목상권,1000536,오목로23길,798,451,347
2016,2,A,골목상권,1000535,신월로20길,204,81,123
2016,2,A,골목상권,1000534,신월로15길,766,358,408
2016,2,A,골목상권,1000533,신목로6길,273,150,123
2016,2,A,골목상권,1000532,신목로5길,952,342,610
2016,2,A,골목상권,1000531,신목로2길,106,51,55
2016,2,A,골목상권,1000530,목동중앙서로8가길,171,98,73
2016,2,A,골목상권,1000529,목동중앙서로7길,262,91,171
2016,2,A,골목상권,1000528,목동중앙북로8길,365,109,256
2016,2,A,골목상권,1000527,목동중앙북로16길,280,89,191
2016,2,A,골목상권,1000526,목동중앙본로7길,104,40,64
2016,2,A,골목상권,1000525,목동중앙로3길,99,55,44
2016,2,A,골목상권,1000524,목동중앙로13나길,261,190,71
2016,2,A,골목상권,1000523,목동중앙남로3가길,591,397,194
2016,2,A,골목상권,1000522,목동로9길,2352,1541,811
2016,2,A,골목상권,1000521,목동로19길,1012,376,636
2016,2,A,골목상권,1000519,목동동로12길,429,168,261
2016,2,A,골목상권,1000518,목동남로4길,10,4,6
2016,2,A,골목상권,1000517,남부순환로88길,308,118,190
2016,2,A,골목상권,1000516,남부순환로79길,467,339,128
2016,2,A,골목상권,1000515,남부순환로70길,550,355,195
2016,2,A,골목상권,1000514,남부순환로58길,286,120,166
2016,2,A,골목상권,1000513,남부순환로40길,19,10,9
2016,2,A,골목상권,1000512,남부순환로33길,1176,932,244
2016,2,A,골목상권,1000511,곰달래로5길,42,25,17
2016,2,A,골목상권,1000510,곰달래로3길,395,209,186
2016,2,A,골목상권,1000509,곰달래로2길,285,168,117
2016,2,A,골목상권,1000508,곰달래로10길,316,229,87
2016,2,A,골목상권,1000507,가로공원로58길,93,21,72
2016,2,A,골목상권,1000506,효창원로93길,105,52,53
2016,2,A,골목상권,1000505,토정로37길,108,46,62
2016,2,A,골목상권,1000504,월드컵로8길,1586,894,692
2016,2,A,골목상권,1000503,월드컵로7길,4,2,2
2016,2,A,골목상권,1000502,월드컵로36길,124,40,84
2016,2,A,골목상권,1000501,월드컵로25길,310,175,135
2016,2,A,골목상권,1000500,월드컵로19길,545,240,305
2016,2,A,골목상권,1000499,월드컵로16길,3824,1925,1899
2016,2,A,골목상권,1000498,월드컵로11길,213,77,136
2016,2,A,골목상권,1000497,월드컵로10길,1635,890,745
2016,2,A,골목상권,1000496,와우산로3길,161,96,65
2016,2,A,골목상권,1000495,와우산로29길,151,75,76
2016,2,A,골목상권,1000494,와우산로29가길,18,6,12
2016,2,A,골목상권,1000493,양화진길,456,321,135
2016,2,A,골목상권,1000492,양화로1길,3931,1880,2051
2016,2,A,골목상권,1000491,양화로11길,384,245,139
2016,2,A,골목상권,1000490,신촌로30길,30,15,15
2016,2,A,골목상권,1000489,신촌로28가길,110,45,65
2016,2,A,골목상권,1000488,신촌로12길,1258,624,634
2016,2,A,골목상권,1000487,숭문길,1094,609,485
2016,2,A,골목상권,1000486,숭문8길,116,68,48
2016,2,A,골목상권,1000485,성지3길,449,253,196
2016,2,A,골목상권,1000484,성산로4길,1805,1124,681
2016,2,A,골목상권,1000483,성미산로32길,407,187,220
2016,2,A,골목상권,1000482,성미산로1길,671,493,178
2016,2,A,골목상권,1000481,성미산로11길,987,669,318
2016,2,A,골목상권,1000480,백범로16길,549,300,249
2016,2,A,골목상권,1000479,방울내로9안길,298,170,128
2016,2,A,골목상권,1000478,모래내로7길,240,127,113
2016,2,A,골목상권,1000477,매봉산로2길,2147,1477,670
2016,2,A,골목상권,1000476,망원로2길,156,90,66
2016,2,A,골목상권,1000475,망원로11길,992,537,455
2016,2,A,골목상권,1000474,만리재옛길,1550,645,905
2016,2,A,골목상권,1000473,마포대로4길,153,89,64
2016,2,A,골목상권,1000472,마포대로20길,1147,594,553
2016,2,A,골목상권,1000471,마포대로12길,62,35,27
2016,2,A,골목상권,1000470,동교로38길,241,106,135
2016,2,A,골목상권,1000469,동교로27길,3478,1557,1921
2016,2,A,골목상권,1000468,동교로25길,474,217,257
2016,2,A,골목상권,1000467,동교로19길,4637,2937,1700
2016,2,A,골목상권,1000466,동교로17길,794,410,384
2016,2,A,골목상권,1000465,독막로8길,318,148,170
2016,2,A,골목상권,1000464,독막로32길,462,188,274
2016,2,A,골목상권,1000463,독막로22길,76,39,37
2016,2,A,골목상권,1000462,도화길,1008,506,502
2016,2,A,골목상권,1000461,도화4길,374,116,258
2016,2,A,골목상권,1000460,대흥로28길,56,45,11
2016,2,A,골목상권,1000459,대흥로21길,491,100,391
2016,2,A,골목상권,1000458,광성로6길,110,70,40
2016,2,A,골목상권,1000457,홍제내길,110,62,48
2016,2,A,골목상권,1000456,홍연길,93,54,39
2016,2,A,골목상권,1000455,통일로39길,10,9,1
2016,2,A,골목상권,1000454,통일로37길,362,138,224
2016,2,A,골목상권,1000453,통일로11길,13,11,2
2016,2,A,골목상권,1000452,충정로6길,15682,8745,6937
2016,2,A,골목상권,1000451,충정로4길,3034,2041,993
2016,2,A,골목상권,1000450,증가로6길,200,71,129
2016,2,A,골목상권,1000449,증가로23나길,467,231,236
2016,2,A,골목상권,1000448,증가로20가길,265,99,166
2016,2,A,골목상권,1000447,증가로10길,168,92,76
2016,2,A,골목상권,1000446,응암로1길,353,246,107
2016,2,A,골목상권,1000445,연희로10길,89,60,29
2016,2,A,골목상권,1000444,신촌로37길,146,63,83
2016,2,A,골목상권,1000443,수색로8길,2424,2315,109
2016,2,A,골목상권,1000442,세무서길,333,122,211
2016,2,A,골목상권,1000440,세검정로1길,294,162,132
2016,2,A,골목상권,1000439,북아현로4길,431,110,321
2016,2,A,골목상권,1000438,모래내로15길,93,25,68
2016,2,A,골목상권,1000437,명지대길,354,236,118
2016,2,A,골목상권,1000436,독립문로8길,803,305,498
2016,2,A,골목상권,1000435,가재울로6길,8,6,2
2016,2,A,골목상권,1000434,통일로92길,80,37,43
2016,2,A,골목상권,1000433,통일로87길,230,107,123
2016,2,A,골목상권,1000432,통일로78길,216,62,154
2016,2,A,골목상권,1000430,진흥로1길,480,134,346
2016,2,A,골목상권,1000429,진흥로12길,464,192,272
2016,2,A,골목상권,1000428,증산서길,555,289,266
2016,2,A,골목상권,1000427,증산로9길,106,36,70
2016,2,A,골목상권,1000426,증산로5길,756,395,361
2016,2,A,골목상권,1000425,증산로21길,264,171,93
2016,2,A,골목상권,1000424,증산로17길,786,417,369
2016,2,A,골목상권,1000423,증산로15길,195,78,117
2016,2,A,골목상권,1000422,증산로13길,74,39,35
2016,2,A,골목상권,1000421,응암로34길,72,47,25
2016,2,A,골목상권,1000420,응암로22길,152,52,100
2016,2,A,골목상권,1000419,응암로14길,372,120,252
2016,2,A,골목상권,1000418,응암로13길,289,121,168
2016,2,A,골목상권,1000417,응암로12길,212,98,114
2016,2,A,골목상권,1000416,은평로8길,275,137,138
2016,2,A,골목상권,1000415,은평로3길,285,80,205
2016,2,A,골목상권,1000414,은평로20길,23,9,14
2016,2,A,골목상권,1000413,은평로13길,513,332,181
2016,2,A,골목상권,1000412,은평로10길,322,194,128
2016,2,A,골목상권,1000411,연서로5길,58,21,37
2016,2,A,골목상권,1000410,연서로41길,241,76,165
2016,2,A,골목상권,1000409,연서로3길,110,39,71
2016,2,A,골목상권,1000408,연서로34길,131,36,95
2016,2,A,골목상권,1000407,연서로33길,26,9,17
2016,2,A,골목상권,1000406,연서로29길,333,127,206
2016,2,A,골목상권,1000405,연서로28길,736,330,406
2016,2,A,골목상권,1000404,연서로27길,64,30,34
2016,2,A,골목상권,1000403,연서로21길,298,189,109
2016,2,A,골목상권,1000402,연서로17길,1070,327,743
2016,2,A,골목상권,1000401,연서로16길,283,107,176
2016,2,A,골목상권,1000400,연서로13길,695,223,472
2016,2,A,골목상권,1000399,연서로11길,239,115,124
2016,2,A,골목상권,1000398,역말로9길,21,16,5
2016,2,A,골목상권,1000397,수색로18길,24,11,13
2016,2,A,골목상권,1000396,서오릉로8길,16,1,15
2016,2,A,골목상권,1000395,서오릉로21길,467,142,325
2016,2,A,골목상권,1000394,불광천길,160,75,85
2016,2,A,골목상권,1000393,갈현로7길,969,266,703
2016,2,A,골목상권,1000392,갈현로41길,79,29,50
2016,2,A,골목상권,1000391,갈현로33길,32,8,24
2016,2,A,골목상권,1000390,갈현로1길,140,60,80
2016,2,A,골목상권,1000389,가좌로7길,47,21,26
2016,2,A,골목상권,1000388,한글비석로44길,459,250,209
2016,2,A,골목상권,1000387,한글비석로24길,395,156,239
2016,2,A,골목상권,1000386,한글비석로22길,773,318,455
2016,2,A,골목상권,1000385,석계로1길,107,67,40
2016,2,A,골목상권,1000384,상계로9가길,367,115,252
2016,2,A,골목상권,1000382,상계로12길,17,10,7
2016,2,A,골목상권,1000381,동일로242길,403,282,121
2016,2,A,골목상권,1000380,동일로192길,464,198,266
2016,2,A,골목상권,1000379,동일로173가길,2426,1343,1083
2016,2,A,골목상권,1000378,공릉로58길,104,45,59
2016,2,A,골목상권,1000377,해등로16길,78,60,18
2016,2,A,골목상권,1000376,우이천로4다길,193,109,84
2016,2,A,골목상권,1000375,우이천로32길,113,62,51
2016,2,A,골목상권,1000374,시루봉로23길,42,18,24
2016,2,A,골목상권,1000373,삼양로144길,67,47,20
2016,2,A,골목상권,1000372,방학로6가길,222,137,85
2016,2,A,골목상권,1000371,방학로5길,118,72,46
2016,2,A,골목상권,1000370,방학로15길,348,228,120
2016,2,A,골목상권,1000369,방학로10길,126,47,79
2016,2,A,골목상권,1000367,도봉산4길,328,285,43
2016,2,A,골목상권,1000366,도봉로181길,217,99,118
2016,2,A,골목상권,1000365,도봉로169나길,275,116,159
2016,2,A,골목상권,1000364,도봉로156길,261,133,128
2016,2,A,골목상권,1000363,도봉로152가길,426,384,42
2016,2,A,골목상권,1000362,도봉로147길,594,339,255
2016,2,A,골목상권,1000360,도봉로114길,471,163,308
2016,2,A,골목상권,1000359,도봉로109길,21,7,14
2016,2,A,골목상권,1000358,도당로29길,888,521,367
2016,2,A,골목상권,1000357,도당로19길,187,82,105
2016,2,A,골목상권,1000356,도당로13바길,203,81,122
2016,2,A,골목상권,1000355,도당로13가길,162,65,97
2016,2,A,골목상권,1000354,덕릉로60길,65,36,29
2016,2,A,골목상권,1000353,노해로63다길,593,251,342
2016,2,A,골목상권,1000352,노해로60길,309,123,186
2016,2,A,골목상권,1000351,한천로140길,91,46,45
2016,2,A,골목상권,1000350,한천로139가길,39,21,18
2016,2,A,골목상권,1000349,한천로132길,335,131,204
2016,2,A,골목상권,1000348,한천로130길,286,133,153
2016,2,A,골목상권,1000347,한천로124나길,87,41,46
2016,2,A,골목상권,1000346,한천로109길,624,282,342
2016,2,A,골목상권,1000345,인수봉로79길,178,44,134
2016,2,A,골목상권,1000344,인수봉로72길,86,41,45
2016,2,A,골목상권,1000343,인수봉로56길,10,1,9
2016,2,A,골목상권,1000342,오패산로67길,591,300,291
2016,2,A,골목상권,1000341,오패산로52길,91,27,64
2016,2,A,골목상권,1000339,수유로12길,303,208,95
2016,2,A,골목상권,1000338,솔샘로65길,519,228,291
2016,2,A,골목상권,1000337,솔매로50길,687,273,414
2016,2,A,골목상권,1000336,솔매로45길,202,90,112
2016,2,A,골목상권,1000335,솔매로41길,80,22,58
2016,2,A,골목상권,1000334,삼양로93길,16,4,12
2016,2,A,골목상권,1000333,삼양로77길,401,139,262
2016,2,A,골목상권,1000332,삼양로54길,7,4,3
2016,2,A,골목상권,1000331,삼양로41길,355,172,183
2016,2,A,골목상권,1000329,삼양로24길,83,36,47
2016,2,A,골목상권,1000328,삼양로20길,131,48,83
2016,2,A,골목상권,1000327,삼각산로28길,730,401,329
2016,2,A,골목상권,1000326,도봉로99길,165,85,80
2016,2,A,골목상권,1000325,도봉로8길,267,186,81
2016,2,A,골목상권,1000324,도봉로76길,389,211,178
2016,2,A,골목상권,1000323,도봉로67길,5,3,2
2016,2,A,골목상권,1000322,도봉로45길,118,72,46
2016,2,A,골목상권,1000321,도봉로18길,357,169,188
2016,2,A,골목상권,1000320,도봉로13길,27,9,18
2016,2,A,골목상권,1000319,덕릉로41길,740,599,141
2016,2,A,골목상권,1000318,덕릉로40길,892,692,200
2016,2,A,골목상권,1000317,노해로33길,31,12,19
2016,2,A,골목상권,1000315,노해로17길,255,82,173
2016,2,A,골목상권,1000314,화랑로40길,161,85,76
2016,2,A,골목상권,1000313,화랑로32길,440,314,126
2016,2,A,골목상권,1000312,화랑로1길,180,103,77
2016,2,A,골목상권,1000311,화랑로19길,476,251,225
2016,2,A,골목상권,1000310,화랑로14길,56,25,31
2016,2,A,골목상권,1000309,화랑로13길,84,41,43
2016,2,A,골목상권,1000308,한천로76길,139,82,57
2016,2,A,골목상권,1000307,한천로101가길,49,31,18
2016,2,A,골목상권,1000306,창경궁로43길,25,13,12
2016,2,A,골목상권,1000305,지봉로20길,98,61,37
2016,2,A,골목상권,1000304,종암로5길,118,85,33
2016,2,A,골목상권,1000303,종암로24가길,270,136,134
2016,2,A,골목상권,1000302,종암로21길,143,60,83
2016,2,A,골목상권,1000301,종암로19길,385,114,271
2016,2,A,골목상권,1000300,종암로16길,81,36,45
2016,2,A,골목상권,1000299,정릉로8길,194,106,88
2016,2,A,골목상권,1000298,정릉로27길,232,107,125
2016,2,A,골목상권,1000296,장위로50길,934,527,407
2016,2,A,골목상권,1000295,장월로1길,442,192,250
2016,2,A,골목상권,1000294,인촌로6길,2404,1232,1172
2016,2,A,골목상권,1000293,인촌로5길,27,4,23
2016,2,A,골목상권,1000292,인촌로24길,190,124,66
2016,2,A,골목상권,1000291,개운사길,3203,1989,1214
2016,2,A,골목상권,1000290,인촌로1길,143,101,42
2016,2,A,골목상권,1000289,인촌로17가길,3096,1161,1935
2016,2,A,골목상권,1000288,오패산로4길,601,194,407
2016,2,A,골목상권,1000287,오패산로3길,1138,656,482
2016,2,A,골목상권,1000286,오패산로19길,44,17,27
2016,2,A,골목상권,1000285,안암로5길,596,357,239
2016,2,A,골목상권,1000284,아리랑로4길,624,224,400
2016,2,A,골목상권,1000283,솔샘로6길,158,74,84
2016,2,A,골목상권,1000282,성북로8길,49,25,24
2016,2,A,골목상권,1000281,삼양로8길,87,46,41
2016,2,A,골목상권,1000280,삼선교로16가길,686,397,289
2016,2,A,골목상권,1000279,삼선교로10다길,116,48,68
2016,2,A,골목상권,1000278,삼선교로10길,225,101,124
2016,2,A,골목상권,1000277,보문로32길,949,387,562
2016,2,A,골목상권,1000276,보문로31길,745,324,421
2016,2,A,골목상권,1000274,보문로13길,780,461,319
2016,2,A,골목상권,1000273,보국문로16길,296,194,102
2016,2,A,골목상권,1000270,동소문로26가길,301,165,136
2016,2,A,골목상권,1000269,동소문로15길,62,35,27
2016,2,A,골목상권,1000268,동소문로13길,545,280,265
2016,2,A,골목상권,1000267,돌곶이로8길,236,104,132
2016,2,A,골목상권,1000266,돌곶이로41길,45,22,23
2016,2,A,골목상권,1000265,돌곶이로28길,163,96,67
2016,2,A,골목상권,1000264,돌곶이로27길,61,32,29
2016,2,A,골목상권,1000263,돌곶이로22길,97,48,49
2016,2,A,골목상권,1000261,길음로7길,10,7,3
2016,2,A,골목상권,1000260,중랑천로10길,777,406,371
2016,2,A,골목상권,1000259,용마산로94길,441,265,176
2016,2,A,골목상권,1000258,용마산로118길,567,275,292
2016,2,A,골목상권,1000257,용마산로112길,280,130,150
2016,2,A,골목상권,1000256,용마산로100길,454,312,142
2016,2,A,골목상권,1000255,신내로7가길,274,80,194
2016,2,A,골목상권,1000254,사가정로54길,107,36,71
2016,2,A,골목상권,1000253,사가정로42길,62,23,39
2016,2,A,골목상권,1000252,봉화산로56길,587,171,416
2016,2,A,골목상권,1000251,봉화산로4길,397,141,256
2016,2,A,골목상권,1000250,봉화산로30길,389,243,146
2016,2,A,골목상권,1000249,봉우재로33길,94,41,53
2016,2,A,골목상권,1000248,면목로78길,302,167,135
2016,2,A,골목상권,1000247,면목로56길,225,167,58
2016,2,A,골목상권,1000246,면목로55길,434,128,306
2016,2,A,골목상권,1000245,면목로49길,540,171,369
2016,2,A,골목상권,1000244,면목로48길,117,58,59
2016,2,A,골목상권,1000243,면목로45길,71,32,39
2016,2,A,골목상권,1000242,면목로33길,377,141,236
2016,2,A,골목상권,1000241,면목로21길,33,24,9
2016,2,A,골목상권,1000240,망우로73길,9,4,5
2016,2,A,골목상권,1000239,망우로68길,77,32,45
2016,2,A,골목상권,1000238,동일로163길,107,68,39
2016,2,A,골목상권,1000237,동일로157길,200,98,102
2016,2,A,골목상권,1000236,동일로149길,1134,830,304
2016,2,A,골목상권,1000235,동일로140길,225,93,132
2016,2,A,골목상권,1000234,동일로139길,62,36,26
2016,2,A,골목상권,1000233,동일로139가길,1169,690,479
2016,2,A,골목상권,1000232,동일로130길,97,22,75
2016,2,A,골목상권,1000231,동일로123길,162,83,79
2016,2,A,골목상권,1000230,동일로112길,171,81,90
2016,2,A,골목상권,1000229,동일로101길,300,118,182
2016,2,A,골목상권,1000228,동일로100길,31,14,17
2016,2,A,골목상권,1000227,답십리로75길,93,53,40
2016,2,A,골목상권,1000226,공릉로2길,637,303,334
2016,2,A,골목상권,1000225,공릉로12가길,47,32,15
2016,2,A,골목상권,1000224,겸재로54길,108,55,53
2016,2,A,골목상권,1000223,겸재로36길,232,193,39
2016,2,A,골목상권,1000222,겸재로29길,451,193,258
2016,2,A,골목상권,1000221,휘경로3길,236,116,120
2016,2,A,골목상권,1000220,휘경로2길,6,2,4
2016,2,A,골목상권,1000219,휘경로23길,16,0,16
2016,2,A,골목상권,1000218,휘경로14길,105,46,59
2016,2,A,골목상권,1000217,한천로46길,397,129,268
2016,2,A,골목상권,1000216,한천로40길,327,175,152
2016,2,A,골목상권,1000215,한천로33길,75,30,45
2016,2,A,골목상권,1000214,한천로14길,648,393,255
2016,2,A,골목상권,1000213,천호대로97길,338,216,122
2016,2,A,골목상권,1000212,천호대로77길,2018,1030,988
2016,2,A,골목상권,1000211,천호대로45길,163,102,61
2016,2,A,골목상권,1000210,천호대로17길,2136,1376,760
2016,2,A,골목상권,1000209,천호대로12길,837,565,272
2016,2,A,골목상권,1000208,천장산로7길,1419,882,537
2016,2,A,골목상권,1000207,제기로5길,192,105,87
2016,2,A,골목상권,1000206,제기로21길,212,140,72
2016,2,A,골목상권,1000205,전농로4길,681,431,250
2016,2,A,골목상권,1000204,전농로3길,106,50,56
2016,2,A,골목상권,1000203,전농로29길,319,155,164
2016,2,A,골목상권,1000202,장한로8길,818,498,320
2016,2,A,골목상권,1000201,장한로5길,2892,2019,873
2016,2,A,골목상권,1000200,장한로27길,162,49,113
2016,2,A,골목상권,1000199,장한로27가길,413,192,221
2016,2,A,골목상권,1000198,장한로26길,576,282,294
2016,2,A,골목상권,1000197,장한로26가길,387,155,232
2016,2,A,골목상권,1000196,장한로25길,1040,457,583
2016,2,A,골목상권,1000195,장한로14길,188,161,27
2016,2,A,골목상권,1000194,이문로42길,241,96,145
2016,2,A,골목상권,1000193,왕산로43길,965,477,488
2016,2,A,골목상권,1000192,왕산로33길,164,112,52
2016,2,A,골목상권,1000191,왕산로32길,12,8,4
2016,2,A,골목상권,1000190,약령시로17길,265,132,133
2016,2,A,골목상권,1000189,서울시립대로4길,656,340,316
2016,2,A,골목상권,1000188,서울시립대로29길,246,144,102
2016,2,A,골목상권,1000187,서울시립대로16길,145,29,116
2016,2,A,골목상권,1000186,사가정로2길,81,61,20
2016,2,A,골목상권,1000185,사가정로23가길,117,69,48
2016,2,A,골목상권,1000184,사가정로13길,280,91,189
2016,2,A,골목상권,1000183,무학로45길,371,213,158
2016,2,A,골목상권,1000182,무학로16길,1120,1004,116
2016,2,A,골목상권,1000181,망우로21길,190,106,84
2016,2,A,골목상권,1000180,망우로18길,512,199,313
2016,2,A,골목상권,1000179,망우로18가길,59,22,37
2016,2,A,골목상권,1000178,답십리로72길,14,12,2
2016,2,A,골목상권,1000177,답십리로69길,871,392,479
2016,2,A,골목상권,1000176,답십리로68길,157,101,56
2016,2,A,골목상권,1000175,답십리로64길,349,204,145
2016,2,A,골목상권,1000174,답십리로63길,112,70,42
2016,2,A,골목상권,1000173,답십리로60길,15,9,6
2016,2,A,골목상권,1000172,답십리로56길,5,4,1
2016,2,A,골목상권,1000171,답십리로23길,7,6,1
2016,2,A,골목상권,1000170,난계로30길,171,120,51
2016,2,A,골목상권,1000168,경희대로3길,267,168,99
2016,2,A,골목상권,1000167,천호대로129길,437,157,280
2016,2,A,골목상권,1000166,천호대로123길,311,120,191
2016,2,A,골목상권,1000165,천호대로109길,1067,562,505
2016,2,A,골목상권,1000164,자양번영로3길,91,39,52
2016,2,A,골목상권,1000162,자양로50길,19,5,14
2016,2,A,골목상권,1000161,자양로45길,549,298,251
2016,2,A,골목상권,1000160,자양로26길,312,94,218
2016,2,A,골목상권,1000159,자양로15길,355,241,114
2016,2,A,골목상권,1000158,자양로11길,1325,664,661
2016,2,A,골목상권,1000157,용마산로3길,830,463,367
2016,2,A,골목상권,1000156,용마산로21길,141,58,83
2016,2,A,골목상권,1000155,아차산로78길,2677,1460,1217
2016,2,A,골목상권,1000154,아차산로65길,717,466,251
2016,2,A,골목상권,1000153,아차산로55길,411,205,206
2016,2,A,골목상권,1000152,아차산로51길,270,156,114
2016,2,A,골목상권,1000151,아차산로40길,495,289,206
2016,2,A,골목상권,1000150,면목로17길,235,156,79
2016,2,A,골목상권,1000149,뚝섬로64길,304,156,148
2016,2,A,골목상권,1000148,뚝섬로58길,189,68,121
2016,2,A,골목상권,1000147,뚝섬로54길,270,202,68
2016,2,A,골목상권,1000146,뚝섬로48길,811,341,470
2016,2,A,골목상권,1000145,뚝섬로24길,100,37,63
2016,2,A,골목상권,1000144,뚝섬로23길,102,65,37
2016,2,A,골목상권,1000143,동일로24길,8,4,4
2016,2,A,골목상권,1000142,동일로18길,177,71,106
2016,2,A,골목상권,1000141,능동로4길,249,115,134
2016,2,A,골목상권,1000140,능동로3길,246,101,145
2016,2,A,골목상권,1000139,능동로34길,936,518,418
2016,2,A,골목상권,1000138,능동로19길,345,220,125
2016,2,A,골목상권,1000137,능동로13길,334,106,228
2016,2,A,골목상권,1000136,긴고랑로9길,62,29,33
2016,2,A,골목상권,1000135,긴고랑로8길,233,210,23
2016,2,A,골목상권,1000134,긴고랑로7길,542,260,282
2016,2,A,골목상권,1000133,긴고랑로20길,541,248,293
2016,2,A,골목상권,1000132,광나루로52길,1717,850,867
2016,2,A,골목상권,1000131,광나루로40길,97,49,48
2016,2,A,골목상권,1000130,광나루로37길,271,155,116
2016,2,A,골목상권,1000129,광나루로36길,37,26,11
2016,2,A,골목상권,1000128,광나루로24길,67,34,33
2016,2,A,골목상권,1000127,광나루로12길,958,532,426
2016,2,A,골목상권,1000126,한림말길,65,39,26
2016,2,A,골목상권,1000124,청계천로10나길,1805,1076,729
2016,2,A,골목상권,1000123,장터길,44,17,27
2016,2,A,골목상권,1000122,용답중앙길,96,57,39
2016,2,A,골목상권,1000121,용답29길,1913,985,928
2016,2,A,골목상권,1000120,왕십리로6길,1293,709,584
2016,2,A,골목상권,1000119,왕십리로31길,108,52,56
2016,2,A,골목상권,1000118,왕십리로26길,4178,2349,1829
2016,2,A,골목상권,1000117,왕십리로21길,163,53,110
2016,2,A,골목상권,1000116,왕십리로14길,2536,1936,600
2016,2,A,골목상권,1000115,아차산로5길,2220,1513,707
2016,2,A,골목상권,1000114,아차산로15길,3980,2863,1117
2016,2,A,골목상권,1000113,아차산로11길,3339,2207,1132
2016,2,A,골목상권,1000112,송정4가길,1037,481,556
2016,2,A,골목상권,1000111,송정12라길,272,182,90
2016,2,A,골목상권,1000110,성수일로6길,3034,1722,1312
2016,2,A,골목상권,1000109,성수이로7길,378,249,129
2016,2,A,골목상권,1000108,성수이로18길,2216,1566,650
2016,2,A,골목상권,1000107,성덕정길,612,380,232
2016,2,A,골목상권,1000106,성덕정17길,230,122,108
2016,2,A,골목상권,1000105,서울숲2길,1331,757,574
2016,2,A,골목상권,1000104,상원길,1736,1181,555
2016,2,A,골목상권,1000103,상원12길,181,106,75
2016,2,A,골목상권,1000102,사근동길,31,17,14
2016,2,A,골목상권,1000101,무학봉길,3,3,0
2016,2,A,골목상권,1000100,무학봉28길,165,77,88
2016,2,A,골목상권,1000099,무학로6길,367,217,150
2016,2,A,골목상권,1000098,무수막길,113,48,65
2016,2,A,골목상권,1000097,매봉길,22,14,8
2016,2,A,골목상권,1000096,마조로1길,198,74,124
2016,2,A,골목상권,1000095,마조로16길,782,545,237
2016,2,A,골목상권,1000094,마장로39길,145,60,85
2016,2,A,골목상권,1000093,마장로27길,99,37,62
2016,2,A,골목상권,1000091,둘레9길,411,239,172
2016,2,A,골목상권,1000090,금호산길,393,145,248
2016,2,A,골목상권,1000089,금호산2길,38,18,20
2016,2,A,골목상권,1000088,고산자로6길,14987,6213,8774
2016,2,A,골목상권,1000087,후암로28길,189,77,112
2016,2,A,골목상권,1000086,효창원로39길,54,36,18
2016,2,A,골목상권,1000085,회나무로13길,56,35,21
2016,2,A,골목상권,1000084,한남대로20길,687,385,302
2016,2,A,골목상권,1000082,한강대로7길,585,405,180
2016,2,A,골목상권,1000081,한강대로62길,624,419,205
2016,2,A,골목상권,1000080,한강대로52길,1177,761,416
2016,2,A,골목상권,1000079,한강대로43길,4653,2995,1658
2016,2,A,골목상권,1000078,한강대로15길,1889,381,1508
2016,2,A,골목상권,1000077,한강대로104길,4222,3010,1212
2016,2,A,골목상권,1000076,청파로73길,1310,743,567
2016,2,A,골목상권,1000075,청파로71길,218,112,106
2016,2,A,골목상권,1000074,청파로47나길,119,79,40
2016,2,A,골목상권,1000073,청파로47길,820,379,441
2016,2,A,골목상권,1000072,장문로45길,77,10,67
2016,2,A,골목상권,1000071,이태원로54길,2167,1070,1097
2016,2,A,골목상권,1000070,이태원로27길,530,297,233
2016,2,A,골목상권,1000069,이촌로22길,213,131,82
2016,2,A,골목상권,1000068,원효로89길,941,755,186
2016,2,A,골목상권,1000067,원효로53길,750,451,299
2016,2,A,골목상권,1000066,원효로41길,2387,1688,699
2016,2,A,골목상권,1000065,원효로19길,961,686,275
2016,2,A,골목상권,1000064,우사단로4길,168,121,47
2016,2,A,골목상권,1000063,우사단로14길,1640,877,763
2016,2,A,골목상권,1000062,우사단로10길,56,30,26
2016,2,A,골목상권,1000061,신흥로20길,196,94,102
2016,2,A,골목상권,1000060,소월로20길,128,40,88
2016,2,A,골목상권,1000059,서빙고로71길,448,261,187
2016,2,A,골목상권,1000058,백범로90길,307,179,128
2016,2,A,골목상권,1000057,백범로79길,1079,663,416
2016,2,A,골목상권,1000056,두텁바위로1길,2562,1438,1124
2016,2,A,골목상권,1000055,대사관로34길,325,181,144
2016,2,A,골목상권,1000054,녹사평대로46길,47,36,11
2016,2,A,골목상권,1000053,녹사평대로40나길,54,33,21
2016,2,A,골목상권,1000052,녹사평대로32길,291,149,142
2016,2,A,골목상권,1000051,녹사평대로26길,2105,1184,921
2016,2,A,골목상권,1000050,녹사평대로11길,294,196,98
2016,2,A,골목상권,1000049,퇴계로90길,473,193,280
2016,2,A,골목상권,1000048,퇴계로8길,2543,1350,1193
2016,2,A,골목상권,1000047,퇴계로56길,1022,814,208
2016,2,A,골목상권,1000046,퇴계로46길,1953,811,1142
2016,2,A,골목상권,1000045,퇴계로18길,2885,1316,1569
2016,2,A,골목상권,1000044,퇴계로12길,975,436,539
2016,2,A,골목상권,1000043,청구로1길,203,98,105
2016,2,A,골목상권,1000042,청구로17길,1677,780,897
2016,2,A,골목상권,1000041,장충단로8길,3984,1228,2756
2016,2,A,골목상권,1000040,삼일대로4길,959,574,385
2016,2,A,골목상권,1000039,명동길,36879,18411,18468
2016,2,A,골목상권,1000037,동호로20길,981,491,490
2016,2,A,골목상권,1000036,동호로15길,4133,2223,1910
2016,2,A,골목상권,1000035,동호로11길,20,16,4
2016,2,A,골목상권,1000034,동호로10길,1446,646,800
2016,2,A,골목상권,1000033,다산로39길,1166,667,499
2016,2,A,골목상권,1000032,다산로38길,1480,755,725
2016,2,A,골목상권,1000031,다산로36길,53,31,22
2016,2,A,골목상권,1000030,다산로33길,384,198,186
2016,2,A,골목상권,1000029,난계로21길,219,147,72
2016,2,A,골목상권,1000028,난계로11길,1884,1070,814
2016,2,A,골목상권,1000027,필운대로1길,5,1,4
2016,2,A,골목상권,1000026,평창길,157,68,89
2016,2,A,골목상권,1000025,통일로12길,241,107,134
2016,2,A,골목상권,1000024,창신길,246,63,183
2016,2,A,골목상권,1000023,창신5길,6,3,3
2016,2,A,골목상권,1000022,창신2길,52,30,22
2016,2,A,골목상권,1000021,창경궁로35길,1426,410,1016
2016,2,A,골목상권,1000020,지봉로8길,155,83,72
2016,2,A,골목상권,1000019,종로65길,628,281,347
2016,2,A,골목상권,1000016,자하문로7길,495,283,212
2016,2,A,골목상권,1000015,이화장길,1863,908,955
2016,2,A,골목상권,1000014,율곡로16길,11,7,4
2016,2,A,골목상권,1000013,율곡로10길,2334,1735,599
2016,2,A,골목상권,1000012,옥인길,490,209,281
2016,2,A,골목상권,1000011,숭인동길,19,8,11
2016,2,A,골목상권,1000010,성균관로5길,132,73,59
2016,2,A,골목상권,1000009,삼청로5길,436,164,272
2016,2,A,골목상권,1000008,북촌로5나길,1569,1093,476
2016,2,A,골목상권,1000007,북촌로5길,50,24,26
2016,2,A,골목상권,1000006,북촌로11길,19,11,8
2016,2,A,골목상권,1000005,백석동길,119,60,59
2016,2,A,골목상권,1000004,명륜길,16,10,6
2016,2,A,골목상권,1000003,돈화문로11가길,1074,566,508
2016,2,A,골목상권,1000001,계동길,844,375,469
2016,1,U,관광특구,1001496,강남 마이스 관광특구,20413,11662,8751
2016,1,U,관광특구,1001495,잠실 관광특구,26362,15696,10666
2016,1,U,관광특구,1001494,종로?청계 관광특구,30380,18859,11521
2016,1,U,관광특구,1001493,동대문패션타운 관광특구,13572,9051,4521
2016,1,U,관광특구,1001492,명동 남대문 북창동 다동 무교동 관광특구,168354,84603,83751
2016,1,U,관광특구,1001491,이태원 관광특구,5551,3173,2378
2016,1,R,전통시장,1001490,길동복조리시장,564,343,221
2016,1,R,전통시장,1001489,둔촌역전통시장,147,73,74
2016,1,R,전통시장,1001488,성내골목시장,7,2,5
2016,1,R,전통시장,1001487,천호시장,18,10,8
2016,1,R,전통시장,1001483,암사종합시장,710,321,389
2016,1,R,전통시장,1001482,고덕전통시장,396,381,15
2016,1,R,전통시장,1001481,명일골목시장,400,118,282
2016,1,R,전통시장,1001480,새마을시장,311,169,142
2016,1,R,전통시장,1001479,석촌시장,175,110,65
2016,1,R,전통시장,1001478,방이시장,656,431,225
2016,1,R,전통시장,1001477,마천시장,240,54,186
2016,1,R,전통시장,1001476,풍납시장,14,4,10
2016,1,R,전통시장,1001475,강남개포시장,34,29,5
2016,1,R,전통시장,1001474,도곡시장,502,219,283
2016,1,R,전통시장,1001471,영동전통시장,3159,2351,808
2016,1,R,전통시장,1001466,미성동도깨비시장,413,180,233
2016,1,R,전통시장,1001464,삼성동시장,57,27,30
2016,1,R,전통시장,1001463,신림중앙시장,18,10,8
2016,1,R,전통시장,1001462,강남골목시장,246,134,112
2016,1,R,전통시장,1001460,관악신사시장,341,266,75
2016,1,R,전통시장,1001459,신원시장,341,144,197
2016,1,R,전통시장,1001458,인헌시장,232,78,154
2016,1,R,전통시장,1001456,봉천현대시장,15,6,9
2016,1,R,전통시장,1001454,봉천제일종합시장,45,24,21
2016,1,R,전통시장,1001453,낙성대시장,18,11,7
2016,1,R,전통시장,1001452,중부시장,153,52,101
2016,1,R,전통시장,1001450,남성역골목시장,496,238,258
2016,1,R,전통시장,1001449,남성사계시장,1905,885,1020
2016,1,R,전통시장,1001448,흑석시장,174,67,107
2016,1,R,전통시장,1001447,상도4동도깨비골목시장,328,89,239
2016,1,R,전통시장,1001445,영도시장,87,37,50
2016,1,R,전통시장,1001441,본동인정시장,111,52,59
2016,1,R,전통시장,1001439,대림중앙시장,26,18,8
2016,1,R,전통시장,1001438,우리시장,15,5,10
2016,1,R,전통시장,1001437,영진시장A동,37,33,4
2016,1,R,전통시장,1001433,영일시장,2,2,0
2016,1,R,전통시장,1001431,영등포청과시장,137,83,54
2016,1,R,전통시장,1001430,영등포전통시장,4051,2015,2036
2016,1,R,전통시장,1001429,은행나무시장,43,10,33
2016,1,R,전통시장,1001427,현대시장,59,17,42
2016,1,R,전통시장,1001424,남문시장,312,120,192
2016,1,R,전통시장,1001423,독산동 우시장,140,58,82
2016,1,R,전통시장,1001421,개봉중앙시장,7,3,4
2016,1,R,전통시장,1001419,가리봉시장,16,9,7
2016,1,R,전통시장,1001418,남구로시장,5,2,3
2016,1,R,전통시장,1001417,구로시장,46,19,27
2016,1,R,전통시장,1001415,방신전통시장,137,116,21
2016,1,R,전통시장,1001414,송화골목시장,485,180,305
2016,1,R,전통시장,1001413,까치산시장,28,18,10
2016,1,R,전통시장,1001411,남부골목시장,174,78,96
2016,1,R,전통시장,1001409,화곡중앙골목시장,2,2,0
2016,1,R,전통시장,1001407,등마루시장,728,448,280
2016,1,R,전통시장,1001406,신정3동골목시장,248,106,142
2016,1,R,전통시장,1001405,신정2동골목시장,8,6,2
2016,1,R,전통시장,1001402,신월6동골목시장,266,120,146
2016,1,R,전통시장,1001401,신곡종합시장,13,10,3
2016,1,R,전통시장,1001400,신월3동골목시장,55,15,40
2016,1,R,전통시장,1001399,경창시장,190,81,109
2016,1,R,전통시장,1001398,월정로시장,104,57,47
2016,1,R,전통시장,1001397,신영시장,49,25,24
2016,1,R,전통시장,1001396,목4동시장,250,88,162
2016,1,R,전통시장,1001395,목3동시장,700,346,354
2016,1,R,전통시장,1001394,목2동시장,198,98,100
2016,1,R,전통시장,1001393,마포농수산물시장,492,312,180
2016,1,R,전통시장,1001391,망원월드컵시장,17,11,6
2016,1,R,전통시장,1001390,망원시장,33,17,16
2016,1,R,전통시장,1001386,신수시장,123,99,24
2016,1,R,전통시장,1001385,아현시장,21,3,18
2016,1,R,전통시장,1001374,대림골목시장,299,95,204
2016,1,R,전통시장,1001367,상계중앙시장,27,11,16
2016,1,R,전통시장,1001364,방학동도깨비시장,131,55,76
2016,1,R,전통시장,1001363,쌍문역골목시장,58,26,32
2016,1,R,전통시장,1001361,신도봉시장,26,16,10
2016,1,R,전통시장,1001359,창동신창시장,130,55,75
2016,1,R,전통시장,1001358,수유북부시장,13,3,10
2016,1,R,전통시장,1001357,장미원골목시장,73,51,22
2016,1,R,전통시장,1001356,수유중앙시장,130,71,59
2016,1,R,전통시장,1001355,강북종합시장,60,24,36
2016,1,R,전통시장,1001354,우이시장,148,63,85
2016,1,R,전통시장,1001353,수유전통시장,451,139,312
2016,1,R,전통시장,1001352,번동북부골목시장,88,54,34
2016,1,R,전통시장,1001351,솔샘시장,105,41,64
2016,1,R,전통시장,1001349,방천골목시장,84,28,56
2016,1,R,전통시장,1001347,석관황금시장,52,42,10
2016,1,R,전통시장,1001343,장위전통시장,178,66,112
2016,1,R,전통시장,1001340,정릉시장,35,14,21
2016,1,R,전통시장,1001339,정릉아리랑시장,8,5,3
2016,1,R,전통시장,1001338,돈암제일시장,77,39,38
2016,1,R,전통시장,1001336,우림골목시장,222,105,117
2016,1,R,전통시장,1001335,묵1동도깨비시장,266,111,155
2016,1,R,전통시장,1001334,태능시장,4,3,1
2016,1,R,전통시장,1001333,중화제일시장,23,1,22
2016,1,R,전통시장,1001332,사가정시장,257,191,66
2016,1,R,전통시장,1001330,동원시장,53,22,31
2016,1,R,전통시장,1001329,동부골목시장,83,28,55
2016,1,R,전통시장,1001326,회기시장,120,48,72
2016,1,R,전통시장,1001323,답십리시장,24,7,17
2016,1,R,전통시장,1001321,답십리현대시장,99,72,27
2016,1,R,전통시장,1001319,청량리종합시장,6,4,2
2016,1,R,전통시장,1001317,청량리농수산물시장,15,13,2
2016,1,R,전통시장,1001316,서울약령시장,1359,862,497
2016,1,R,전통시장,1001313,청량리수산시장,196,104,92
2016,1,R,전통시장,1001310,구의시장,99,57,42
2016,1,R,전통시장,1001309,조양시장,75,39,36
2016,1,R,전통시장,1001308,영동교골목시장,26,18,8
2016,1,R,전통시장,1001307,능동로골목시장,292,272,20
2016,1,R,전통시장,1001304,자양골목시장,93,49,44
2016,1,R,전통시장,1001301,중곡제일시장,140,74,66
2016,1,R,전통시장,1001299,한아름시장,114,63,51
2016,1,R,전통시장,1001298,성동용답상가시장,277,143,134
2016,1,R,전통시장,1001297,뚝도시장,31,13,18
2016,1,R,전통시장,1001296,금남시장,22,12,10
2016,1,R,전통시장,1001295,행당시장,219,118,101
2016,1,R,전통시장,1001294,마장축산물시장,1569,1052,517
2016,1,R,전통시장,1001289,용문전통시장,25,14,11
2016,1,R,전통시장,1001286,후암시장,39,16,23
2016,1,R,전통시장,1001285,합동(새벽)시장,2374,1285,1089
2016,1,R,전통시장,1001284,서울중앙시장,227,151,76
2016,1,R,전통시장,1001283,백학시장,445,237,208
2016,1,R,전통시장,1001282,약수시장,1580,599,981
2016,1,R,전통시장,1001281,청평화시장,2653,1742,911
2016,1,R,전통시장,1001280,제일평화시장,454,291,163
2016,1,R,전통시장,1001278,남평화시장,163,106,57
2016,1,R,전통시장,1001277,방산종합시장,1815,1185,630
2016,1,R,전통시장,1001275,인현시장,1202,775,427
2016,1,R,전통시장,1001274,신중부시장,2420,1612,808
2016,1,R,전통시장,1001273,남대문시장,7064,3772,3292
2016,1,R,전통시장,1001271,동묘시장,924,601,323
2016,1,R,전통시장,1001270,창신골목시장,225,123,102
2016,1,R,전통시장,1001268,충신시장,340,202,138
2016,1,R,전통시장,1001267,종로신진시장,31,14,17
2016,1,R,전통시장,1001266,동대문종합시장,240,147,93
2016,1,R,전통시장,1001265,광장시장,213,150,63
2016,1,D,발달상권,1001263,서울 노원구 노원역_3,797,330,467
2016,1,D,발달상권,1001261,서울 노원구 노원역_1,982,310,672
2016,1,D,발달상권,1001260,창동역,2395,1568,827
2016,1,D,발달상권,1001259,서울 강북구 수유역_3,58,30,28
2016,1,D,발달상권,1001257,서울 강북구 수유역_2,4168,2160,2008
2016,1,D,발달상권,1001256,서울 강북구 수유역_1,120,95,25
2016,1,D,발달상권,1001255,서울 은평구 연신내역_3,598,198,400
2016,1,D,발달상권,1001254,서울 은평구 연신내역_2,378,157,221
2016,1,D,발달상권,1001253,서울 은평구 연신내역_1,76,38,38
2016,1,D,발달상권,1001252,서울 성북구 미아삼거리역_2,502,225,277
2016,1,D,발달상권,1001251,서울 강북구 미아삼거리역_1,462,163,299
2016,1,D,발달상권,1001250,서울 은평구 불광역_3,45,13,32
2016,1,D,발달상권,1001249,서울 은평구 불광역_2,71,26,45
2016,1,D,발달상권,1001248,서울 은평구 불광역_1,253,116,137
2016,1,D,발달상권,1001247,미아사거리_2,134,67,67
2016,1,D,발달상권,1001246,미아사거리_1,570,268,302
2016,1,D,발달상권,1001245,서울 성북구 성신여대입구역,4909,3017,1892
2016,1,D,발달상권,1001244,경희대학교,351,157,194
2016,1,D,발달상권,1001243,서울 성북구 안암역,83,50,33
2016,1,D,발달상권,1001242,혜화역 대학로_3,1690,809,881
2016,1,D,발달상권,1001241,혜화역 대학로_2,1393,814,579
2016,1,D,발달상권,1001240,혜화역 대학로_1,1256,631,625
2016,1,D,발달상권,1001239,디지털미디어시티,21515,12932,8583
2016,1,D,발달상권,1001238,서울 동대문구 청량리역,3146,2021,1125
2016,1,D,발달상권,1001236,서울 종로구 안국역_2,755,288,467
2016,1,D,발달상권,1001235,서울 종로구 안국역_1,11904,9790,2114
2016,1,D,발달상권,1001234,서울 종로구 경복궁역_1,231,91,140
2016,1,D,발달상권,1001233,서울 종로구 종로3가역_3,3114,1728,1386
2016,1,D,발달상권,1001232,서울 종로구 종로3가역_2,1812,1014,798
2016,1,D,발달상권,1001231,서울 동대문구 신설동역_2,4296,2180,2116
2016,1,D,발달상권,1001230,인사동,21966,13787,8179
2016,1,D,발달상권,1001229,서울 종로구 종로5가역_4,662,361,301
2016,1,D,발달상권,1001228,서울 종로구 종로5가역_3,5333,3619,1714
2016,1,D,발달상권,1001227,종로구청,14751,8665,6086
2016,1,D,발달상권,1001226,서울 종로구 종로5가역_2,14106,8861,5245
2016,1,D,발달상권,1001225,신설동역,729,448,281
2016,1,D,발달상권,1001224,서울 동대문구 신설동역_1,2,2,0
2016,1,D,발달상권,1001223,서울 종로구 광화문역_2,53651,33301,20350
2016,1,D,발달상권,1001222,동묘앞역,69,43,26
2016,1,D,발달상권,1001221,장안동사거리,552,265,287
2016,1,D,발달상권,1001220,서울 종로구 동대문역_2,1054,577,477
2016,1,D,발달상권,1001218,동대문시장_2,496,323,173
2016,1,D,발달상권,1001217,서울 종로구 종로5가역_1,51,37,14
2016,1,D,발달상권,1001216,서울 종로구 종로3가역_1,3427,1529,1898
2016,1,D,발달상권,1001215,서울 종로구 광화문역_1,2337,1584,753
2016,1,D,발달상권,1001214,종각역,20802,13736,7066
2016,1,D,발달상권,1001213,종각역 젊음의 거리,2020,921,1099
2016,1,D,발달상권,1001212,서대문구 서대문역_1,384,262,122
2016,1,D,발달상권,1001211,동대문시장_1,428,238,190
2016,1,D,발달상권,1001210,시청역_2,23527,14744,8783
2016,1,D,발달상권,1001209,서울시청,26181,12363,13818
2016,1,D,발달상권,1001208,서울 중구 을지로3가역_2,8769,5651,3118
2016,1,D,발달상권,1001207,서울 중구 신당역_2,1266,655,611
2016,1,D,발달상권,1001206,서대문구 서대문역_2,1999,1346,653
2016,1,D,발달상권,1001205,동대문역사문화공원역,4141,2978,1163
2016,1,D,발달상권,1001204,서울 중구 을지로3가역_1,14260,9716,4544
2016,1,D,발달상권,1001203,명동거리,26062,12172,13890
2016,1,D,발달상권,1001202,롯데백화점,40444,22933,17511
2016,1,D,발달상권,1001201,서울 중구 신당역_1,1100,687,413
2016,1,D,발달상권,1001200,북창동,7518,4748,2770
2016,1,D,발달상권,1001199,서울 중구 충무로역_2,16829,7381,9448
2016,1,D,발달상권,1001198,서울 강서구 송정역,682,482,200
2016,1,D,발달상권,1001197,장한평역_2,12116,9714,2402
2016,1,D,발달상권,1001196,시청역_1,65736,38240,27496
2016,1,D,발달상권,1001195,왕십리역_2,718,322,396
2016,1,D,발달상권,1001194,서울 강서구 발산역,681,417,264
2016,1,D,발달상권,1001193,장한평역_1,2460,1628,832
2016,1,D,발달상권,1001192,서울 중구 충무로역_1,3092,2078,1014
2016,1,D,발달상권,1001190,장한평역,2347,1629,718
2016,1,D,발달상권,1001189,서울 중구 명동역,3485,1809,1676
2016,1,D,발달상권,1001188,장충동 족발거리,204,90,114
2016,1,D,발달상권,1001187,한양시장,253,115,138
2016,1,D,발달상권,1001186,서울 서대문구 이대역,1171,463,708
2016,1,D,발달상권,1001185,서울 서대문구 신촌역,2563,1052,1511
2016,1,D,발달상권,1001184,서울 마포구 홍대입구역_3,722,592,130
2016,1,D,발달상권,1001183,서울 마포구 홍대입구역_2,2801,1132,1669
2016,1,D,발달상권,1001182,홍익대학교 주변,14466,7280,7186
2016,1,D,발달상권,1001181,서울 광진구 군자역,163,101,62
2016,1,D,발달상권,1001180,신촌역,207,108,99
2016,1,D,발달상권,1001179,강서구청,3431,2220,1211
2016,1,D,발달상권,1001178,서울 마포구 홍대입구역_1,720,411,309
2016,1,D,발달상권,1001175,서울 강동구 고덕역,493,286,207
2016,1,D,발달상권,1001173,서울 강동구 명일역,848,324,524
2016,1,D,발달상권,1001172,어린이대공원역,139,94,45
2016,1,D,발달상권,1001171,서울 마포구 공덕역_2,3907,2319,1588
2016,1,D,발달상권,1001170,공덕역,6742,4222,2520
2016,1,D,발달상권,1001169,서울 용산구 숙대입구역,4350,3094,1256
2016,1,D,발달상권,1001168,남영역,14337,6498,7839
2016,1,D,발달상권,1001167,서울 마포구 공덕역_1,4255,2117,2138
2016,1,D,발달상권,1001166,서울 마포구 마포역_2,964,561,403
2016,1,D,발달상권,1001165,서울 광진구 건대입구역_2,2725,988,1737
2016,1,D,발달상권,1001164,서울 마포구 마포역_1,10554,6415,4139
2016,1,D,발달상권,1001163,서울 강동구 천호역_2,3676,1846,1830
2016,1,D,발달상권,1001162,서울 광진구 건대입구역_1,930,474,456
2016,1,D,발달상권,1001161,건대입구역,781,411,370
2016,1,D,발달상권,1001160,서울 광진구 구의역,867,536,331
2016,1,D,발달상권,1001159,서울 강동구 천호역,973,447,526
2016,1,D,발달상권,1001158,당산역_2,5049,3064,1985
2016,1,D,발달상권,1001156,서울 강동구 길동역,1552,1015,537
2016,1,D,발달상권,1001155,용산 전자상가_5,2249,1648,601
2016,1,D,발달상권,1001153,당산역_1,1109,711,398
2016,1,D,발달상권,1001152,서울 광진구 강변역,2212,1810,402
2016,1,D,발달상권,1001151,용산 전자상가_3,2497,1827,670
2016,1,D,발달상권,1001150,서울 용산구 이태원역,703,432,271
2016,1,D,발달상권,1001149,한남오거리,610,327,283
2016,1,D,발달상권,1001147,용산 전자상가_2,494,399,95
2016,1,D,발달상권,1001146,용산구청,101,71,30
2016,1,D,발달상권,1001145,용산 전자상가_1,8205,6282,1923
2016,1,D,발달상권,1001144,국회의사당역_2,40118,22728,17390
2016,1,D,발달상권,1001143,서울 용산구 신용산역,311,125,186
2016,1,D,발달상권,1001142,국회의사당역_1,5670,4378,1292
2016,1,D,발달상권,1001141,압구정 로데오거리_2,14341,6032,8309
2016,1,D,발달상권,1001140,서울 강남구 압구정역,10450,4987,5463
2016,1,D,발달상권,1001139,서울 영등포구 영등포구청역,3674,1149,2525
2016,1,D,발달상권,1001138,압구정 로데오거리_1,7548,2500,5048
2016,1,D,발달상권,1001137,서울 강동구 둔촌동역,47,14,33
2016,1,D,발달상권,1001136,오목교역,211,106,105
2016,1,D,발달상권,1001135,신사동 가로수길,21175,9945,11230
2016,1,D,발달상권,1001134,서울 영등포구 여의도역_2,47922,31723,16199
2016,1,D,발달상권,1001133,청담사거리_3,1274,424,850
2016,1,D,발달상권,1001132,영등포유통상가,1975,1272,703
2016,1,D,발달상권,1001131,청담역_2,1365,996,369
2016,1,D,발달상권,1001130,청담역_1,245,182,63
2016,1,D,발달상권,1001129,청담사거리_2,1026,808,218
2016,1,D,발달상권,1001127,서울 영등포구 여의도역_1,52600,31128,21472
2016,1,D,발달상권,1001125,학동사거리_2,2822,1608,1214
2016,1,D,발달상권,1001124,서울 영등포구 영등포시장역,349,279,70
2016,1,D,발달상권,1001123,학동사거리_1,4027,2009,2018
2016,1,D,발달상권,1001122,여의도 시범아파트앞,2428,1582,846
2016,1,D,발달상권,1001121,영등포역_3,851,508,343
2016,1,D,발달상권,1001120,도산공원사거리_1,9818,5857,3961
2016,1,D,발달상권,1001119,영등포역_2,1076,582,494
2016,1,D,발달상권,1001118,문래동 주민센터,66,56,10
2016,1,D,발달상권,1001117,강남구 신사역_2,7283,4812,2471
2016,1,D,발달상권,1001115,서울 강남구 강남구청역_2,3940,2444,1496
2016,1,D,발달상권,1001114,강남구 신사역_1,2553,1171,1382
2016,1,D,발달상권,1001113,서울 동작구 노량진1동_1,36,26,10
2016,1,D,발달상권,1001112,서울 강남구 학동역_3,8474,4970,3504
2016,1,D,발달상권,1001111,서울 강남구 강남구청역_1,2950,1693,1257
2016,1,D,발달상권,1001110,잠실역,5964,4585,1379
2016,1,D,발달상권,1001109,강남구 논현역_4,8114,3632,4482
2016,1,D,발달상권,1001108,학동역,843,420,423
2016,1,D,발달상권,1001107,방이동 먹자골목,5729,3810,1919
2016,1,D,발달상권,1001106,서울 강남구 학동역_2,5870,2854,3016
2016,1,D,발달상권,1001105,서울 동작구 노량진역,3620,2082,1538
2016,1,D,발달상권,1001104,삼성역_3,8416,4875,3541
2016,1,D,발달상권,1001103,코엑스,20413,11662,8751
2016,1,D,발달상권,1001102,서울 강남구 학동역_1,5642,3488,2154
2016,1,D,발달상권,1001101,선정릉역_2,6466,4051,2415
2016,1,D,발달상권,1001100,강남구 논현역_3,1534,861,673
2016,1,D,발달상권,1001099,포스코사거리_2,7212,4325,2887
2016,1,D,발달상권,1001098,포스코사거리_1,51969,34731,17238
2016,1,D,발달상권,1001097,잠실역 롯데월드,3297,1640,1657
2016,1,D,발달상권,1001096,신도림역,3669,2005,1664
2016,1,D,발달상권,1001095,강남구 논현역_2,7962,3773,4189
2016,1,D,발달상권,1001094,선정릉역_1,1602,1094,508
2016,1,D,발달상권,1001093,신천역,5911,3248,2663
2016,1,D,발달상권,1001092,강남구 논현역_1,2974,1984,990
2016,1,D,발달상권,1001091,삼성역_2,17660,10419,7241
2016,1,D,발달상권,1001090,삼정역_2,2635,1188,1447
2016,1,D,발달상권,1001089,삼정역_1,2956,1594,1362
2016,1,D,발달상권,1001088,삼성역_1,28464,18481,9983
2016,1,D,발달상권,1001087,서울 강남구 선릉역_2,7162,4492,2670
2016,1,D,발달상권,1001086,고속터미널역,15243,4725,10518
2016,1,D,발달상권,1001085,서울 서초구 강남역,33448,19141,14307
2016,1,D,발달상권,1001084,서울 강남구 선릉역_1,19188,8450,10738
2016,1,D,발달상권,1001082,선릉역_2,20279,11010,9269
2016,1,D,발달상권,1001081,서울 강남구 역삼역_2,27201,21335,5866
2016,1,D,발달상권,1001080,서울 송파구 석촌역_1,43,29,14
2016,1,D,발달상권,1001078,서울 강남구 강남역_2,6537,4247,2290
2016,1,D,발달상권,1001077,선릉역_1,57431,29571,27860
2016,1,D,발달상권,1001076,구로역,160,91,69
2016,1,D,발달상권,1001075,역삼역_2,3939,2184,1755
2016,1,D,발달상권,1001074,대림역_2,7164,5491,1673
2016,1,D,발달상권,1001073,서울 강남구 역삼역_1,25489,16152,9337
2016,1,D,발달상권,1001072,신대방삼거리역,312,163,149
2016,1,D,발달상권,1001071,서울 강남구 한티역,1236,465,771
2016,1,D,발달상권,1001070,은마아파트입구사거리_4,82,45,37
2016,1,D,발달상권,1001067,오류동역,1444,724,720
2016,1,D,발달상권,1001066,서울 강남구 강남역,38860,18331,20529
2016,1,D,발달상권,1001063,교대역_4,4898,2895,2003
2016,1,D,발달상권,1001062,서울 강남구 강남역_1,136304,99464,36840
2016,1,D,발달상권,1001061,방배동카페골목,111,42,69
2016,1,D,발달상권,1001060,가락시장,15738,10117,5621
2016,1,D,발달상권,1001059,교대역_3,4466,2764,1702
2016,1,D,발달상권,1001058,역삼역_1,1760,955,805
2016,1,D,발달상권,1001057,교대역_2,3563,2279,1284
2016,1,D,발달상권,1001056,서울 송파구 가락시장역,5278,3419,1859
2016,1,D,발달상권,1001055,서울 서초구 서초역,11731,4924,6807
2016,1,D,발달상권,1001054,서울 강남구 대치역_2,1371,876,495
2016,1,D,발달상권,1001052,뱅뱅사거리_2,23374,14912,8462
2016,1,D,발달상권,1001051,보라매공원,14487,8365,6122
2016,1,D,발달상권,1001050,교대역_1,13110,7749,5361
2016,1,D,발달상권,1001049,개봉동 현대아파트 인근,162,74,88
2016,1,D,발달상권,1001048,뱅뱅사거리,10129,7003,3126
2016,1,D,발달상권,1001047,뱅뱅사거리_1,9886,7034,2852
2016,1,D,발달상권,1001046,서울 관악구 신림역_4,813,404,409
2016,1,D,발달상권,1001045,동작구 총신대입구역_1,222,109,113
2016,1,D,발달상권,1001044,양재역_3,3312,2304,1008
2016,1,D,발달상권,1001043,동작구 총신대입구역_2,850,383,467
2016,1,D,발달상권,1001042,서울 서초구 남부터미널역_3,1707,999,708
2016,1,D,발달상권,1001041,서울 강남구 수서역,18371,10610,7761
2016,1,D,발달상권,1001039,서울 서초구 남부터미널역_2,11583,5674,5909
2016,1,D,발달상권,1001038,구로디지탈1단지,64770,41847,22923
2016,1,D,발달상권,1001037,양재역,128,68,60
2016,1,D,발달상권,1001035,매봉역,338,155,183
2016,1,D,발달상권,1001034,서울 서초구 방배역,3749,2211,1538
2016,1,D,발달상권,1001033,서울 서초구 남부터미널역_1,740,530,210
2016,1,D,발달상권,1001032,서울 관악구 신림역_2,29,15,14
2016,1,D,발달상권,1001031,서울 관악구 신림역_1,1951,913,1038
2016,1,D,발달상권,1001030,양재역_2,8441,4680,3761
2016,1,D,발달상권,1001029,양재역_1,950,665,285
2016,1,D,발달상권,1001028,서울 관악구 서울대입구역_2,40,4,36
2016,1,D,발달상권,1001027,가산디지털단지역_3,31398,18928,12470
2016,1,D,발달상권,1001026,구로디지털단지역,1947,1297,650
2016,1,D,발달상권,1001025,서울 관악구 서울대입구역_1,1896,810,1086
2016,1,D,발달상권,1001024,관악구 사당역_1,3870,1606,2264
2016,1,D,발달상권,1001023,가산디지털단지역_2,61769,37010,24759
2016,1,D,발달상권,1001022,관악구 사당역_2,390,194,196
2016,1,D,발달상권,1001021,가산디지털단지역_1,24498,16480,8018
2016,1,D,발달상권,1001020,장지역,3954,2503,1451
2016,1,D,발달상권,1001019,포이사거리_1,5643,3083,2560
2016,1,D,발달상권,1001018,포이사거리_2,7827,5282,2545
2016,1,D,발달상권,1001016,서울 관악구 대학동_1,81,49,32
2016,1,D,발달상권,1001015,서울 금천구 독산1동_1,2987,2109,878
2016,1,D,발달상권,1001013,양재 화물트럭터미널앞_2,202,96,106
2016,1,D,발달상권,1001012,양재 화물트럭터미널앞_1,4112,3239,873
2016,1,D,발달상권,1001011,서울 금천구 시흥1동_4,931,480,451
2016,1,A,골목상권,1001010,풍성로37가길,45,21,24
2016,1,A,골목상권,1001009,천호옛길,561,394,167
2016,1,A,골목상권,1001008,천호옛14길,594,288,306
2016,1,A,골목상권,1001007,천호대로219길,886,519,367
2016,1,A,골목상권,1001006,천호대로197길,19,6,13
2016,1,A,골목상권,1001005,천호대로187길,847,499,348
2016,1,A,골목상권,1001004,천호대로170길,407,157,250
2016,1,A,골목상권,1001003,천호대로162길,1107,752,355
2016,1,A,골목상권,1001002,천중로51길,413,228,185
2016,1,A,골목상권,1001001,천중로39길,616,213,403
2016,1,A,골목상권,1001000,진황도로47길,1139,584,555
2016,1,A,골목상권,1000999,진황도로27길,444,267,177
2016,1,A,골목상권,1000998,올림픽로98길,42,23,19
2016,1,A,골목상권,1000997,올림픽로80길,5,3,2
2016,1,A,골목상권,1000995,올림픽로77길,8,6,2
2016,1,A,골목상권,1000994,올림픽로71길,408,305,103
2016,1,A,골목상권,1000993,올림픽로48길,5859,3559,2300
2016,1,A,골목상권,1000992,양재대로96길,1370,827,543
2016,1,A,골목상권,1000991,양재대로95길,624,339,285
2016,1,A,골목상권,1000990,양재대로91길,1082,579,503
2016,1,A,골목상권,1000989,양재대로133길,311,117,194
2016,1,A,골목상권,1000988,양재대로124길,566,328,238
2016,1,A,골목상권,1000987,양재대로116길,220,93,127
2016,1,A,골목상권,1000986,양재대로101길,1324,730,594
2016,1,A,골목상권,1000985,암사길,383,168,215
2016,1,A,골목상권,1000984,성안로3길,1545,994,551
2016,1,A,골목상권,1000983,성내로5길,981,517,464
2016,1,A,골목상권,1000982,상일로5길,54,31,23
2016,1,A,골목상권,1000981,상암로5길,456,194,262
2016,1,A,골목상권,1000980,상암로51길,711,314,397
2016,1,A,골목상권,1000979,상암로4길,227,176,51
2016,1,A,골목상권,1000978,상암로14길,418,257,161
2016,1,A,골목상권,1000977,명일로13길,127,52,75
2016,1,A,골목상권,1000976,동남로85길,121,59,62
2016,1,A,골목상권,1000975,동남로82길,11,4,7
2016,1,A,골목상권,1000974,동남로65길,90,33,57
2016,1,A,골목상권,1000973,구천면로42길,338,166,172
2016,1,A,골목상권,1000972,구천면로41길,609,248,361
2016,1,A,골목상권,1000971,구천면로36길,67,42,25
2016,1,A,골목상권,1000969,고덕로25길,10,8,2
2016,1,A,골목상권,1000968,고덕로10길,184,92,92
2016,1,A,골목상권,1000967,강동대로53길,846,461,385
2016,1,A,골목상권,1000966,풍성로25길,874,373,501
2016,1,A,골목상권,1000965,오금로46길,1381,708,673
2016,1,A,골목상권,1000964,오금로36길,1712,1360,352
2016,1,A,골목상권,1000963,오금로11길,2155,1391,764
2016,1,A,골목상권,1000962,양재대로72길,835,494,341
2016,1,A,골목상권,1000961,양재대로71길,1168,703,465
2016,1,A,골목상권,1000960,양재대로64길,1423,577,846
2016,1,A,골목상권,1000959,양재대로62길,6032,3658,2374
2016,1,A,골목상권,1000958,송파대로30길,1662,1067,595
2016,1,A,골목상권,1000957,송이로36길,1914,1398,516
2016,1,A,골목상권,1000956,송이로32길,789,430,359
2016,1,A,골목상권,1000955,송이로23길,1305,807,498
2016,1,A,골목상권,1000954,삼전로13길,1777,946,831
2016,1,A,골목상권,1000953,백제고분로50길,3143,1555,1588
2016,1,A,골목상권,1000952,백제고분로46길,1619,1004,615
2016,1,A,골목상권,1000951,백제고분로45길,468,318,150
2016,1,A,골목상권,1000950,백제고분로42길,116,74,42
2016,1,A,골목상권,1000949,백제고분로39길,1416,1046,370
2016,1,A,골목상권,1000948,백제고분로34길,1648,1085,563
2016,1,A,골목상권,1000947,백제고분로33길,862,555,307
2016,1,A,골목상권,1000946,백제고분로32길,1063,452,611
2016,1,A,골목상권,1000945,백제고분로31길,334,215,119
2016,1,A,골목상권,1000944,백제고분로22길,1098,658,440
2016,1,A,골목상권,1000943,백제고분로21길,191,133,58
2016,1,A,골목상권,1000942,마천로51길,132,49,83
2016,1,A,골목상권,1000941,동남로20길,168,91,77
2016,1,A,골목상권,1000940,거마로20길,411,182,229
2016,1,A,골목상권,1000939,학동로77길,2957,1533,1424
2016,1,A,골목상권,1000938,학동로6길,1856,1007,849
2016,1,A,골목상권,1000937,학동로56길,948,548,400
2016,1,A,골목상권,1000936,학동로38길,7102,4600,2502
2016,1,A,골목상권,1000935,테헤란로81길,665,211,454
2016,1,A,골목상권,1000934,일원로9길,468,268,200
2016,1,A,골목상권,1000933,일원로3길,242,115,127
2016,1,A,골목상권,1000932,영동대로65길,3256,1948,1308
2016,1,A,골목상권,1000931,영동대로112길,758,522,236
2016,1,A,골목상권,1000930,언주로81길,8439,3979,4460
2016,1,A,골목상권,1000929,압구정로2길,2630,1415,1215
2016,1,A,골목상권,1000928,선릉로18길,395,223,172
2016,1,A,골목상권,1000927,선릉로146길,1832,957,875
2016,1,A,골목상권,1000926,선릉로133길,150,82,68
2016,1,A,골목상권,1000925,선릉로132길,1004,534,470
2016,1,A,골목상권,1000924,선릉로121길,1710,909,801
2016,1,A,골목상권,1000923,삼성로75길,2547,1351,1196
2016,1,A,골목상권,1000922,삼성로69길,273,152,121
2016,1,A,골목상권,1000921,삼성로64길,628,319,309
2016,1,A,골목상권,1000920,삼성로63길,152,68,84
2016,1,A,골목상권,1000919,삼성로57길,877,279,598
2016,1,A,골목상권,1000918,삼성로147길,907,359,548
2016,1,A,골목상권,1000917,삼성로115길,246,150,96
2016,1,A,골목상권,1000916,봉은사로68길,231,126,105
2016,1,A,골목상권,1000915,봉은사로57길,590,409,181
2016,1,A,골목상권,1000914,봉은사로43길,1048,706,342
2016,1,A,골목상권,1000913,봉은사로29길,148,99,49
2016,1,A,골목상권,1000912,봉은사로109길,295,168,127
2016,1,A,골목상권,1000911,도산대로89길,2731,1055,1676
2016,1,A,골목상권,1000910,도산대로81길,4613,1463,3150
2016,1,A,골목상권,1000909,도산대로50길,2684,1862,822
2016,1,A,골목상권,1000908,도산대로38길,170,88,82
2016,1,A,골목상권,1000907,도산대로30길,2971,1396,1575
2016,1,A,골목상권,1000906,도산대로23길,1455,871,584
2016,1,A,골목상권,1000905,도산대로15길,1708,790,918
2016,1,A,골목상권,1000904,도곡로37길,3274,2182,1092
2016,1,A,골목상권,1000903,논현로8길,795,418,377
2016,1,A,골목상권,1000902,논현로63길,9719,2785,6934
2016,1,A,골목상권,1000901,논현로28길,12742,9090,3652
2016,1,A,골목상권,1000900,논현로26길,6849,4269,2580
2016,1,A,골목상권,1000898,논현로139길,2146,1239,907
2016,1,A,골목상권,1000897,논현로123길,109,63,46
2016,1,A,골목상권,1000896,논현로115길,2983,1694,1289
2016,1,A,골목상권,1000895,논현로10길,2469,1656,813
2016,1,A,골목상권,1000894,논현로106길,2763,1574,1189
2016,1,A,골목상권,1000893,남부순환로365길,182,135,47
2016,1,A,골목상권,1000891,개포로28길,300,220,80
2016,1,A,골목상권,1000890,개포로20길,4197,2384,1813
2016,1,A,골목상권,1000889,개포로17길,2694,1749,945
2016,1,A,골목상권,1000888,강남대로140길,4530,2545,1985
2016,1,A,골목상권,1000887,강남대로136길,1187,667,520
2016,1,A,골목상권,1000886,강남대로118길,564,316,248
2016,1,A,골목상권,1000885,서초중앙로8길,5867,4472,1395
2016,1,A,골목상권,1000884,방배중앙로21길,2152,725,1427
2016,1,A,골목상권,1000883,효령로72길,197,115,82
2016,1,A,골목상권,1000882,효령로34길,52,26,26
2016,1,A,골목상권,1000881,효령로31길,1502,900,602
2016,1,A,골목상권,1000880,효령로23길,690,416,274
2016,1,A,골목상권,1000879,청두곶길,2013,1376,637
2016,1,A,골목상권,1000878,주흥길,371,237,134
2016,1,A,골목상권,1000877,주흥15길,1400,898,502
2016,1,A,골목상권,1000876,언남길,1858,1357,501
2016,1,A,골목상권,1000875,신반포로45길,444,295,149
2016,1,A,골목상권,1000874,서초대로8길,287,203,84
2016,1,A,골목상권,1000873,서초대로64길,468,334,134
2016,1,A,골목상권,1000872,서초대로4길,601,437,164
2016,1,A,골목상권,1000871,서초대로25길,3555,2153,1402
2016,1,A,골목상권,1000870,서초대로23길,565,343,222
2016,1,A,골목상권,1000869,서초대로15길,1102,519,583
2016,1,A,골목상권,1000868,사평대로57길,198,76,122
2016,1,A,골목상권,1000867,사평대로26길,18,12,6
2016,1,A,골목상권,1000866,사평대로22길,1223,691,532
2016,1,A,골목상권,1000865,사임당로17길,1594,989,605
2016,1,A,골목상권,1000864,방배로42길,168,92,76
2016,1,A,골목상권,1000863,방배로35길,2287,1492,795
2016,1,A,골목상권,1000862,방배로18길,71,40,31
2016,1,A,골목상권,1000861,반포대로9길,667,469,198
2016,1,A,골목상권,1000860,바우뫼로39길,2184,1370,814
2016,1,A,골목상권,1000859,마방로2길,3799,2479,1320
2016,1,A,골목상권,1000858,방배천로4안길,1650,883,767
2016,1,A,골목상권,1000857,동산로19길,1380,930,450
2016,1,A,골목상권,1000856,동산로10길,2297,1238,1059
2016,1,A,골목상권,1000855,동광로39길,51,35,16
2016,1,A,골목상권,1000854,동광로1길,1396,785,611
2016,1,A,골목상권,1000853,동광로12길,724,495,229
2016,1,A,골목상권,1000852,논현로27길,3483,2528,955
2016,1,A,골목상권,1000851,논현로1길,609,378,231
2016,1,A,골목상권,1000850,남부순환로339길,11713,5285,6428
2016,1,A,골목상권,1000849,남부순환로325길,8052,4244,3808
2016,1,A,골목상권,1000848,남부순환로317길,1506,1082,424
2016,1,A,골목상권,1000847,고무래로8길,6843,3765,3078
2016,1,A,골목상권,1000846,강남대로8길,3189,2111,1078
2016,1,A,골목상권,1000845,강남대로34길,954,654,300
2016,1,A,골목상권,1000844,강남대로23길,6012,4353,1659
2016,1,A,골목상권,1000843,소담길,24,6,18
2016,1,A,골목상권,1000842,원신길,292,115,177
2016,1,A,골목상권,1000840,양산길,418,300,118
2016,1,A,골목상권,1000839,호암로24길,626,240,386
2016,1,A,골목상권,1000838,호암로20길,46,31,15
2016,1,A,골목상권,1000837,행운길,19,3,16
2016,1,A,골목상권,1000836,행운1길,84,53,31
2016,1,A,골목상권,1000835,청림3길,70,37,33
2016,1,A,골목상권,1000834,청룡길,170,114,56
2016,1,A,골목상권,1000833,청룡8길,33,11,22
2016,1,A,골목상권,1000832,중앙길,301,114,187
2016,1,A,골목상권,1000831,조원중앙로2길,1136,785,351
2016,1,A,골목상권,1000830,조원로18길,1030,541,489
2016,1,A,골목상권,1000829,조원로10길,273,132,141
2016,1,A,골목상권,1000828,장군봉2길,299,122,177
2016,1,A,골목상권,1000827,장군봉1길,99,13,86
2016,1,A,골목상권,1000826,인헌길,79,35,44
2016,1,A,골목상권,1000825,은천로25길,297,104,193
2016,1,A,골목상권,1000824,양녕로6길,934,603,331
2016,1,A,골목상권,1000823,신원로3길,33,23,10
2016,1,A,골목상권,1000822,신사로20길,63,31,32
2016,1,A,골목상권,1000820,신림로64길,222,119,103
2016,1,A,골목상권,1000819,신림로48길,74,38,36
2016,1,A,골목상권,1000818,신림로38길,49,25,24
2016,1,A,골목상권,1000817,신림로28길,326,225,101
2016,1,A,골목상권,1000816,신림로11길,436,403,33
2016,1,A,골목상권,1000815,신림동길,341,197,144
2016,1,A,골목상권,1000814,승방길,514,343,171
2016,1,A,골목상권,1000813,서림7길,254,91,163
2016,1,A,골목상권,1000812,봉천로33길,357,228,129
2016,1,A,골목상권,1000811,봉천로13길,287,86,201
2016,1,A,골목상권,1000810,복은길,195,73,122
2016,1,A,골목상권,1000809,법원단지길,2,1,1
2016,1,A,골목상권,1000808,법원단지9길,85,35,50
2016,1,A,골목상권,1000807,미성5길,61,34,27
2016,1,A,골목상권,1000806,대학길,79,34,45
2016,1,A,골목상권,1000805,대학14길,12,2,10
2016,1,A,골목상권,1000804,당곡길,352,158,194
2016,1,A,골목상권,1000803,남현길,237,91,146
2016,1,A,골목상권,1000802,남현3길,520,300,220
2016,1,A,골목상권,1000800,남부순환로248길,258,129,129
2016,1,A,골목상권,1000799,남부순환로234길,138,88,50
2016,1,A,골목상권,1000798,남부순환로172길,1500,840,660
2016,1,A,골목상권,1000797,남부순환로161길,17,4,13
2016,1,A,골목상권,1000796,남부순환로151길,121,75,46
2016,1,A,골목상권,1000795,남부순환로142길,70,30,40
2016,1,A,골목상권,1000794,난향길,171,49,122
2016,1,A,골목상권,1000793,난우길,410,172,238
2016,1,A,골목상권,1000792,난곡로74길,175,70,105
2016,1,A,골목상권,1000791,난곡로34길,28,8,20
2016,1,A,골목상권,1000790,난곡로26길,137,63,74
2016,1,A,골목상권,1000789,난곡로24길,34,15,19
2016,1,A,골목상권,1000788,낙성대역길,752,476,276
2016,1,A,골목상권,1000787,국회단지길,517,225,292
2016,1,A,골목상권,1000786,구암길,82,30,52
2016,1,A,골목상권,1000785,관천로22길,17,7,10
2016,1,A,골목상권,1000784,관천로15길,123,71,52
2016,1,A,골목상권,1000783,관악로30길,170,59,111
2016,1,A,골목상권,1000782,관악로28길,143,71,72
2016,1,A,골목상권,1000781,관악로14길,397,212,185
2016,1,A,골목상권,1000780,관악로10길,218,146,72
2016,1,A,골목상권,1000779,흑석로9길,174,73,101
2016,1,A,골목상권,1000778,흑석로13길,142,17,125
2016,1,A,골목상권,1000777,장승배기로27길,36,18,18
2016,1,A,골목상권,1000776,장승배기로19길,8,5,3
2016,1,A,골목상권,1000774,여의대방로46길,421,127,294
2016,1,A,골목상권,1000773,여의대방로24길,16144,7449,8695
2016,1,A,골목상권,1000772,여의대방로22카길,267,111,156
2016,1,A,골목상권,1000771,여의대방로22나길,132,51,81
2016,1,A,골목상권,1000770,여의대방로22길,211,128,83
2016,1,A,골목상권,1000769,양녕로26길,126,66,60
2016,1,A,골목상권,1000768,신대방길,121,78,43
2016,1,A,골목상권,1000767,성대로29길,2,2,0
2016,1,A,골목상권,1000766,성대로1길,327,132,195
2016,1,A,골목상권,1000765,서달로8가길,194,81,113
2016,1,A,골목상권,1000763,서달로14길,37,16,21
2016,1,A,골목상권,1000762,서달로10길,75,30,45
2016,1,A,골목상권,1000761,상도로62길,157,57,100
2016,1,A,골목상권,1000760,상도로61길,43,21,22
2016,1,A,골목상권,1000759,상도로47길,69,48,21
2016,1,A,골목상권,1000758,상도로37길,1997,1016,981
2016,1,A,골목상권,1000757,상도로15길,255,111,144
2016,1,A,골목상권,1000756,사당로8길,119,62,57
2016,1,A,골목상권,1000755,사당로30길,309,209,100
2016,1,A,골목상권,1000754,사당로2차길,100,62,38
2016,1,A,골목상권,1000753,사당로29길,21,15,6
2016,1,A,골목상권,1000752,사당로26길,233,127,106
2016,1,A,골목상권,1000751,사당로23나길,137,46,91
2016,1,A,골목상권,1000750,사당로23길,19,11,8
2016,1,A,골목상권,1000749,사당로20길,160,117,43
2016,1,A,골목상권,1000748,사당로16길,132,39,93
2016,1,A,골목상권,1000747,사당로16가길,790,488,302
2016,1,A,골목상권,1000746,만양로8길,70,29,41
2016,1,A,골목상권,1000745,만양로14길,377,159,218
2016,1,A,골목상권,1000744,등용로14길,591,428,163
2016,1,A,골목상권,1000743,동작대로7길,1799,791,1008
2016,1,A,골목상권,1000742,동작대로35길,246,93,153
2016,1,A,골목상권,1000741,동작대로33길,108,52,56
2016,1,A,골목상권,1000740,동작대로29길,33,18,15
2016,1,A,골목상권,1000739,동작대로17길,1322,706,616
2016,1,A,골목상권,1000738,대방동2길,446,215,231
2016,1,A,골목상권,1000737,대방동27길,138,79,59
2016,1,A,골목상권,1000736,노량진로6길,108,28,80
2016,1,A,골목상권,1000735,국사봉길,37,6,31
2016,1,A,골목상권,1000734,국사봉2길,99,67,32
2016,1,A,골목상권,1000733,국사봉1길,15,9,6
2016,1,A,골목상권,1000732,영신로9길,387,168,219
2016,1,A,골목상권,1000731,영등포로84길,355,83,272
2016,1,A,골목상권,1000730,영등포로80길,74,50,24
2016,1,A,골목상권,1000729,영등포로62길,5,3,2
2016,1,A,골목상권,1000728,영등포로35길,53,40,13
2016,1,A,골목상권,1000727,영등포로27길,301,186,115
2016,1,A,골목상권,1000724,여의대방로43나길,2337,1891,446
2016,1,A,골목상권,1000723,여의대방로39길,13,9,4
2016,1,A,골목상권,1000722,여의대방로35길,731,393,338
2016,1,A,골목상권,1000721,양평로28길,559,430,129
2016,1,A,골목상권,1000720,양평로22라길,42,27,15
2016,1,A,골목상권,1000719,양평로19길,4183,3344,839
2016,1,A,골목상권,1000718,신길로60길,419,178,241
2016,1,A,골목상권,1000717,신길로42길,383,187,196
2016,1,A,골목상권,1000716,신길로42가길,91,27,64
2016,1,A,골목상권,1000715,신길로39길,121,61,60
2016,1,A,골목상권,1000714,신길로17길,43,29,14
2016,1,A,골목상권,1000713,선유서로28길,437,232,205
2016,1,A,골목상권,1000712,선유서로25길,2293,1694,599
2016,1,A,골목상권,1000711,선유서로24길,179,100,79
2016,1,A,골목상권,1000710,선유로55길,2244,1391,853
2016,1,A,골목상권,1000709,디지털로74길,58,35,23
2016,1,A,골목상권,1000708,디지털로57길,7,1,6
2016,1,A,골목상권,1000707,디지털로37길,240,123,117
2016,1,A,골목상권,1000706,도신로62길,190,50,140
2016,1,A,골목상권,1000705,도신로60길,94,15,79
2016,1,A,골목상권,1000704,도신로29길,89,39,50
2016,1,A,골목상권,1000703,도신로15길,87,48,39
2016,1,A,골목상권,1000702,도림천로21길,100,47,53
2016,1,A,골목상권,1000701,도림로63길,30,19,11
2016,1,A,골목상권,1000700,도림로147길,1657,1197,460
2016,1,A,골목상권,1000699,도림로112길,16,8,8
2016,1,A,골목상권,1000698,대림로8길,1809,607,1202
2016,1,A,골목상권,1000697,대림로7길,15,5,10
2016,1,A,골목상권,1000696,대림로44길,46,28,18
2016,1,A,골목상권,1000695,대림로34길,173,63,110
2016,1,A,골목상권,1000694,대림로31길,750,365,385
2016,1,A,골목상권,1000693,대림로29길,1589,781,808
2016,1,A,골목상권,1000692,대림로22길,311,175,136
2016,1,A,골목상권,1000691,당산로46길,3211,1718,1493
2016,1,A,골목상권,1000690,당산로38길,276,215,61
2016,1,A,골목상권,1000689,당산로37길,3541,2209,1332
2016,1,A,골목상권,1000688,당산로31길,4168,2308,1860
2016,1,A,골목상권,1000687,국회대로56길,1578,1022,556
2016,1,A,골목상권,1000686,경인로90길,322,198,124
2016,1,A,골목상권,1000685,경인로80길,1565,1134,431
2016,1,A,골목상권,1000684,경인로77길,620,438,182
2016,1,A,골목상권,1000683,가마산로61길,219,90,129
2016,1,A,골목상권,1000682,시흥대로94길,796,415,381
2016,1,A,골목상권,1000681,시흥대로84길,164,65,99
2016,1,A,골목상권,1000680,시흥대로68길,342,126,216
2016,1,A,골목상권,1000679,시흥대로63길,2781,1467,1314
2016,1,A,골목상권,1000678,시흥대로62가길,421,111,310
2016,1,A,골목상권,1000677,시흥대로36길,349,212,137
2016,1,A,골목상권,1000676,시흥대로22길,495,353,142
2016,1,A,골목상권,1000675,시흥대로153길,621,324,297
2016,1,A,골목상권,1000674,시흥대로150길,582,262,320
2016,1,A,골목상권,1000673,시흥대로141길,694,423,271
2016,1,A,골목상권,1000672,시흥대로138길,14,7,7
2016,1,A,골목상권,1000671,시흥대로120길,616,421,195
2016,1,A,골목상권,1000670,벚꽃로56길,1850,1241,609
2016,1,A,골목상권,1000669,범안로17길,176,91,85
2016,1,A,골목상권,1000668,범안로11길,1115,895,220
2016,1,A,골목상권,1000667,문성로5길,190,49,141
2016,1,A,골목상권,1000666,독산로85길,69,25,44
2016,1,A,골목상권,1000665,독산로78다길,245,107,138
2016,1,A,골목상권,1000664,독산로70길,4,3,1
2016,1,A,골목상권,1000663,독산로64길,159,36,123
2016,1,A,골목상권,1000662,독산로50길,47,21,26
2016,1,A,골목상권,1000661,독산로40길,53,17,36
2016,1,A,골목상권,1000660,독산로108길,738,319,419
2016,1,A,골목상권,1000659,남부순환로112길,10,6,4
2016,1,A,골목상권,1000658,금하로24길,178,65,113
2016,1,A,골목상권,1000657,금하로1길,64,36,28
2016,1,A,골목상권,1000656,금하로14길,2,1,1
2016,1,A,골목상권,1000655,가산로5길,514,395,119
2016,1,A,골목상권,1000654,가산로3길,2440,1869,571
2016,1,A,골목상권,1000653,중앙로1길,1401,979,422
2016,1,A,골목상권,1000652,중앙로15길,97,48,49
2016,1,A,골목상권,1000651,우마길,35,23,12
2016,1,A,골목상권,1000650,오류로8길,230,110,120
2016,1,A,골목상권,1000649,신도림로13길,714,544,170
2016,1,A,골목상권,1000648,새말로18길,1203,491,712
2016,1,A,골목상권,1000647,부일로1길,765,632,133
2016,1,A,골목상권,1000646,부일로15길,191,169,22
2016,1,A,골목상권,1000645,부일로11길,27,9,18
2016,1,A,골목상권,1000644,디지털로32길,1262,673,589
2016,1,A,골목상권,1000643,디지털로32가길,7089,5056,2033
2016,1,A,골목상권,1000642,디지털로27길,393,251,142
2016,1,A,골목상권,1000641,도림로6길,105,44,61
2016,1,A,골목상권,1000640,도림로12길,98,42,56
2016,1,A,골목상권,1000639,남부순환로97길,262,85,177
2016,1,A,골목상권,1000638,구로중앙로8길,251,113,138
2016,1,A,골목상권,1000637,구로중앙로7길,185,68,117
2016,1,A,골목상권,1000636,구로중앙로42길,757,553,204
2016,1,A,골목상권,1000635,구로중앙로34길,594,323,271
2016,1,A,골목상권,1000634,구로중앙로28길,2883,1429,1454
2016,1,A,골목상권,1000633,구로중앙로19길,13,7,6
2016,1,A,골목상권,1000632,구로동로8길,157,47,110
2016,1,A,골목상권,1000631,구로동로7길,165,65,100
2016,1,A,골목상권,1000630,구로동로42길,26,19,7
2016,1,A,골목상권,1000629,구로동로41길,454,275,179
2016,1,A,골목상권,1000628,구로동로38길,43,17,26
2016,1,A,골목상권,1000627,구로동로28길,181,72,109
2016,1,A,골목상권,1000626,구로동로15길,23,2,21
2016,1,A,골목상권,1000625,공원로6가길,235,177,58
2016,1,A,골목상권,1000624,고척로52길,229,73,156
2016,1,A,골목상권,1000623,고척로27다길,227,90,137
2016,1,A,골목상권,1000622,고척로27길,233,97,136
2016,1,A,골목상권,1000621,고척로21나길,242,58,184
2016,1,A,골목상권,1000620,경인로47길,724,413,311
2016,1,A,골목상권,1000619,경인로35길,269,116,153
2016,1,A,골목상권,1000618,경인로31길,47,14,33
2016,1,A,골목상권,1000617,경인로15길,121,57,64
2016,1,A,골목상권,1000616,개봉로3길,303,169,134
2016,1,A,골목상권,1000615,개봉로2길,440,127,313
2016,1,A,골목상권,1000614,개봉로23가길,867,497,370
2016,1,A,골목상권,1000613,개봉로20길,115,66,49
2016,1,A,골목상권,1000612,개봉로1길,48,24,24
2016,1,A,골목상권,1000611,개봉로17다길,102,57,45
2016,1,A,골목상권,1000610,개봉로17길,837,400,437
2016,1,A,골목상권,1000609,개봉로11길,52,12,40
2016,1,A,골목상권,1000608,화곡로64길,2650,1398,1252
2016,1,A,골목상권,1000607,화곡로59길,519,195,324
2016,1,A,골목상권,1000606,화곡로44나길,853,722,131
2016,1,A,골목상권,1000605,화곡로31길,1080,388,692
2016,1,A,골목상권,1000604,화곡로20길,484,303,181
2016,1,A,골목상권,1000603,화곡로13길,251,82,169
2016,1,A,골목상권,1000602,초원로16길,445,191,254
2016,1,A,골목상권,1000601,초록마을로8길,171,28,143
2016,1,A,골목상권,1000600,초록마을로3길,48,23,25
2016,1,A,골목상권,1000599,월정로20길,2,1,1
2016,1,A,골목상권,1000598,우장산로6길,352,218,134
2016,1,A,골목상권,1000597,양천로73가길,1371,893,478
2016,1,A,골목상권,1000596,양천로71길,220,133,87
2016,1,A,골목상권,1000595,양천로49길,771,611,160
2016,1,A,골목상권,1000594,양천로26길,105,46,59
2016,1,A,골목상권,1000593,양천로24길,227,112,115
2016,1,A,골목상권,1000592,양천로24가길,691,280,411
2016,1,A,골목상권,1000591,양천로14길,324,200,124
2016,1,A,골목상권,1000590,방화대로6라길,733,491,242
2016,1,A,골목상권,1000589,방화대로21길,763,442,321
2016,1,A,골목상권,1000588,등촌로5길,10,2,8
2016,1,A,골목상권,1000587,등촌로55길,474,329,145
2016,1,A,골목상권,1000586,등촌로51길,10,9,1
2016,1,A,골목상권,1000585,등촌로39길,64,27,37
2016,1,A,골목상권,1000584,등촌로13길,195,100,95
2016,1,A,골목상권,1000583,남부순환로11길,430,313,117
2016,1,A,골목상권,1000582,까치산로4길,127,46,81
2016,1,A,골목상권,1000581,국회대로7길,355,215,140
2016,1,A,골목상권,1000580,공항대로8길,177,76,101
2016,1,A,골목상권,1000579,공항대로61길,250,158,92
2016,1,A,골목상권,1000578,공항대로59다길,844,639,205
2016,1,A,골목상권,1000577,공항대로59길,1093,698,395
2016,1,A,골목상권,1000576,공항대로55길,901,643,258
2016,1,A,골목상권,1000575,공항대로42길,8,5,3
2016,1,A,골목상권,1000574,공항대로38길,246,127,119
2016,1,A,골목상권,1000573,곰달래로60길,525,267,258
2016,1,A,골목상권,1000572,곰달래로53길,60,18,42
2016,1,A,골목상권,1000571,곰달래로47길,38,18,20
2016,1,A,골목상권,1000570,곰달래로31길,7,6,1
2016,1,A,골목상권,1000569,곰달래로25길,529,213,316
2016,1,A,골목상권,1000568,개화동로25길,647,429,218
2016,1,A,골목상권,1000567,개화동로23길,93,53,40
2016,1,A,골목상권,1000566,강서로8길,120,75,45
2016,1,A,골목상권,1000565,강서로5라길,277,156,121
2016,1,A,골목상권,1000564,강서로5나길,112,63,49
2016,1,A,골목상권,1000563,강서로5가길,45,26,19
2016,1,A,골목상권,1000562,강서로47라길,78,42,36
2016,1,A,골목상권,1000561,강서로47길,385,195,190
2016,1,A,골목상권,1000560,강서로45다길,838,370,468
2016,1,A,골목상권,1000559,강서로45길,126,59,67
2016,1,A,골목상권,1000558,강서로35길,152,87,65
2016,1,A,골목상권,1000557,강서로29길,292,166,126
2016,1,A,골목상권,1000556,강서로18길,23,12,11
2016,1,A,골목상권,1000555,강서로17가길,106,43,63
2016,1,A,골목상권,1000554,강서로15길,262,151,111
2016,1,A,골목상권,1000553,가로공원로80길,74,40,34
2016,1,A,골목상권,1000552,가로공원로76가길,18,7,11
2016,1,A,골목상권,1000551,화곡로4길,276,104,172
2016,1,A,골목상권,1000550,화곡로3길,180,65,115
2016,1,A,골목상권,1000549,지양로7길,219,67,152
2016,1,A,골목상권,1000548,중앙로55길,365,187,178
2016,1,A,골목상권,1000547,중앙로51길,124,69,55
2016,1,A,골목상권,1000546,중앙로47길,103,20,83
2016,1,A,골목상권,1000545,중앙로45길,156,49,107
2016,1,A,골목상권,1000544,중앙로36길,2,2,0
2016,1,A,골목상권,1000543,중앙로32길,569,267,302
2016,1,A,골목상권,1000542,중앙로25길,263,81,182
2016,1,A,골목상권,1000541,은행정로7길,469,151,318
2016,1,A,골목상권,1000539,오목로5길,312,182,130
2016,1,A,골목상권,1000538,오목로3길,452,427,25
2016,1,A,골목상권,1000537,오목로30길,178,82,96
2016,1,A,골목상권,1000536,오목로23길,736,402,334
2016,1,A,골목상권,1000535,신월로20길,212,79,133
2016,1,A,골목상권,1000534,신월로15길,783,363,420
2016,1,A,골목상권,1000533,신목로6길,229,124,105
2016,1,A,골목상권,1000532,신목로5길,901,328,573
2016,1,A,골목상권,1000531,신목로2길,98,46,52
2016,1,A,골목상권,1000530,목동중앙서로8가길,172,95,77
2016,1,A,골목상권,1000529,목동중앙서로7길,243,82,161
2016,1,A,골목상권,1000528,목동중앙북로8길,394,174,220
2016,1,A,골목상권,1000527,목동중앙북로16길,268,84,184
2016,1,A,골목상권,1000526,목동중앙본로7길,97,36,61
2016,1,A,골목상권,1000525,목동중앙로3길,104,57,47
2016,1,A,골목상권,1000524,목동중앙로13나길,258,190,68
2016,1,A,골목상권,1000523,목동중앙남로3가길,570,387,183
2016,1,A,골목상권,1000522,목동로9길,2432,1606,826
2016,1,A,골목상권,1000521,목동로19길,1003,378,625
2016,1,A,골목상권,1000519,목동동로12길,414,161,253
2016,1,A,골목상권,1000518,목동남로4길,10,5,5
2016,1,A,골목상권,1000517,남부순환로88길,327,139,188
2016,1,A,골목상권,1000516,남부순환로79길,588,408,180
2016,1,A,골목상권,1000515,남부순환로70길,670,468,202
2016,1,A,골목상권,1000514,남부순환로58길,158,84,74
2016,1,A,골목상권,1000513,남부순환로40길,22,12,10
2016,1,A,골목상권,1000512,남부순환로33길,1144,900,244
2016,1,A,골목상권,1000511,곰달래로5길,48,27,21
2016,1,A,골목상권,1000510,곰달래로3길,411,217,194
2016,1,A,골목상권,1000509,곰달래로2길,288,168,120
2016,1,A,골목상권,1000508,곰달래로10길,320,238,82
2016,1,A,골목상권,1000507,가로공원로58길,95,19,76
2016,1,A,골목상권,1000506,효창원로93길,114,60,54
2016,1,A,골목상권,1000505,토정로37길,122,46,76
2016,1,A,골목상권,1000504,월드컵로8길,1516,866,650
2016,1,A,골목상권,1000503,월드컵로7길,4,2,2
2016,1,A,골목상권,1000502,월드컵로36길,116,32,84
2016,1,A,골목상권,1000501,월드컵로25길,288,157,131
2016,1,A,골목상권,1000500,월드컵로19길,404,171,233
2016,1,A,골목상권,1000499,월드컵로16길,3859,1816,2043
2016,1,A,골목상권,1000498,월드컵로11길,195,71,124
2016,1,A,골목상권,1000497,월드컵로10길,1770,981,789
2016,1,A,골목상권,1000496,와우산로3길,143,87,56
2016,1,A,골목상권,1000495,와우산로29길,140,70,70
2016,1,A,골목상권,1000494,와우산로29가길,17,7,10
2016,1,A,골목상권,1000493,양화진길,441,314,127
2016,1,A,골목상권,1000492,양화로1길,4384,2299,2085
2016,1,A,골목상권,1000491,양화로11길,397,248,149
2016,1,A,골목상권,1000490,신촌로30길,29,14,15
2016,1,A,골목상권,1000489,신촌로28가길,113,48,65
2016,1,A,골목상권,1000488,신촌로12길,1235,596,639
2016,1,A,골목상권,1000487,숭문길,692,366,326
2016,1,A,골목상권,1000486,숭문8길,115,68,47
2016,1,A,골목상권,1000485,성지3길,500,278,222
2016,1,A,골목상권,1000484,성산로4길,3415,2084,1331
2016,1,A,골목상권,1000483,성미산로32길,346,175,171
2016,1,A,골목상권,1000482,성미산로1길,645,497,148
2016,1,A,골목상권,1000481,성미산로11길,982,674,308
2016,1,A,골목상권,1000480,백범로16길,578,316,262
2016,1,A,골목상권,1000479,방울내로9안길,313,174,139
2016,1,A,골목상권,1000478,모래내로7길,235,124,111
2016,1,A,골목상권,1000477,매봉산로2길,1621,1096,525
2016,1,A,골목상권,1000476,망원로2길,186,106,80
2016,1,A,골목상권,1000475,망원로11길,968,529,439
2016,1,A,골목상권,1000474,만리재옛길,1413,519,894
2016,1,A,골목상권,1000473,마포대로4길,143,84,59
2016,1,A,골목상권,1000472,마포대로20길,1113,594,519
2016,1,A,골목상권,1000471,마포대로12길,68,36,32
2016,1,A,골목상권,1000470,동교로38길,218,88,130
2016,1,A,골목상권,1000469,동교로27길,3400,1613,1787
2016,1,A,골목상권,1000468,동교로25길,384,178,206
2016,1,A,골목상권,1000467,동교로19길,4534,2892,1642
2016,1,A,골목상권,1000466,동교로17길,786,411,375
2016,1,A,골목상권,1000465,독막로8길,329,156,173
2016,1,A,골목상권,1000464,독막로32길,458,190,268
2016,1,A,골목상권,1000463,독막로22길,73,40,33
2016,1,A,골목상권,1000462,도화길,1004,488,516
2016,1,A,골목상권,1000461,도화4길,350,114,236
2016,1,A,골목상권,1000460,대흥로28길,55,46,9
2016,1,A,골목상권,1000459,대흥로21길,506,107,399
2016,1,A,골목상권,1000458,광성로6길,112,72,40
2016,1,A,골목상권,1000457,홍제내길,99,59,40
2016,1,A,골목상권,1000456,홍연길,88,55,33
2016,1,A,골목상권,1000455,통일로39길,10,9,1
2016,1,A,골목상권,1000454,통일로37길,342,130,212
2016,1,A,골목상권,1000453,통일로11길,12,10,2
2016,1,A,골목상권,1000452,충정로6길,15437,8539,6898
2016,1,A,골목상권,1000451,충정로4길,2998,2018,980
2016,1,A,골목상권,1000450,증가로6길,205,77,128
2016,1,A,골목상권,1000449,증가로23나길,422,212,210
2016,1,A,골목상권,1000448,증가로20가길,259,99,160
2016,1,A,골목상권,1000447,증가로10길,169,93,76
2016,1,A,골목상권,1000446,응암로1길,325,237,88
2016,1,A,골목상권,1000445,연희로10길,93,64,29
2016,1,A,골목상권,1000444,신촌로37길,148,63,85
2016,1,A,골목상권,1000443,수색로8길,2898,2789,109
2016,1,A,골목상권,1000442,세무서길,338,123,215
2016,1,A,골목상권,1000440,세검정로1길,278,171,107
2016,1,A,골목상권,1000439,북아현로4길,432,109,323
2016,1,A,골목상권,1000438,모래내로15길,81,20,61
2016,1,A,골목상권,1000437,명지대길,342,239,103
2016,1,A,골목상권,1000436,독립문로8길,730,281,449
2016,1,A,골목상권,1000435,가재울로6길,10,7,3
2016,1,A,골목상권,1000434,통일로92길,61,34,27
2016,1,A,골목상권,1000433,통일로87길,233,124,109
2016,1,A,골목상권,1000432,통일로78길,209,63,146
2016,1,A,골목상권,1000430,진흥로1길,491,147,344
2016,1,A,골목상권,1000429,진흥로12길,452,202,250
2016,1,A,골목상권,1000428,증산서길,387,279,108
2016,1,A,골목상권,1000427,증산로9길,98,36,62
2016,1,A,골목상권,1000426,증산로5길,722,373,349
2016,1,A,골목상권,1000425,증산로21길,258,171,87
2016,1,A,골목상권,1000424,증산로17길,802,414,388
2016,1,A,골목상권,1000423,증산로15길,196,74,122
2016,1,A,골목상권,1000422,증산로13길,66,35,31
2016,1,A,골목상권,1000421,응암로34길,104,63,41
2016,1,A,골목상권,1000420,응암로22길,166,54,112
2016,1,A,골목상권,1000419,응암로14길,336,104,232
2016,1,A,골목상권,1000418,응암로13길,264,107,157
2016,1,A,골목상권,1000417,응암로12길,212,97,115
2016,1,A,골목상권,1000416,은평로8길,264,139,125
2016,1,A,골목상권,1000415,은평로3길,294,84,210
2016,1,A,골목상권,1000414,은평로20길,23,9,14
2016,1,A,골목상권,1000413,은평로13길,481,309,172
2016,1,A,골목상권,1000412,은평로10길,305,186,119
2016,1,A,골목상권,1000411,연서로5길,57,22,35
2016,1,A,골목상권,1000410,연서로41길,231,65,166
2016,1,A,골목상권,1000409,연서로3길,104,39,65
2016,1,A,골목상권,1000408,연서로34길,132,40,92
2016,1,A,골목상권,1000407,연서로33길,28,8,20
2016,1,A,골목상권,1000406,연서로29길,325,119,206
2016,1,A,골목상권,1000405,연서로28길,753,343,410
2016,1,A,골목상권,1000404,연서로27길,65,29,36
2016,1,A,골목상권,1000403,연서로21길,335,208,127
2016,1,A,골목상권,1000402,연서로17길,1034,325,709
2016,1,A,골목상권,1000401,연서로16길,293,108,185
2016,1,A,골목상권,1000400,연서로13길,700,228,472
2016,1,A,골목상권,1000399,연서로11길,193,94,99
2016,1,A,골목상권,1000398,역말로9길,21,18,3
2016,1,A,골목상권,1000397,수색로18길,24,13,11
2016,1,A,골목상권,1000396,서오릉로8길,29,12,17
2016,1,A,골목상권,1000395,서오릉로21길,476,152,324
2016,1,A,골목상권,1000394,불광천길,167,82,85
2016,1,A,골목상권,1000393,갈현로7길,977,269,708
2016,1,A,골목상권,1000392,갈현로41길,92,38,54
2016,1,A,골목상권,1000391,갈현로33길,35,8,27
2016,1,A,골목상권,1000390,갈현로1길,131,56,75
2016,1,A,골목상권,1000389,가좌로7길,53,22,31
2016,1,A,골목상권,1000388,한글비석로44길,456,251,205
2016,1,A,골목상권,1000387,한글비석로24길,387,155,232
2016,1,A,골목상권,1000386,한글비석로22길,705,298,407
2016,1,A,골목상권,1000385,석계로1길,112,69,43
2016,1,A,골목상권,1000384,상계로9가길,347,99,248
2016,1,A,골목상권,1000382,상계로12길,13,9,4
2016,1,A,골목상권,1000381,동일로242길,492,373,119
2016,1,A,골목상권,1000380,동일로192길,462,223,239
2016,1,A,골목상권,1000379,동일로173가길,2408,1352,1056
2016,1,A,골목상권,1000378,공릉로58길,103,45,58
2016,1,A,골목상권,1000377,해등로16길,79,64,15
2016,1,A,골목상권,1000376,우이천로4다길,195,111,84
2016,1,A,골목상권,1000375,우이천로32길,96,46,50
2016,1,A,골목상권,1000374,시루봉로23길,39,18,21
2016,1,A,골목상권,1000373,삼양로144길,60,43,17
2016,1,A,골목상권,1000372,방학로6가길,162,87,75
2016,1,A,골목상권,1000371,방학로5길,119,73,46
2016,1,A,골목상권,1000370,방학로15길,346,219,127
2016,1,A,골목상권,1000369,방학로10길,121,49,72
2016,1,A,골목상권,1000367,도봉산4길,326,287,39
2016,1,A,골목상권,1000366,도봉로181길,216,98,118
2016,1,A,골목상권,1000365,도봉로169나길,282,127,155
2016,1,A,골목상권,1000364,도봉로156길,269,140,129
2016,1,A,골목상권,1000363,도봉로152가길,452,395,57
2016,1,A,골목상권,1000362,도봉로147길,578,337,241
2016,1,A,골목상권,1000360,도봉로114길,465,162,303
2016,1,A,골목상권,1000359,도봉로109길,18,6,12
2016,1,A,골목상권,1000358,도당로29길,903,537,366
2016,1,A,골목상권,1000357,도당로19길,162,74,88
2016,1,A,골목상권,1000356,도당로13바길,213,77,136
2016,1,A,골목상권,1000355,도당로13가길,144,63,81
2016,1,A,골목상권,1000354,덕릉로60길,54,27,27
2016,1,A,골목상권,1000353,노해로63다길,556,228,328
2016,1,A,골목상권,1000352,노해로60길,305,130,175
2016,1,A,골목상권,1000351,한천로140길,93,45,48
2016,1,A,골목상권,1000350,한천로139가길,54,29,25
2016,1,A,골목상권,1000349,한천로132길,293,110,183
2016,1,A,골목상권,1000348,한천로130길,287,131,156
2016,1,A,골목상권,1000347,한천로124나길,88,41,47
2016,1,A,골목상권,1000346,한천로109길,616,282,334
2016,1,A,골목상권,1000345,인수봉로79길,171,37,134
2016,1,A,골목상권,1000344,인수봉로72길,93,48,45
2016,1,A,골목상권,1000343,인수봉로56길,12,1,11
2016,1,A,골목상권,1000342,오패산로67길,537,282,255
2016,1,A,골목상권,1000341,오패산로52길,87,26,61
2016,1,A,골목상권,1000339,수유로12길,260,168,92
2016,1,A,골목상권,1000338,솔샘로65길,546,237,309
2016,1,A,골목상권,1000337,솔매로50길,694,269,425
2016,1,A,골목상권,1000336,솔매로45길,221,97,124
2016,1,A,골목상권,1000335,솔매로41길,76,16,60
2016,1,A,골목상권,1000334,삼양로93길,17,4,13
2016,1,A,골목상권,1000333,삼양로77길,401,137,264
2016,1,A,골목상권,1000332,삼양로54길,6,3,3
2016,1,A,골목상권,1000331,삼양로41길,342,167,175
2016,1,A,골목상권,1000329,삼양로24길,78,36,42
2016,1,A,골목상권,1000328,삼양로20길,133,49,84
2016,1,A,골목상권,1000327,삼각산로28길,669,373,296
2016,1,A,골목상권,1000326,도봉로99길,162,92,70
2016,1,A,골목상권,1000325,도봉로8길,271,187,84
2016,1,A,골목상권,1000324,도봉로76길,379,194,185
2016,1,A,골목상권,1000323,도봉로67길,5,3,2
2016,1,A,골목상권,1000322,도봉로45길,151,97,54
2016,1,A,골목상권,1000321,도봉로18길,367,175,192
2016,1,A,골목상권,1000320,도봉로13길,31,12,19
2016,1,A,골목상권,1000319,덕릉로41길,717,595,122
2016,1,A,골목상권,1000318,덕릉로40길,915,701,214
2016,1,A,골목상권,1000317,노해로33길,32,13,19
2016,1,A,골목상권,1000315,노해로17길,268,132,136
2016,1,A,골목상권,1000314,화랑로40길,161,82,79
2016,1,A,골목상권,1000313,화랑로32길,412,287,125
2016,1,A,골목상권,1000312,화랑로1길,201,108,93
2016,1,A,골목상권,1000311,화랑로19길,437,221,216
2016,1,A,골목상권,1000310,화랑로14길,44,20,24
2016,1,A,골목상권,1000309,화랑로13길,91,44,47
2016,1,A,골목상권,1000308,한천로76길,133,77,56
2016,1,A,골목상권,1000307,한천로101가길,61,36,25
2016,1,A,골목상권,1000306,창경궁로43길,28,14,14
2016,1,A,골목상권,1000305,지봉로20길,92,54,38
2016,1,A,골목상권,1000304,종암로5길,109,76,33
2016,1,A,골목상권,1000303,종암로24가길,282,151,131
2016,1,A,골목상권,1000302,종암로21길,131,52,79
2016,1,A,골목상권,1000301,종암로19길,370,103,267
2016,1,A,골목상권,1000300,종암로16길,77,36,41
2016,1,A,골목상권,1000299,정릉로8길,204,118,86
2016,1,A,골목상권,1000298,정릉로27길,223,90,133
2016,1,A,골목상권,1000296,장위로50길,956,527,429
2016,1,A,골목상권,1000295,장월로1길,419,184,235
2016,1,A,골목상권,1000294,인촌로6길,2258,1187,1071
2016,1,A,골목상권,1000293,인촌로5길,25,6,19
2016,1,A,골목상권,1000292,인촌로24길,171,114,57
2016,1,A,골목상권,1000291,개운사길,3066,1943,1123
2016,1,A,골목상권,1000290,인촌로1길,140,97,43
2016,1,A,골목상권,1000289,인촌로17가길,3124,1198,1926
2016,1,A,골목상권,1000288,오패산로4길,576,180,396
2016,1,A,골목상권,1000287,오패산로3길,1176,692,484
2016,1,A,골목상권,1000286,오패산로19길,47,15,32
2016,1,A,골목상권,1000285,안암로5길,568,345,223
2016,1,A,골목상권,1000284,아리랑로4길,628,238,390
2016,1,A,골목상권,1000283,솔샘로6길,149,65,84
2016,1,A,골목상권,1000282,성북로8길,45,23,22
2016,1,A,골목상권,1000281,삼양로8길,77,39,38
2016,1,A,골목상권,1000280,삼선교로16가길,675,400,275
2016,1,A,골목상권,1000279,삼선교로10다길,96,33,63
2016,1,A,골목상권,1000278,삼선교로10길,231,101,130
2016,1,A,골목상권,1000277,보문로32길,948,396,552
2016,1,A,골목상권,1000276,보문로31길,789,296,493
2016,1,A,골목상권,1000274,보문로13길,774,441,333
2016,1,A,골목상권,1000273,보국문로16길,292,202,90
2016,1,A,골목상권,1000270,동소문로26가길,241,132,109
2016,1,A,골목상권,1000269,동소문로15길,61,28,33
2016,1,A,골목상권,1000268,동소문로13길,841,478,363
2016,1,A,골목상권,1000267,돌곶이로8길,203,112,91
2016,1,A,골목상권,1000266,돌곶이로41길,47,21,26
2016,1,A,골목상권,1000265,돌곶이로28길,142,83,59
2016,1,A,골목상권,1000264,돌곶이로27길,53,30,23
2016,1,A,골목상권,1000263,돌곶이로22길,103,51,52
2016,1,A,골목상권,1000261,길음로7길,12,8,4
2016,1,A,골목상권,1000260,중랑천로10길,677,364,313
2016,1,A,골목상권,1000259,용마산로94길,452,279,173
2016,1,A,골목상권,1000258,용마산로118길,534,258,276
2016,1,A,골목상권,1000257,용마산로112길,277,131,146
2016,1,A,골목상권,1000256,용마산로100길,471,331,140
2016,1,A,골목상권,1000255,신내로7가길,281,75,206
2016,1,A,골목상권,1000254,사가정로54길,98,32,66
2016,1,A,골목상권,1000253,사가정로42길,60,22,38
2016,1,A,골목상권,1000252,봉화산로56길,591,158,433
2016,1,A,골목상권,1000251,봉화산로4길,358,127,231
2016,1,A,골목상권,1000250,봉화산로30길,392,246,146
2016,1,A,골목상권,1000249,봉우재로33길,62,23,39
2016,1,A,골목상권,1000248,면목로78길,291,171,120
2016,1,A,골목상권,1000247,면목로56길,223,167,56
2016,1,A,골목상권,1000246,면목로55길,457,143,314
2016,1,A,골목상권,1000245,면목로49길,503,162,341
2016,1,A,골목상권,1000244,면목로48길,104,57,47
2016,1,A,골목상권,1000243,면목로45길,90,36,54
2016,1,A,골목상권,1000242,면목로33길,450,168,282
2016,1,A,골목상권,1000241,면목로21길,27,22,5
2016,1,A,골목상권,1000240,망우로73길,9,4,5
2016,1,A,골목상권,1000239,망우로68길,74,30,44
2016,1,A,골목상권,1000238,동일로163길,126,85,41
2016,1,A,골목상권,1000237,동일로157길,193,95,98
2016,1,A,골목상권,1000236,동일로149길,1124,823,301
2016,1,A,골목상권,1000235,동일로140길,220,85,135
2016,1,A,골목상권,1000234,동일로139길,73,40,33
2016,1,A,골목상권,1000233,동일로139가길,1126,665,461
2016,1,A,골목상권,1000232,동일로130길,96,22,74
2016,1,A,골목상권,1000231,동일로123길,169,93,76
2016,1,A,골목상권,1000230,동일로112길,171,73,98
2016,1,A,골목상권,1000229,동일로101길,323,128,195
2016,1,A,골목상권,1000228,동일로100길,38,18,20
2016,1,A,골목상권,1000227,답십리로75길,88,48,40
2016,1,A,골목상권,1000226,공릉로2길,627,304,323
2016,1,A,골목상권,1000225,공릉로12가길,39,26,13
2016,1,A,골목상권,1000224,겸재로54길,116,65,51
2016,1,A,골목상권,1000223,겸재로36길,284,224,60
2016,1,A,골목상권,1000222,겸재로29길,452,190,262
2016,1,A,골목상권,1000221,휘경로3길,226,124,102
2016,1,A,골목상권,1000220,휘경로2길,7,2,5
2016,1,A,골목상권,1000219,휘경로23길,15,0,15
2016,1,A,골목상권,1000218,휘경로14길,101,42,59
2016,1,A,골목상권,1000217,한천로46길,387,121,266
2016,1,A,골목상권,1000216,한천로40길,278,149,129
2016,1,A,골목상권,1000215,한천로33길,70,31,39
2016,1,A,골목상권,1000214,한천로14길,610,374,236
2016,1,A,골목상권,1000213,천호대로97길,328,206,122
2016,1,A,골목상권,1000212,천호대로77길,2002,1019,983
2016,1,A,골목상권,1000211,천호대로45길,171,107,64
2016,1,A,골목상권,1000210,천호대로17길,2060,1287,773
2016,1,A,골목상권,1000209,천호대로12길,817,541,276
2016,1,A,골목상권,1000208,천장산로7길,1427,887,540
2016,1,A,골목상권,1000207,제기로5길,196,103,93
2016,1,A,골목상권,1000206,제기로21길,216,138,78
2016,1,A,골목상권,1000205,전농로4길,656,427,229
2016,1,A,골목상권,1000204,전농로3길,96,44,52
2016,1,A,골목상권,1000203,전농로29길,307,148,159
2016,1,A,골목상권,1000202,장한로8길,804,482,322
2016,1,A,골목상권,1000201,장한로5길,2857,1991,866
2016,1,A,골목상권,1000200,장한로27길,170,49,121
2016,1,A,골목상권,1000199,장한로27가길,394,197,197
2016,1,A,골목상권,1000198,장한로26길,568,289,279
2016,1,A,골목상권,1000197,장한로26가길,389,170,219
2016,1,A,골목상권,1000196,장한로25길,1000,428,572
2016,1,A,골목상권,1000195,장한로14길,187,158,29
2016,1,A,골목상권,1000194,이문로42길,235,87,148
2016,1,A,골목상권,1000193,왕산로43길,990,489,501
2016,1,A,골목상권,1000192,왕산로33길,175,121,54
2016,1,A,골목상권,1000191,왕산로32길,12,8,4
2016,1,A,골목상권,1000190,약령시로17길,260,137,123
2016,1,A,골목상권,1000189,서울시립대로4길,805,501,304
2016,1,A,골목상권,1000188,서울시립대로29길,234,135,99
2016,1,A,골목상권,1000187,서울시립대로16길,139,34,105
2016,1,A,골목상권,1000186,사가정로2길,81,66,15
2016,1,A,골목상권,1000185,사가정로23가길,116,69,47
2016,1,A,골목상권,1000184,사가정로13길,303,115,188
2016,1,A,골목상권,1000183,무학로45길,407,229,178
2016,1,A,골목상권,1000182,무학로16길,1106,982,124
2016,1,A,골목상권,1000181,망우로21길,187,106,81
2016,1,A,골목상권,1000180,망우로18길,529,216,313
2016,1,A,골목상권,1000179,망우로18가길,63,24,39
2016,1,A,골목상권,1000178,답십리로72길,14,11,3
2016,1,A,골목상권,1000177,답십리로69길,854,385,469
2016,1,A,골목상권,1000176,답십리로68길,172,109,63
2016,1,A,골목상권,1000175,답십리로64길,334,200,134
2016,1,A,골목상권,1000174,답십리로63길,109,65,44
2016,1,A,골목상권,1000173,답십리로60길,9,4,5
2016,1,A,골목상권,1000172,답십리로56길,8,6,2
2016,1,A,골목상권,1000171,답십리로23길,5,4,1
2016,1,A,골목상권,1000170,난계로30길,165,119,46
2016,1,A,골목상권,1000168,경희대로3길,268,165,103
2016,1,A,골목상권,1000167,천호대로129길,200,65,135
2016,1,A,골목상권,1000166,천호대로123길,369,156,213
2016,1,A,골목상권,1000165,천호대로109길,1236,696,540
2016,1,A,골목상권,1000164,자양번영로3길,94,38,56
2016,1,A,골목상권,1000162,자양로50길,20,5,15
2016,1,A,골목상권,1000161,자양로45길,540,295,245
2016,1,A,골목상권,1000160,자양로26길,328,107,221
2016,1,A,골목상권,1000159,자양로15길,435,249,186
2016,1,A,골목상권,1000158,자양로11길,1328,671,657
2016,1,A,골목상권,1000157,용마산로3길,806,444,362
2016,1,A,골목상권,1000156,용마산로21길,149,60,89
2016,1,A,골목상권,1000155,아차산로78길,1608,979,629
2016,1,A,골목상권,1000154,아차산로65길,705,460,245
2016,1,A,골목상권,1000153,아차산로55길,459,231,228
2016,1,A,골목상권,1000152,아차산로51길,272,149,123
2016,1,A,골목상권,1000151,아차산로40길,497,285,212
2016,1,A,골목상권,1000150,면목로17길,230,146,84
2016,1,A,골목상권,1000149,뚝섬로64길,400,232,168
2016,1,A,골목상권,1000148,뚝섬로58길,198,71,127
2016,1,A,골목상권,1000147,뚝섬로54길,148,87,61
2016,1,A,골목상권,1000146,뚝섬로48길,835,371,464
2016,1,A,골목상권,1000145,뚝섬로24길,106,38,68
2016,1,A,골목상권,1000144,뚝섬로23길,100,63,37
2016,1,A,골목상권,1000143,동일로24길,8,2,6
2016,1,A,골목상권,1000142,동일로18길,173,73,100
2016,1,A,골목상권,1000141,능동로4길,239,101,138
2016,1,A,골목상권,1000140,능동로3길,242,101,141
2016,1,A,골목상권,1000139,능동로34길,906,478,428
2016,1,A,골목상권,1000138,능동로19길,347,217,130
2016,1,A,골목상권,1000137,능동로13길,316,104,212
2016,1,A,골목상권,1000136,긴고랑로9길,72,33,39
2016,1,A,골목상권,1000135,긴고랑로8길,232,205,27
2016,1,A,골목상권,1000134,긴고랑로7길,516,249,267
2016,1,A,골목상권,1000133,긴고랑로20길,522,237,285
2016,1,A,골목상권,1000132,광나루로52길,1771,866,905
2016,1,A,골목상권,1000131,광나루로40길,82,41,41
2016,1,A,골목상권,1000130,광나루로37길,318,204,114
2016,1,A,골목상권,1000129,광나루로36길,41,26,15
2016,1,A,골목상권,1000128,광나루로24길,69,39,30
2016,1,A,골목상권,1000127,광나루로12길,914,537,377
2016,1,A,골목상권,1000126,한림말길,66,39,27
2016,1,A,골목상권,1000124,청계천로10나길,1746,1023,723
2016,1,A,골목상권,1000123,장터길,44,18,26
2016,1,A,골목상권,1000122,용답중앙길,77,47,30
2016,1,A,골목상권,1000121,용답29길,1911,987,924
2016,1,A,골목상권,1000120,왕십리로6길,1309,728,581
2016,1,A,골목상권,1000119,왕십리로31길,118,58,60
2016,1,A,골목상권,1000118,왕십리로26길,4148,2276,1872
2016,1,A,골목상권,1000117,왕십리로21길,151,42,109
2016,1,A,골목상권,1000116,왕십리로14길,2349,1789,560
2016,1,A,골목상권,1000115,아차산로5길,2190,1524,666
2016,1,A,골목상권,1000114,아차산로15길,3880,2773,1107
2016,1,A,골목상권,1000113,아차산로11길,3299,2174,1125
2016,1,A,골목상권,1000112,송정4가길,1025,481,544
2016,1,A,골목상권,1000111,송정12라길,251,163,88
2016,1,A,골목상권,1000110,성수일로6길,3115,1767,1348
2016,1,A,골목상권,1000109,성수이로7길,358,236,122
2016,1,A,골목상권,1000108,성수이로18길,2206,1574,632
2016,1,A,골목상권,1000107,성덕정길,641,411,230
2016,1,A,골목상권,1000106,성덕정17길,213,118,95
2016,1,A,골목상권,1000105,서울숲2길,1802,989,813
2016,1,A,골목상권,1000104,상원길,1615,1098,517
2016,1,A,골목상권,1000103,상원12길,181,110,71
2016,1,A,골목상권,1000102,사근동길,30,16,14
2016,1,A,골목상권,1000101,무학봉길,3,3,0
2016,1,A,골목상권,1000100,무학봉28길,157,67,90
2016,1,A,골목상권,1000099,무학로6길,347,213,134
2016,1,A,골목상권,1000098,무수막길,112,55,57
2016,1,A,골목상권,1000097,매봉길,31,19,12
2016,1,A,골목상권,1000096,마조로1길,183,70,113
2016,1,A,골목상권,1000095,마조로16길,773,534,239
2016,1,A,골목상권,1000094,마장로39길,69,40,29
2016,1,A,골목상권,1000093,마장로27길,99,41,58
2016,1,A,골목상권,1000091,둘레9길,406,237,169
2016,1,A,골목상권,1000090,금호산길,388,146,242
2016,1,A,골목상권,1000089,금호산2길,34,15,19
2016,1,A,골목상권,1000088,고산자로6길,15281,6321,8960
2016,1,A,골목상권,1000087,후암로28길,173,73,100
2016,1,A,골목상권,1000086,효창원로39길,53,34,19
2016,1,A,골목상권,1000085,회나무로13길,56,33,23
2016,1,A,골목상권,1000084,한남대로20길,670,380,290
2016,1,A,골목상권,1000082,한강대로7길,425,304,121
2016,1,A,골목상권,1000081,한강대로62길,685,489,196
2016,1,A,골목상권,1000080,한강대로52길,1178,776,402
2016,1,A,골목상권,1000079,한강대로43길,4631,3023,1608
2016,1,A,골목상권,1000078,한강대로15길,1910,431,1479
2016,1,A,골목상권,1000077,한강대로104길,4166,3032,1134
2016,1,A,골목상권,1000076,청파로73길,1315,755,560
2016,1,A,골목상권,1000075,청파로71길,240,125,115
2016,1,A,골목상권,1000074,청파로47나길,119,76,43
2016,1,A,골목상권,1000073,청파로47길,816,377,439
2016,1,A,골목상권,1000072,장문로45길,73,10,63
2016,1,A,골목상권,1000071,이태원로54길,1417,811,606
2016,1,A,골목상권,1000070,이태원로27길,501,290,211
2016,1,A,골목상권,1000069,이촌로22길,207,121,86
2016,1,A,골목상권,1000068,원효로89길,946,761,185
2016,1,A,골목상권,1000067,원효로53길,774,480,294
2016,1,A,골목상권,1000066,원효로41길,2729,1962,767
2016,1,A,골목상권,1000065,원효로19길,951,682,269
2016,1,A,골목상권,1000064,우사단로4길,165,122,43
2016,1,A,골목상권,1000063,우사단로14길,1676,926,750
2016,1,A,골목상권,1000062,우사단로10길,59,28,31
2016,1,A,골목상권,1000061,신흥로20길,183,90,93
2016,1,A,골목상권,1000060,소월로20길,130,44,86
2016,1,A,골목상권,1000059,서빙고로71길,426,250,176
2016,1,A,골목상권,1000058,백범로90길,272,158,114
2016,1,A,골목상권,1000057,백범로79길,963,580,383
2016,1,A,골목상권,1000056,두텁바위로1길,2451,1381,1070
2016,1,A,골목상권,1000055,대사관로34길,306,186,120
2016,1,A,골목상권,1000054,녹사평대로46길,42,30,12
2016,1,A,골목상권,1000053,녹사평대로40나길,34,17,17
2016,1,A,골목상권,1000052,녹사평대로32길,301,149,152
2016,1,A,골목상권,1000051,녹사평대로26길,2122,1195,927
2016,1,A,골목상권,1000050,녹사평대로11길,288,195,93
2016,1,A,골목상권,1000049,퇴계로90길,472,196,276
2016,1,A,골목상권,1000048,퇴계로8길,2326,1364,962
2016,1,A,골목상권,1000047,퇴계로56길,1029,822,207
2016,1,A,골목상권,1000046,퇴계로46길,1844,721,1123
2016,1,A,골목상권,1000045,퇴계로18길,2852,1327,1525
2016,1,A,골목상권,1000044,퇴계로12길,1047,475,572
2016,1,A,골목상권,1000043,청구로1길,193,92,101
2016,1,A,골목상권,1000042,청구로17길,1731,786,945
2016,1,A,골목상권,1000041,장충단로8길,3961,1236,2725
2016,1,A,골목상권,1000040,삼일대로4길,964,584,380
2016,1,A,골목상권,1000039,명동길,35442,17876,17566
2016,1,A,골목상권,1000037,동호로20길,883,401,482
2016,1,A,골목상권,1000036,동호로15길,4480,2457,2023
2016,1,A,골목상권,1000035,동호로11길,20,17,3
2016,1,A,골목상권,1000034,동호로10길,1477,655,822
2016,1,A,골목상권,1000033,다산로39길,1097,653,444
2016,1,A,골목상권,1000032,다산로38길,1689,936,753
2016,1,A,골목상권,1000031,다산로36길,58,31,27
2016,1,A,골목상권,1000030,다산로33길,391,189,202
2016,1,A,골목상권,1000029,난계로21길,203,134,69
2016,1,A,골목상권,1000028,난계로11길,2007,1090,917
2016,1,A,골목상권,1000026,평창길,164,72,92
2016,1,A,골목상권,1000025,통일로12길,236,106,130
2016,1,A,골목상권,1000024,창신길,257,70,187
2016,1,A,골목상권,1000023,창신5길,6,3,3
2016,1,A,골목상권,1000022,창신2길,63,31,32
2016,1,A,골목상권,1000021,창경궁로35길,1375,372,1003
2016,1,A,골목상권,1000020,지봉로8길,156,80,76
2016,1,A,골목상권,1000019,종로65길,679,307,372
2016,1,A,골목상권,1000016,자하문로7길,488,276,212
2016,1,A,골목상권,1000015,이화장길,2018,999,1019
2016,1,A,골목상권,1000014,율곡로16길,11,7,4
2016,1,A,골목상권,1000013,율곡로10길,2294,1702,592
2016,1,A,골목상권,1000012,옥인길,529,242,287
2016,1,A,골목상권,1000011,숭인동길,19,8,11
2016,1,A,골목상권,1000010,성균관로5길,121,74,47
2016,1,A,골목상권,1000009,삼청로5길,440,165,275
2016,1,A,골목상권,1000008,북촌로5나길,1510,1054,456
2016,1,A,골목상권,1000007,북촌로5길,55,23,32
2016,1,A,골목상권,1000006,북촌로11길,24,12,12
2016,1,A,골목상권,1000005,백석동길,95,50,45
2016,1,A,골목상권,1000004,명륜길,15,11,4
2016,1,A,골목상권,1000003,돈화문로11가길,1085,599,486
2016,1,A,골목상권,1000001,계동길,885,398,487
2015,4,U,관광특구,1001496,강남 마이스 관광특구,20413,11662,8751
2015,4,U,관광특구,1001495,잠실 관광특구,26362,15696,10666
2015,4,U,관광특구,1001494,종로?청계 관광특구,30380,18859,11521
2015,4,U,관광특구,1001493,동대문패션타운 관광특구,13572,9051,4521
2015,4,U,관광특구,1001492,명동 남대문 북창동 다동 무교동 관광특구,168354,84603,83751
2015,4,U,관광특구,1001491,이태원 관광특구,5551,3173,2378
2015,4,R,전통시장,1001490,길동복조리시장,564,343,221
2015,4,R,전통시장,1001489,둔촌역전통시장,147,73,74
2015,4,R,전통시장,1001488,성내골목시장,7,2,5
2015,4,R,전통시장,1001487,천호시장,18,10,8
2015,4,R,전통시장,1001483,암사종합시장,710,321,389
2015,4,R,전통시장,1001482,고덕전통시장,396,381,15
2015,4,R,전통시장,1001481,명일골목시장,400,118,282
2015,4,R,전통시장,1001480,새마을시장,311,169,142
2015,4,R,전통시장,1001479,석촌시장,175,110,65
2015,4,R,전통시장,1001478,방이시장,656,431,225
2015,4,R,전통시장,1001477,마천시장,240,54,186
2015,4,R,전통시장,1001476,풍납시장,14,4,10
2015,4,R,전통시장,1001475,강남개포시장,34,29,5
2015,4,R,전통시장,1001474,도곡시장,502,219,283
2015,4,R,전통시장,1001471,영동전통시장,3159,2351,808
2015,4,R,전통시장,1001466,미성동도깨비시장,413,180,233
2015,4,R,전통시장,1001464,삼성동시장,57,27,30
2015,4,R,전통시장,1001463,신림중앙시장,18,10,8
2015,4,R,전통시장,1001462,강남골목시장,246,134,112
2015,4,R,전통시장,1001460,관악신사시장,341,266,75
2015,4,R,전통시장,1001459,신원시장,341,144,197
2015,4,R,전통시장,1001458,인헌시장,232,78,154
2015,4,R,전통시장,1001456,봉천현대시장,15,6,9
2015,4,R,전통시장,1001454,봉천제일종합시장,45,24,21
2015,4,R,전통시장,1001453,낙성대시장,18,11,7
2015,4,R,전통시장,1001452,중부시장,153,52,101
2015,4,R,전통시장,1001450,남성역골목시장,496,238,258
2015,4,R,전통시장,1001449,남성사계시장,1905,885,1020
2015,4,R,전통시장,1001448,흑석시장,174,67,107
2015,4,R,전통시장,1001447,상도4동도깨비골목시장,328,89,239
2015,4,R,전통시장,1001445,영도시장,87,37,50
2015,4,R,전통시장,1001441,본동인정시장,111,52,59
2015,4,R,전통시장,1001439,대림중앙시장,26,18,8
2015,4,R,전통시장,1001438,우리시장,15,5,10
2015,4,R,전통시장,1001437,영진시장A동,37,33,4
2015,4,R,전통시장,1001433,영일시장,2,2,0
2015,4,R,전통시장,1001431,영등포청과시장,137,83,54
2015,4,R,전통시장,1001430,영등포전통시장,4051,2015,2036
2015,4,R,전통시장,1001429,은행나무시장,43,10,33
2015,4,R,전통시장,1001427,현대시장,59,17,42
2015,4,R,전통시장,1001424,남문시장,312,120,192
2015,4,R,전통시장,1001423,독산동 우시장,140,58,82
2015,4,R,전통시장,1001421,개봉중앙시장,7,3,4
2015,4,R,전통시장,1001419,가리봉시장,16,9,7
2015,4,R,전통시장,1001418,남구로시장,5,2,3
2015,4,R,전통시장,1001417,구로시장,46,19,27
2015,4,R,전통시장,1001415,방신전통시장,137,116,21
2015,4,R,전통시장,1001414,송화골목시장,485,180,305
2015,4,R,전통시장,1001413,까치산시장,28,18,10
2015,4,R,전통시장,1001411,남부골목시장,174,78,96
2015,4,R,전통시장,1001409,화곡중앙골목시장,2,2,0
2015,4,R,전통시장,1001407,등마루시장,728,448,280
2015,4,R,전통시장,1001406,신정3동골목시장,248,106,142
2015,4,R,전통시장,1001405,신정2동골목시장,8,6,2
2015,4,R,전통시장,1001402,신월6동골목시장,266,120,146
2015,4,R,전통시장,1001401,신곡종합시장,13,10,3
2015,4,R,전통시장,1001400,신월3동골목시장,55,15,40
2015,4,R,전통시장,1001399,경창시장,190,81,109
2015,4,R,전통시장,1001398,월정로시장,104,57,47
2015,4,R,전통시장,1001397,신영시장,49,25,24
2015,4,R,전통시장,1001396,목4동시장,250,88,162
2015,4,R,전통시장,1001395,목3동시장,700,346,354
2015,4,R,전통시장,1001394,목2동시장,198,98,100
2015,4,R,전통시장,1001393,마포농수산물시장,492,312,180
2015,4,R,전통시장,1001391,망원월드컵시장,17,11,6
2015,4,R,전통시장,1001390,망원시장,33,17,16
2015,4,R,전통시장,1001386,신수시장,123,99,24
2015,4,R,전통시장,1001385,아현시장,21,3,18
2015,4,R,전통시장,1001374,대림골목시장,299,95,204
2015,4,R,전통시장,1001367,상계중앙시장,27,11,16
2015,4,R,전통시장,1001364,방학동도깨비시장,131,55,76
2015,4,R,전통시장,1001363,쌍문역골목시장,58,26,32
2015,4,R,전통시장,1001361,신도봉시장,26,16,10
2015,4,R,전통시장,1001359,창동신창시장,130,55,75
2015,4,R,전통시장,1001358,수유북부시장,13,3,10
2015,4,R,전통시장,1001357,장미원골목시장,73,51,22
2015,4,R,전통시장,1001356,수유중앙시장,130,71,59
2015,4,R,전통시장,1001355,강북종합시장,60,24,36
2015,4,R,전통시장,1001354,우이시장,148,63,85
2015,4,R,전통시장,1001353,수유전통시장,451,139,312
2015,4,R,전통시장,1001352,번동북부골목시장,88,54,34
2015,4,R,전통시장,1001351,솔샘시장,105,41,64
2015,4,R,전통시장,1001349,방천골목시장,84,28,56
2015,4,R,전통시장,1001347,석관황금시장,52,42,10
2015,4,R,전통시장,1001343,장위전통시장,178,66,112
2015,4,R,전통시장,1001340,정릉시장,35,14,21
2015,4,R,전통시장,1001339,정릉아리랑시장,8,5,3
2015,4,R,전통시장,1001338,돈암제일시장,77,39,38
2015,4,R,전통시장,1001336,우림골목시장,222,105,117
2015,4,R,전통시장,1001335,묵1동도깨비시장,266,111,155
2015,4,R,전통시장,1001334,태능시장,4,3,1
2015,4,R,전통시장,1001333,중화제일시장,23,1,22
2015,4,R,전통시장,1001332,사가정시장,257,191,66
2015,4,R,전통시장,1001330,동원시장,53,22,31
2015,4,R,전통시장,1001329,동부골목시장,83,28,55
2015,4,R,전통시장,1001326,회기시장,120,48,72
2015,4,R,전통시장,1001323,답십리시장,24,7,17
2015,4,R,전통시장,1001321,답십리현대시장,99,72,27
2015,4,R,전통시장,1001319,청량리종합시장,6,4,2
2015,4,R,전통시장,1001317,청량리농수산물시장,15,13,2
2015,4,R,전통시장,1001316,서울약령시장,1359,862,497
2015,4,R,전통시장,1001313,청량리수산시장,196,104,92
2015,4,R,전통시장,1001310,구의시장,99,57,42
2015,4,R,전통시장,1001309,조양시장,75,39,36
2015,4,R,전통시장,1001308,영동교골목시장,26,18,8
2015,4,R,전통시장,1001307,능동로골목시장,292,272,20
2015,4,R,전통시장,1001304,자양골목시장,93,49,44
2015,4,R,전통시장,1001301,중곡제일시장,140,74,66
2015,4,R,전통시장,1001299,한아름시장,114,63,51
2015,4,R,전통시장,1001298,성동용답상가시장,277,143,134
2015,4,R,전통시장,1001297,뚝도시장,31,13,18
2015,4,R,전통시장,1001296,금남시장,22,12,10
2015,4,R,전통시장,1001295,행당시장,219,118,101
2015,4,R,전통시장,1001294,마장축산물시장,1569,1052,517
2015,4,R,전통시장,1001289,용문전통시장,25,14,11
2015,4,R,전통시장,1001286,후암시장,39,16,23
2015,4,R,전통시장,1001285,합동(새벽)시장,2374,1285,1089
2015,4,R,전통시장,1001284,서울중앙시장,227,151,76
2015,4,R,전통시장,1001283,백학시장,445,237,208
2015,4,R,전통시장,1001282,약수시장,1580,599,981
2015,4,R,전통시장,1001281,청평화시장,2653,1742,911
2015,4,R,전통시장,1001280,제일평화시장,454,291,163
2015,4,R,전통시장,1001278,남평화시장,163,106,57
2015,4,R,전통시장,1001277,방산종합시장,1815,1185,630
2015,4,R,전통시장,1001275,인현시장,1202,775,427
2015,4,R,전통시장,1001274,신중부시장,2420,1612,808
2015,4,R,전통시장,1001273,남대문시장,7064,3772,3292
2015,4,R,전통시장,1001271,동묘시장,924,601,323
2015,4,R,전통시장,1001270,창신골목시장,225,123,102
2015,4,R,전통시장,1001268,충신시장,340,202,138
2015,4,R,전통시장,1001267,종로신진시장,31,14,17
2015,4,R,전통시장,1001266,동대문종합시장,240,147,93
2015,4,R,전통시장,1001265,광장시장,213,150,63
2015,4,D,발달상권,1001263,서울 노원구 노원역_3,797,330,467
2015,4,D,발달상권,1001261,서울 노원구 노원역_1,982,310,672
2015,4,D,발달상권,1001260,창동역,2395,1568,827
2015,4,D,발달상권,1001259,서울 강북구 수유역_3,58,30,28
2015,4,D,발달상권,1001257,서울 강북구 수유역_2,4168,2160,2008
2015,4,D,발달상권,1001256,서울 강북구 수유역_1,120,95,25
2015,4,D,발달상권,1001255,서울 은평구 연신내역_3,598,198,400
2015,4,D,발달상권,1001254,서울 은평구 연신내역_2,378,157,221
2015,4,D,발달상권,1001253,서울 은평구 연신내역_1,76,38,38
2015,4,D,발달상권,1001252,서울 성북구 미아삼거리역_2,502,225,277
2015,4,D,발달상권,1001251,서울 강북구 미아삼거리역_1,462,163,299
2015,4,D,발달상권,1001250,서울 은평구 불광역_3,45,13,32
2015,4,D,발달상권,1001249,서울 은평구 불광역_2,71,26,45
2015,4,D,발달상권,1001248,서울 은평구 불광역_1,253,116,137
2015,4,D,발달상권,1001247,미아사거리_2,134,67,67
2015,4,D,발달상권,1001246,미아사거리_1,570,268,302
2015,4,D,발달상권,1001245,서울 성북구 성신여대입구역,4909,3017,1892
2015,4,D,발달상권,1001244,경희대학교,351,157,194
2015,4,D,발달상권,1001243,서울 성북구 안암역,83,50,33
2015,4,D,발달상권,1001242,혜화역 대학로_3,1690,809,881
2015,4,D,발달상권,1001241,혜화역 대학로_2,1393,814,579
2015,4,D,발달상권,1001240,혜화역 대학로_1,1256,631,625
2015,4,D,발달상권,1001239,디지털미디어시티,21515,12932,8583
2015,4,D,발달상권,1001238,서울 동대문구 청량리역,3146,2021,1125
2015,4,D,발달상권,1001236,서울 종로구 안국역_2,755,288,467
2015,4,D,발달상권,1001235,서울 종로구 안국역_1,11904,9790,2114
2015,4,D,발달상권,1001234,서울 종로구 경복궁역_1,231,91,140
2015,4,D,발달상권,1001233,서울 종로구 종로3가역_3,3114,1728,1386
2015,4,D,발달상권,1001232,서울 종로구 종로3가역_2,1812,1014,798
2015,4,D,발달상권,1001231,서울 동대문구 신설동역_2,4296,2180,2116
2015,4,D,발달상권,1001230,인사동,21966,13787,8179
2015,4,D,발달상권,1001229,서울 종로구 종로5가역_4,662,361,301
2015,4,D,발달상권,1001228,서울 종로구 종로5가역_3,5333,3619,1714
2015,4,D,발달상권,1001227,종로구청,14751,8665,6086
2015,4,D,발달상권,1001226,서울 종로구 종로5가역_2,14106,8861,5245
2015,4,D,발달상권,1001225,신설동역,729,448,281
2015,4,D,발달상권,1001224,서울 동대문구 신설동역_1,2,2,0
2015,4,D,발달상권,1001223,서울 종로구 광화문역_2,53651,33301,20350
2015,4,D,발달상권,1001222,동묘앞역,69,43,26
2015,4,D,발달상권,1001221,장안동사거리,552,265,287
2015,4,D,발달상권,1001220,서울 종로구 동대문역_2,1054,577,477
2015,4,D,발달상권,1001218,동대문시장_2,496,323,173
2015,4,D,발달상권,1001217,서울 종로구 종로5가역_1,51,37,14
2015,4,D,발달상권,1001216,서울 종로구 종로3가역_1,3427,1529,1898
2015,4,D,발달상권,1001215,서울 종로구 광화문역_1,2337,1584,753
2015,4,D,발달상권,1001214,종각역,20802,13736,7066
2015,4,D,발달상권,1001213,종각역 젊음의 거리,2020,921,1099
2015,4,D,발달상권,1001212,서대문구 서대문역_1,384,262,122
2015,4,D,발달상권,1001211,동대문시장_1,428,238,190
2015,4,D,발달상권,1001210,시청역_2,23527,14744,8783
2015,4,D,발달상권,1001209,서울시청,26181,12363,13818
2015,4,D,발달상권,1001208,서울 중구 을지로3가역_2,8769,5651,3118
2015,4,D,발달상권,1001207,서울 중구 신당역_2,1266,655,611
2015,4,D,발달상권,1001206,서대문구 서대문역_2,1999,1346,653
2015,4,D,발달상권,1001205,동대문역사문화공원역,4141,2978,1163
2015,4,D,발달상권,1001204,서울 중구 을지로3가역_1,14260,9716,4544
2015,4,D,발달상권,1001203,명동거리,26062,12172,13890
2015,4,D,발달상권,1001202,롯데백화점,40444,22933,17511
2015,4,D,발달상권,1001201,서울 중구 신당역_1,1100,687,413
2015,4,D,발달상권,1001200,북창동,7518,4748,2770
2015,4,D,발달상권,1001199,서울 중구 충무로역_2,16829,7381,9448
2015,4,D,발달상권,1001198,서울 강서구 송정역,682,482,200
2015,4,D,발달상권,1001197,장한평역_2,12116,9714,2402
2015,4,D,발달상권,1001196,시청역_1,65736,38240,27496
2015,4,D,발달상권,1001195,왕십리역_2,718,322,396
2015,4,D,발달상권,1001194,서울 강서구 발산역,681,417,264
2015,4,D,발달상권,1001193,장한평역_1,2460,1628,832
2015,4,D,발달상권,1001192,서울 중구 충무로역_1,3092,2078,1014
2015,4,D,발달상권,1001190,장한평역,2347,1629,718
2015,4,D,발달상권,1001189,서울 중구 명동역,3485,1809,1676
2015,4,D,발달상권,1001188,장충동 족발거리,204,90,114
2015,4,D,발달상권,1001187,한양시장,253,115,138
2015,4,D,발달상권,1001186,서울 서대문구 이대역,1171,463,708
2015,4,D,발달상권,1001185,서울 서대문구 신촌역,2563,1052,1511
2015,4,D,발달상권,1001184,서울 마포구 홍대입구역_3,722,592,130
2015,4,D,발달상권,1001183,서울 마포구 홍대입구역_2,2801,1132,1669
2015,4,D,발달상권,1001182,홍익대학교 주변,14466,7280,7186
2015,4,D,발달상권,1001181,서울 광진구 군자역,163,101,62
2015,4,D,발달상권,1001180,신촌역,207,108,99
2015,4,D,발달상권,1001179,강서구청,3431,2220,1211
2015,4,D,발달상권,1001178,서울 마포구 홍대입구역_1,720,411,309
2015,4,D,발달상권,1001175,서울 강동구 고덕역,493,286,207
2015,4,D,발달상권,1001173,서울 강동구 명일역,848,324,524
2015,4,D,발달상권,1001172,어린이대공원역,139,94,45
2015,4,D,발달상권,1001171,서울 마포구 공덕역_2,3907,2319,1588
2015,4,D,발달상권,1001170,공덕역,6742,4222,2520
2015,4,D,발달상권,1001169,서울 용산구 숙대입구역,4350,3094,1256
2015,4,D,발달상권,1001168,남영역,14337,6498,7839
2015,4,D,발달상권,1001167,서울 마포구 공덕역_1,4255,2117,2138
2015,4,D,발달상권,1001166,서울 마포구 마포역_2,964,561,403
2015,4,D,발달상권,1001165,서울 광진구 건대입구역_2,2725,988,1737
2015,4,D,발달상권,1001164,서울 마포구 마포역_1,10554,6415,4139
2015,4,D,발달상권,1001163,서울 강동구 천호역_2,3676,1846,1830
2015,4,D,발달상권,1001162,서울 광진구 건대입구역_1,930,474,456
2015,4,D,발달상권,1001161,건대입구역,781,411,370
2015,4,D,발달상권,1001160,서울 광진구 구의역,867,536,331
2015,4,D,발달상권,1001159,서울 강동구 천호역,973,447,526
2015,4,D,발달상권,1001158,당산역_2,5049,3064,1985
2015,4,D,발달상권,1001156,서울 강동구 길동역,1552,1015,537
2015,4,D,발달상권,1001155,용산 전자상가_5,2249,1648,601
2015,4,D,발달상권,1001153,당산역_1,1109,711,398
2015,4,D,발달상권,1001152,서울 광진구 강변역,2212,1810,402
2015,4,D,발달상권,1001151,용산 전자상가_3,2497,1827,670
2015,4,D,발달상권,1001150,서울 용산구 이태원역,703,432,271
2015,4,D,발달상권,1001149,한남오거리,610,327,283
2015,4,D,발달상권,1001147,용산 전자상가_2,494,399,95
2015,4,D,발달상권,1001146,용산구청,101,71,30
2015,4,D,발달상권,1001145,용산 전자상가_1,8205,6282,1923
2015,4,D,발달상권,1001144,국회의사당역_2,40118,22728,17390
2015,4,D,발달상권,1001143,서울 용산구 신용산역,311,125,186
2015,4,D,발달상권,1001142,국회의사당역_1,5670,4378,1292
2015,4,D,발달상권,1001141,압구정 로데오거리_2,14341,6032,8309
2015,4,D,발달상권,1001140,서울 강남구 압구정역,10450,4987,5463
2015,4,D,발달상권,1001139,서울 영등포구 영등포구청역,3674,1149,2525
2015,4,D,발달상권,1001138,압구정 로데오거리_1,7548,2500,5048
2015,4,D,발달상권,1001137,서울 강동구 둔촌동역,47,14,33
2015,4,D,발달상권,1001136,오목교역,211,106,105
2015,4,D,발달상권,1001135,신사동 가로수길,21175,9945,11230
2015,4,D,발달상권,1001134,서울 영등포구 여의도역_2,47922,31723,16199
2015,4,D,발달상권,1001133,청담사거리_3,1274,424,850
2015,4,D,발달상권,1001132,영등포유통상가,1975,1272,703
2015,4,D,발달상권,1001131,청담역_2,1365,996,369
2015,4,D,발달상권,1001130,청담역_1,245,182,63
2015,4,D,발달상권,1001129,청담사거리_2,1026,808,218
2015,4,D,발달상권,1001127,서울 영등포구 여의도역_1,52600,31128,21472
2015,4,D,발달상권,1001125,학동사거리_2,2822,1608,1214
2015,4,D,발달상권,1001124,서울 영등포구 영등포시장역,349,279,70
2015,4,D,발달상권,1001123,학동사거리_1,4027,2009,2018
2015,4,D,발달상권,1001122,여의도 시범아파트앞,2428,1582,846
2015,4,D,발달상권,1001121,영등포역_3,851,508,343
2015,4,D,발달상권,1001120,도산공원사거리_1,9818,5857,3961
2015,4,D,발달상권,1001119,영등포역_2,1076,582,494
2015,4,D,발달상권,1001118,문래동 주민센터,66,56,10
2015,4,D,발달상권,1001117,강남구 신사역_2,7283,4812,2471
2015,4,D,발달상권,1001115,서울 강남구 강남구청역_2,3940,2444,1496
2015,4,D,발달상권,1001114,강남구 신사역_1,2553,1171,1382
2015,4,D,발달상권,1001113,서울 동작구 노량진1동_1,36,26,10
2015,4,D,발달상권,1001112,서울 강남구 학동역_3,8474,4970,3504
2015,4,D,발달상권,1001111,서울 강남구 강남구청역_1,2950,1693,1257
2015,4,D,발달상권,1001110,잠실역,5964,4585,1379
2015,4,D,발달상권,1001109,강남구 논현역_4,8114,3632,4482
2015,4,D,발달상권,1001108,학동역,843,420,423
2015,4,D,발달상권,1001107,방이동 먹자골목,5729,3810,1919
2015,4,D,발달상권,1001106,서울 강남구 학동역_2,5870,2854,3016
2015,4,D,발달상권,1001105,서울 동작구 노량진역,3620,2082,1538
2015,4,D,발달상권,1001104,삼성역_3,8416,4875,3541
2015,4,D,발달상권,1001103,코엑스,20413,11662,8751
2015,4,D,발달상권,1001102,서울 강남구 학동역_1,5642,3488,2154
2015,4,D,발달상권,1001101,선정릉역_2,6466,4051,2415
2015,4,D,발달상권,1001100,강남구 논현역_3,1534,861,673
2015,4,D,발달상권,1001099,포스코사거리_2,7212,4325,2887
2015,4,D,발달상권,1001098,포스코사거리_1,51969,34731,17238
2015,4,D,발달상권,1001097,잠실역 롯데월드,3297,1640,1657
2015,4,D,발달상권,1001096,신도림역,3669,2005,1664
2015,4,D,발달상권,1001095,강남구 논현역_2,7962,3773,4189
2015,4,D,발달상권,1001094,선정릉역_1,1602,1094,508
2015,4,D,발달상권,1001093,신천역,5911,3248,2663
2015,4,D,발달상권,1001092,강남구 논현역_1,2974,1984,990
2015,4,D,발달상권,1001091,삼성역_2,17660,10419,7241
2015,4,D,발달상권,1001090,삼정역_2,2635,1188,1447
2015,4,D,발달상권,1001089,삼정역_1,2956,1594,1362
2015,4,D,발달상권,1001088,삼성역_1,28464,18481,9983
2015,4,D,발달상권,1001087,서울 강남구 선릉역_2,7162,4492,2670
2015,4,D,발달상권,1001086,고속터미널역,15243,4725,10518
2015,4,D,발달상권,1001085,서울 서초구 강남역,33448,19141,14307
2015,4,D,발달상권,1001084,서울 강남구 선릉역_1,19188,8450,10738
2015,4,D,발달상권,1001082,선릉역_2,20279,11010,9269
2015,4,D,발달상권,1001081,서울 강남구 역삼역_2,27201,21335,5866
2015,4,D,발달상권,1001080,서울 송파구 석촌역_1,43,29,14
2015,4,D,발달상권,1001078,서울 강남구 강남역_2,6537,4247,2290
2015,4,D,발달상권,1001077,선릉역_1,57431,29571,27860
2015,4,D,발달상권,1001076,구로역,160,91,69
2015,4,D,발달상권,1001075,역삼역_2,3939,2184,1755
2015,4,D,발달상권,1001074,대림역_2,7164,5491,1673
2015,4,D,발달상권,1001073,서울 강남구 역삼역_1,25489,16152,9337
2015,4,D,발달상권,1001072,신대방삼거리역,312,163,149
2015,4,D,발달상권,1001071,서울 강남구 한티역,1236,465,771
2015,4,D,발달상권,1001070,은마아파트입구사거리_4,82,45,37
2015,4,D,발달상권,1001067,오류동역,1444,724,720
2015,4,D,발달상권,1001066,서울 강남구 강남역,38860,18331,20529
2015,4,D,발달상권,1001063,교대역_4,4898,2895,2003
2015,4,D,발달상권,1001062,서울 강남구 강남역_1,136304,99464,36840
2015,4,D,발달상권,1001061,방배동카페골목,111,42,69
2015,4,D,발달상권,1001060,가락시장,15738,10117,5621
2015,4,D,발달상권,1001059,교대역_3,4466,2764,1702
2015,4,D,발달상권,1001058,역삼역_1,1760,955,805
2015,4,D,발달상권,1001057,교대역_2,3563,2279,1284
2015,4,D,발달상권,1001056,서울 송파구 가락시장역,5278,3419,1859
2015,4,D,발달상권,1001055,서울 서초구 서초역,11731,4924,6807
2015,4,D,발달상권,1001054,서울 강남구 대치역_2,1371,876,495
2015,4,D,발달상권,1001052,뱅뱅사거리_2,23374,14912,8462
2015,4,D,발달상권,1001051,보라매공원,14487,8365,6122
2015,4,D,발달상권,1001050,교대역_1,13110,7749,5361
2015,4,D,발달상권,1001049,개봉동 현대아파트 인근,162,74,88
2015,4,D,발달상권,1001048,뱅뱅사거리,10129,7003,3126
2015,4,D,발달상권,1001047,뱅뱅사거리_1,9886,7034,2852
2015,4,D,발달상권,1001046,서울 관악구 신림역_4,813,404,409
2015,4,D,발달상권,1001045,동작구 총신대입구역_1,222,109,113
2015,4,D,발달상권,1001044,양재역_3,3312,2304,1008
2015,4,D,발달상권,1001043,동작구 총신대입구역_2,850,383,467
2015,4,D,발달상권,1001042,서울 서초구 남부터미널역_3,1707,999,708
2015,4,D,발달상권,1001041,서울 강남구 수서역,18371,10610,7761
2015,4,D,발달상권,1001039,서울 서초구 남부터미널역_2,11583,5674,5909
2015,4,D,발달상권,1001038,구로디지탈1단지,64770,41847,22923
2015,4,D,발달상권,1001037,양재역,128,68,60
2015,4,D,발달상권,1001035,매봉역,338,155,183
2015,4,D,발달상권,1001034,서울 서초구 방배역,3749,2211,1538
2015,4,D,발달상권,1001033,서울 서초구 남부터미널역_1,740,530,210
2015,4,D,발달상권,1001032,서울 관악구 신림역_2,29,15,14
2015,4,D,발달상권,1001031,서울 관악구 신림역_1,1951,913,1038
2015,4,D,발달상권,1001030,양재역_2,8441,4680,3761
2015,4,D,발달상권,1001029,양재역_1,950,665,285
2015,4,D,발달상권,1001028,서울 관악구 서울대입구역_2,40,4,36
2015,4,D,발달상권,1001027,가산디지털단지역_3,31398,18928,12470
2015,4,D,발달상권,1001026,구로디지털단지역,1947,1297,650
2015,4,D,발달상권,1001025,서울 관악구 서울대입구역_1,1896,810,1086
2015,4,D,발달상권,1001024,관악구 사당역_1,3870,1606,2264
2015,4,D,발달상권,1001023,가산디지털단지역_2,61769,37010,24759
2015,4,D,발달상권,1001022,관악구 사당역_2,390,194,196
2015,4,D,발달상권,1001021,가산디지털단지역_1,24498,16480,8018
2015,4,D,발달상권,1001020,장지역,3954,2503,1451
2015,4,D,발달상권,1001019,포이사거리_1,5643,3083,2560
2015,4,D,발달상권,1001018,포이사거리_2,7827,5282,2545
2015,4,D,발달상권,1001016,서울 관악구 대학동_1,81,49,32
2015,4,D,발달상권,1001015,서울 금천구 독산1동_1,2987,2109,878
2015,4,D,발달상권,1001013,양재 화물트럭터미널앞_2,202,96,106
2015,4,D,발달상권,1001012,양재 화물트럭터미널앞_1,4112,3239,873
2015,4,D,발달상권,1001011,서울 금천구 시흥1동_4,931,480,451
2015,4,A,골목상권,1001010,풍성로37가길,45,21,24
2015,4,A,골목상권,1001009,천호옛길,561,394,167
2015,4,A,골목상권,1001008,천호옛14길,594,288,306
2015,4,A,골목상권,1001007,천호대로219길,886,519,367
2015,4,A,골목상권,1001006,천호대로197길,19,6,13
2015,4,A,골목상권,1001005,천호대로187길,847,499,348
2015,4,A,골목상권,1001004,천호대로170길,407,157,250
2015,4,A,골목상권,1001003,천호대로162길,1107,752,355
2015,4,A,골목상권,1001002,천중로51길,413,228,185
2015,4,A,골목상권,1001001,천중로39길,616,213,403
2015,4,A,골목상권,1001000,진황도로47길,1139,584,555
2015,4,A,골목상권,1000999,진황도로27길,444,267,177
2015,4,A,골목상권,1000998,올림픽로98길,42,23,19
2015,4,A,골목상권,1000997,올림픽로80길,5,3,2
2015,4,A,골목상권,1000995,올림픽로77길,8,6,2
2015,4,A,골목상권,1000994,올림픽로71길,408,305,103
2015,4,A,골목상권,1000993,올림픽로48길,5859,3559,2300
2015,4,A,골목상권,1000992,양재대로96길,1370,827,543
2015,4,A,골목상권,1000991,양재대로95길,624,339,285
2015,4,A,골목상권,1000990,양재대로91길,1082,579,503
2015,4,A,골목상권,1000989,양재대로133길,311,117,194
2015,4,A,골목상권,1000988,양재대로124길,566,328,238
2015,4,A,골목상권,1000987,양재대로116길,220,93,127
2015,4,A,골목상권,1000986,양재대로101길,1324,730,594
2015,4,A,골목상권,1000985,암사길,383,168,215
2015,4,A,골목상권,1000984,성안로3길,1545,994,551
2015,4,A,골목상권,1000983,성내로5길,981,517,464
2015,4,A,골목상권,1000982,상일로5길,54,31,23
2015,4,A,골목상권,1000981,상암로5길,456,194,262
2015,4,A,골목상권,1000980,상암로51길,711,314,397
2015,4,A,골목상권,1000979,상암로4길,227,176,51
2015,4,A,골목상권,1000978,상암로14길,418,257,161
2015,4,A,골목상권,1000977,명일로13길,127,52,75
2015,4,A,골목상권,1000976,동남로85길,121,59,62
2015,4,A,골목상권,1000975,동남로82길,11,4,7
2015,4,A,골목상권,1000974,동남로65길,90,33,57
2015,4,A,골목상권,1000973,구천면로42길,338,166,172
2015,4,A,골목상권,1000972,구천면로41길,609,248,361
2015,4,A,골목상권,1000971,구천면로36길,67,42,25
2015,4,A,골목상권,1000969,고덕로25길,10,8,2
2015,4,A,골목상권,1000968,고덕로10길,184,92,92
2015,4,A,골목상권,1000967,강동대로53길,846,461,385
2015,4,A,골목상권,1000966,풍성로25길,874,373,501
2015,4,A,골목상권,1000965,오금로46길,1381,708,673
2015,4,A,골목상권,1000964,오금로36길,1712,1360,352
2015,4,A,골목상권,1000963,오금로11길,2155,1391,764
2015,4,A,골목상권,1000962,양재대로72길,835,494,341
2015,4,A,골목상권,1000961,양재대로71길,1168,703,465
2015,4,A,골목상권,1000960,양재대로64길,1423,577,846
2015,4,A,골목상권,1000959,양재대로62길,6032,3658,2374
2015,4,A,골목상권,1000958,송파대로30길,1662,1067,595
2015,4,A,골목상권,1000957,송이로36길,1914,1398,516
2015,4,A,골목상권,1000956,송이로32길,789,430,359
2015,4,A,골목상권,1000955,송이로23길,1305,807,498
2015,4,A,골목상권,1000954,삼전로13길,1777,946,831
2015,4,A,골목상권,1000953,백제고분로50길,3143,1555,1588
2015,4,A,골목상권,1000952,백제고분로46길,1619,1004,615
2015,4,A,골목상권,1000951,백제고분로45길,468,318,150
2015,4,A,골목상권,1000950,백제고분로42길,116,74,42
2015,4,A,골목상권,1000949,백제고분로39길,1416,1046,370
2015,4,A,골목상권,1000948,백제고분로34길,1648,1085,563
2015,4,A,골목상권,1000947,백제고분로33길,862,555,307
2015,4,A,골목상권,1000946,백제고분로32길,1063,452,611
2015,4,A,골목상권,1000945,백제고분로31길,334,215,119
2015,4,A,골목상권,1000944,백제고분로22길,1098,658,440
2015,4,A,골목상권,1000943,백제고분로21길,191,133,58
2015,4,A,골목상권,1000942,마천로51길,132,49,83
2015,4,A,골목상권,1000941,동남로20길,168,91,77
2015,4,A,골목상권,1000940,거마로20길,411,182,229
2015,4,A,골목상권,1000939,학동로77길,2957,1533,1424
2015,4,A,골목상권,1000938,학동로6길,1856,1007,849
2015,4,A,골목상권,1000937,학동로56길,948,548,400
2015,4,A,골목상권,1000936,학동로38길,7102,4600,2502
2015,4,A,골목상권,1000935,테헤란로81길,665,211,454
2015,4,A,골목상권,1000934,일원로9길,468,268,200
2015,4,A,골목상권,1000933,일원로3길,242,115,127
2015,4,A,골목상권,1000932,영동대로65길,3256,1948,1308
2015,4,A,골목상권,1000931,영동대로112길,758,522,236
2015,4,A,골목상권,1000930,언주로81길,8439,3979,4460
2015,4,A,골목상권,1000929,압구정로2길,2630,1415,1215
2015,4,A,골목상권,1000928,선릉로18길,395,223,172
2015,4,A,골목상권,1000927,선릉로146길,1832,957,875
2015,4,A,골목상권,1000926,선릉로133길,150,82,68
2015,4,A,골목상권,1000925,선릉로132길,1004,534,470
2015,4,A,골목상권,1000924,선릉로121길,1710,909,801
2015,4,A,골목상권,1000923,삼성로75길,2547,1351,1196
2015,4,A,골목상권,1000922,삼성로69길,273,152,121
2015,4,A,골목상권,1000921,삼성로64길,628,319,309
2015,4,A,골목상권,1000920,삼성로63길,152,68,84
2015,4,A,골목상권,1000919,삼성로57길,877,279,598
2015,4,A,골목상권,1000918,삼성로147길,907,359,548
2015,4,A,골목상권,1000917,삼성로115길,246,150,96
2015,4,A,골목상권,1000916,봉은사로68길,231,126,105
2015,4,A,골목상권,1000915,봉은사로57길,590,409,181
2015,4,A,골목상권,1000914,봉은사로43길,1048,706,342
2015,4,A,골목상권,1000913,봉은사로29길,148,99,49
2015,4,A,골목상권,1000912,봉은사로109길,295,168,127
2015,4,A,골목상권,1000911,도산대로89길,2731,1055,1676
2015,4,A,골목상권,1000910,도산대로81길,4613,1463,3150
2015,4,A,골목상권,1000909,도산대로50길,2684,1862,822
2015,4,A,골목상권,1000908,도산대로38길,170,88,82
2015,4,A,골목상권,1000907,도산대로30길,2971,1396,1575
2015,4,A,골목상권,1000906,도산대로23길,1455,871,584
2015,4,A,골목상권,1000905,도산대로15길,1708,790,918
2015,4,A,골목상권,1000904,도곡로37길,3274,2182,1092
2015,4,A,골목상권,1000903,논현로8길,795,418,377
2015,4,A,골목상권,1000902,논현로63길,9719,2785,6934
2015,4,A,골목상권,1000901,논현로28길,12742,9090,3652
2015,4,A,골목상권,1000900,논현로26길,6849,4269,2580
2015,4,A,골목상권,1000898,논현로139길,2146,1239,907
2015,4,A,골목상권,1000897,논현로123길,109,63,46
2015,4,A,골목상권,1000896,논현로115길,2983,1694,1289
2015,4,A,골목상권,1000895,논현로10길,2469,1656,813
2015,4,A,골목상권,1000894,논현로106길,2763,1574,1189
2015,4,A,골목상권,1000893,남부순환로365길,182,135,47
2015,4,A,골목상권,1000891,개포로28길,300,220,80
2015,4,A,골목상권,1000890,개포로20길,4197,2384,1813
2015,4,A,골목상권,1000889,개포로17길,2694,1749,945
2015,4,A,골목상권,1000888,강남대로140길,4530,2545,1985
2015,4,A,골목상권,1000887,강남대로136길,1187,667,520
2015,4,A,골목상권,1000886,강남대로118길,564,316,248
2015,4,A,골목상권,1000885,서초중앙로8길,5867,4472,1395
2015,4,A,골목상권,1000884,방배중앙로21길,2152,725,1427
2015,4,A,골목상권,1000883,효령로72길,197,115,82
2015,4,A,골목상권,1000882,효령로34길,52,26,26
2015,4,A,골목상권,1000881,효령로31길,1502,900,602
2015,4,A,골목상권,1000880,효령로23길,690,416,274
2015,4,A,골목상권,1000879,청두곶길,2013,1376,637
2015,4,A,골목상권,1000878,주흥길,371,237,134
2015,4,A,골목상권,1000877,주흥15길,1400,898,502
2015,4,A,골목상권,1000876,언남길,1858,1357,501
2015,4,A,골목상권,1000875,신반포로45길,444,295,149
2015,4,A,골목상권,1000874,서초대로8길,287,203,84
2015,4,A,골목상권,1000873,서초대로64길,468,334,134
2015,4,A,골목상권,1000872,서초대로4길,601,437,164
2015,4,A,골목상권,1000871,서초대로25길,3555,2153,1402
2015,4,A,골목상권,1000870,서초대로23길,565,343,222
2015,4,A,골목상권,1000869,서초대로15길,1102,519,583
2015,4,A,골목상권,1000868,사평대로57길,198,76,122
2015,4,A,골목상권,1000867,사평대로26길,18,12,6
2015,4,A,골목상권,1000866,사평대로22길,1223,691,532
2015,4,A,골목상권,1000865,사임당로17길,1594,989,605
2015,4,A,골목상권,1000864,방배로42길,168,92,76
2015,4,A,골목상권,1000863,방배로35길,2287,1492,795
2015,4,A,골목상권,1000862,방배로18길,71,40,31
2015,4,A,골목상권,1000861,반포대로9길,667,469,198
2015,4,A,골목상권,1000860,바우뫼로39길,2184,1370,814
2015,4,A,골목상권,1000859,마방로2길,3799,2479,1320
2015,4,A,골목상권,1000858,방배천로4안길,1650,883,767
2015,4,A,골목상권,1000857,동산로19길,1380,930,450
2015,4,A,골목상권,1000856,동산로10길,2297,1238,1059
2015,4,A,골목상권,1000855,동광로39길,51,35,16
2015,4,A,골목상권,1000854,동광로1길,1396,785,611
2015,4,A,골목상권,1000853,동광로12길,724,495,229
2015,4,A,골목상권,1000852,논현로27길,3483,2528,955
2015,4,A,골목상권,1000851,논현로1길,609,378,231
2015,4,A,골목상권,1000850,남부순환로339길,11713,5285,6428
2015,4,A,골목상권,1000849,남부순환로325길,8052,4244,3808
2015,4,A,골목상권,1000848,남부순환로317길,1506,1082,424
2015,4,A,골목상권,1000847,고무래로8길,6843,3765,3078
2015,4,A,골목상권,1000846,강남대로8길,3189,2111,1078
2015,4,A,골목상권,1000845,강남대로34길,954,654,300
2015,4,A,골목상권,1000844,강남대로23길,6012,4353,1659
2015,4,A,골목상권,1000843,소담길,24,6,18
2015,4,A,골목상권,1000842,원신길,292,115,177
2015,4,A,골목상권,1000840,양산길,418,300,118
2015,4,A,골목상권,1000839,호암로24길,626,240,386
2015,4,A,골목상권,1000838,호암로20길,46,31,15
2015,4,A,골목상권,1000837,행운길,19,3,16
2015,4,A,골목상권,1000836,행운1길,84,53,31
2015,4,A,골목상권,1000835,청림3길,70,37,33
2015,4,A,골목상권,1000834,청룡길,170,114,56
2015,4,A,골목상권,1000833,청룡8길,33,11,22
2015,4,A,골목상권,1000832,중앙길,301,114,187
2015,4,A,골목상권,1000831,조원중앙로2길,1136,785,351
2015,4,A,골목상권,1000830,조원로18길,1030,541,489
2015,4,A,골목상권,1000829,조원로10길,273,132,141
2015,4,A,골목상권,1000828,장군봉2길,299,122,177
2015,4,A,골목상권,1000827,장군봉1길,99,13,86
2015,4,A,골목상권,1000826,인헌길,79,35,44
2015,4,A,골목상권,1000825,은천로25길,297,104,193
2015,4,A,골목상권,1000824,양녕로6길,934,603,331
2015,4,A,골목상권,1000823,신원로3길,33,23,10
2015,4,A,골목상권,1000822,신사로20길,63,31,32
2015,4,A,골목상권,1000820,신림로64길,222,119,103
2015,4,A,골목상권,1000819,신림로48길,74,38,36
2015,4,A,골목상권,1000818,신림로38길,49,25,24
2015,4,A,골목상권,1000817,신림로28길,326,225,101
2015,4,A,골목상권,1000816,신림로11길,436,403,33
2015,4,A,골목상권,1000815,신림동길,341,197,144
2015,4,A,골목상권,1000814,승방길,514,343,171
2015,4,A,골목상권,1000813,서림7길,254,91,163
2015,4,A,골목상권,1000812,봉천로33길,357,228,129
2015,4,A,골목상권,1000811,봉천로13길,287,86,201
2015,4,A,골목상권,1000810,복은길,195,73,122
2015,4,A,골목상권,1000809,법원단지길,2,1,1
2015,4,A,골목상권,1000808,법원단지9길,85,35,50
2015,4,A,골목상권,1000807,미성5길,61,34,27
2015,4,A,골목상권,1000806,대학길,79,34,45
2015,4,A,골목상권,1000805,대학14길,12,2,10
2015,4,A,골목상권,1000804,당곡길,352,158,194
2015,4,A,골목상권,1000803,남현길,237,91,146
2015,4,A,골목상권,1000802,남현3길,520,300,220
2015,4,A,골목상권,1000800,남부순환로248길,258,129,129
2015,4,A,골목상권,1000799,남부순환로234길,138,88,50
2015,4,A,골목상권,1000798,남부순환로172길,1500,840,660
2015,4,A,골목상권,1000797,남부순환로161길,17,4,13
2015,4,A,골목상권,1000796,남부순환로151길,121,75,46
2015,4,A,골목상권,1000795,남부순환로142길,70,30,40
2015,4,A,골목상권,1000794,난향길,171,49,122
2015,4,A,골목상권,1000793,난우길,410,172,238
2015,4,A,골목상권,1000792,난곡로74길,175,70,105
2015,4,A,골목상권,1000791,난곡로34길,28,8,20
2015,4,A,골목상권,1000790,난곡로26길,137,63,74
2015,4,A,골목상권,1000789,난곡로24길,34,15,19
2015,4,A,골목상권,1000788,낙성대역길,752,476,276
2015,4,A,골목상권,1000787,국회단지길,517,225,292
2015,4,A,골목상권,1000786,구암길,82,30,52
2015,4,A,골목상권,1000785,관천로22길,17,7,10
2015,4,A,골목상권,1000784,관천로15길,123,71,52
2015,4,A,골목상권,1000783,관악로30길,170,59,111
2015,4,A,골목상권,1000782,관악로28길,143,71,72
2015,4,A,골목상권,1000781,관악로14길,397,212,185
2015,4,A,골목상권,1000780,관악로10길,218,146,72
2015,4,A,골목상권,1000779,흑석로9길,174,73,101
2015,4,A,골목상권,1000778,흑석로13길,142,17,125
2015,4,A,골목상권,1000777,장승배기로27길,36,18,18
2015,4,A,골목상권,1000776,장승배기로19길,8,5,3
2015,4,A,골목상권,1000774,여의대방로46길,421,127,294
2015,4,A,골목상권,1000773,여의대방로24길,16144,7449,8695
2015,4,A,골목상권,1000772,여의대방로22카길,267,111,156
2015,4,A,골목상권,1000771,여의대방로22나길,132,51,81
2015,4,A,골목상권,1000770,여의대방로22길,211,128,83
2015,4,A,골목상권,1000769,양녕로26길,126,66,60
2015,4,A,골목상권,1000768,신대방길,121,78,43
2015,4,A,골목상권,1000767,성대로29길,2,2,0
2015,4,A,골목상권,1000766,성대로1길,327,132,195
2015,4,A,골목상권,1000765,서달로8가길,194,81,113
2015,4,A,골목상권,1000763,서달로14길,37,16,21
2015,4,A,골목상권,1000762,서달로10길,75,30,45
2015,4,A,골목상권,1000761,상도로62길,157,57,100
2015,4,A,골목상권,1000760,상도로61길,43,21,22
2015,4,A,골목상권,1000759,상도로47길,69,48,21
2015,4,A,골목상권,1000758,상도로37길,1997,1016,981
2015,4,A,골목상권,1000757,상도로15길,255,111,144
2015,4,A,골목상권,1000756,사당로8길,119,62,57
2015,4,A,골목상권,1000755,사당로30길,309,209,100
2015,4,A,골목상권,1000754,사당로2차길,100,62,38
2015,4,A,골목상권,1000753,사당로29길,21,15,6
2015,4,A,골목상권,1000752,사당로26길,233,127,106
2015,4,A,골목상권,1000751,사당로23나길,137,46,91
2015,4,A,골목상권,1000750,사당로23길,19,11,8
2015,4,A,골목상권,1000749,사당로20길,160,117,43
2015,4,A,골목상권,1000748,사당로16길,132,39,93
2015,4,A,골목상권,1000747,사당로16가길,790,488,302
2015,4,A,골목상권,1000746,만양로8길,70,29,41
2015,4,A,골목상권,1000745,만양로14길,377,159,218
2015,4,A,골목상권,1000744,등용로14길,591,428,163
2015,4,A,골목상권,1000743,동작대로7길,1799,791,1008
2015,4,A,골목상권,1000742,동작대로35길,246,93,153
2015,4,A,골목상권,1000741,동작대로33길,108,52,56
2015,4,A,골목상권,1000740,동작대로29길,33,18,15
2015,4,A,골목상권,1000739,동작대로17길,1322,706,616
2015,4,A,골목상권,1000738,대방동2길,446,215,231
2015,4,A,골목상권,1000737,대방동27길,138,79,59
2015,4,A,골목상권,1000736,노량진로6길,108,28,80
2015,4,A,골목상권,1000735,국사봉길,37,6,31
2015,4,A,골목상권,1000734,국사봉2길,99,67,32
2015,4,A,골목상권,1000733,국사봉1길,15,9,6
2015,4,A,골목상권,1000732,영신로9길,387,168,219
2015,4,A,골목상권,1000731,영등포로84길,355,83,272
2015,4,A,골목상권,1000730,영등포로80길,74,50,24
2015,4,A,골목상권,1000729,영등포로62길,5,3,2
2015,4,A,골목상권,1000728,영등포로35길,53,40,13
2015,4,A,골목상권,1000727,영등포로27길,301,186,115
2015,4,A,골목상권,1000724,여의대방로43나길,2337,1891,446
2015,4,A,골목상권,1000723,여의대방로39길,13,9,4
2015,4,A,골목상권,1000722,여의대방로35길,731,393,338
2015,4,A,골목상권,1000721,양평로28길,559,430,129
2015,4,A,골목상권,1000720,양평로22라길,42,27,15
2015,4,A,골목상권,1000719,양평로19길,4183,3344,839
2015,4,A,골목상권,1000718,신길로60길,419,178,241
2015,4,A,골목상권,1000717,신길로42길,383,187,196
2015,4,A,골목상권,1000716,신길로42가길,91,27,64
2015,4,A,골목상권,1000715,신길로39길,121,61,60
2015,4,A,골목상권,1000714,신길로17길,43,29,14
2015,4,A,골목상권,1000713,선유서로28길,437,232,205
2015,4,A,골목상권,1000712,선유서로25길,2293,1694,599
2015,4,A,골목상권,1000711,선유서로24길,179,100,79
2015,4,A,골목상권,1000710,선유로55길,2244,1391,853
2015,4,A,골목상권,1000709,디지털로74길,58,35,23
2015,4,A,골목상권,1000708,디지털로57길,7,1,6
2015,4,A,골목상권,1000707,디지털로37길,240,123,117
2015,4,A,골목상권,1000706,도신로62길,190,50,140
2015,4,A,골목상권,1000705,도신로60길,94,15,79
2015,4,A,골목상권,1000704,도신로29길,89,39,50
2015,4,A,골목상권,1000703,도신로15길,87,48,39
2015,4,A,골목상권,1000702,도림천로21길,100,47,53
2015,4,A,골목상권,1000701,도림로63길,30,19,11
2015,4,A,골목상권,1000700,도림로147길,1657,1197,460
2015,4,A,골목상권,1000699,도림로112길,16,8,8
2015,4,A,골목상권,1000698,대림로8길,1809,607,1202
2015,4,A,골목상권,1000697,대림로7길,15,5,10
2015,4,A,골목상권,1000696,대림로44길,46,28,18
2015,4,A,골목상권,1000695,대림로34길,173,63,110
2015,4,A,골목상권,1000694,대림로31길,750,365,385
2015,4,A,골목상권,1000693,대림로29길,1589,781,808
2015,4,A,골목상권,1000692,대림로22길,311,175,136
2015,4,A,골목상권,1000691,당산로46길,3211,1718,1493
2015,4,A,골목상권,1000690,당산로38길,276,215,61
2015,4,A,골목상권,1000689,당산로37길,3541,2209,1332
2015,4,A,골목상권,1000688,당산로31길,4168,2308,1860
2015,4,A,골목상권,1000687,국회대로56길,1578,1022,556
2015,4,A,골목상권,1000686,경인로90길,322,198,124
2015,4,A,골목상권,1000685,경인로80길,1565,1134,431
2015,4,A,골목상권,1000684,경인로77길,620,438,182
2015,4,A,골목상권,1000683,가마산로61길,219,90,129
2015,4,A,골목상권,1000682,시흥대로94길,796,415,381
2015,4,A,골목상권,1000681,시흥대로84길,164,65,99
2015,4,A,골목상권,1000680,시흥대로68길,342,126,216
2015,4,A,골목상권,1000679,시흥대로63길,2781,1467,1314
2015,4,A,골목상권,1000678,시흥대로62가길,421,111,310
2015,4,A,골목상권,1000677,시흥대로36길,349,212,137
2015,4,A,골목상권,1000676,시흥대로22길,495,353,142
2015,4,A,골목상권,1000675,시흥대로153길,621,324,297
2015,4,A,골목상권,1000674,시흥대로150길,582,262,320
2015,4,A,골목상권,1000673,시흥대로141길,694,423,271
2015,4,A,골목상권,1000672,시흥대로138길,14,7,7
2015,4,A,골목상권,1000671,시흥대로120길,616,421,195
2015,4,A,골목상권,1000670,벚꽃로56길,1850,1241,609
2015,4,A,골목상권,1000669,범안로17길,176,91,85
2015,4,A,골목상권,1000668,범안로11길,1115,895,220
2015,4,A,골목상권,1000667,문성로5길,190,49,141
2015,4,A,골목상권,1000666,독산로85길,69,25,44
2015,4,A,골목상권,1000665,독산로78다길,245,107,138
2015,4,A,골목상권,1000664,독산로70길,4,3,1
2015,4,A,골목상권,1000663,독산로64길,159,36,123
2015,4,A,골목상권,1000662,독산로50길,47,21,26
2015,4,A,골목상권,1000661,독산로40길,53,17,36
2015,4,A,골목상권,1000660,독산로108길,738,319,419
2015,4,A,골목상권,1000659,남부순환로112길,10,6,4
2015,4,A,골목상권,1000658,금하로24길,178,65,113
2015,4,A,골목상권,1000657,금하로1길,64,36,28
2015,4,A,골목상권,1000656,금하로14길,2,1,1
2015,4,A,골목상권,1000655,가산로5길,514,395,119
2015,4,A,골목상권,1000654,가산로3길,2440,1869,571
2015,4,A,골목상권,1000653,중앙로1길,1401,979,422
2015,4,A,골목상권,1000652,중앙로15길,97,48,49
2015,4,A,골목상권,1000651,우마길,35,23,12
2015,4,A,골목상권,1000650,오류로8길,230,110,120
2015,4,A,골목상권,1000649,신도림로13길,714,544,170
2015,4,A,골목상권,1000648,새말로18길,1203,491,712
2015,4,A,골목상권,1000647,부일로1길,765,632,133
2015,4,A,골목상권,1000646,부일로15길,191,169,22
2015,4,A,골목상권,1000645,부일로11길,27,9,18
2015,4,A,골목상권,1000644,디지털로32길,1262,673,589
2015,4,A,골목상권,1000643,디지털로32가길,7089,5056,2033
2015,4,A,골목상권,1000642,디지털로27길,393,251,142
2015,4,A,골목상권,1000641,도림로6길,105,44,61
2015,4,A,골목상권,1000640,도림로12길,98,42,56
2015,4,A,골목상권,1000639,남부순환로97길,262,85,177
2015,4,A,골목상권,1000638,구로중앙로8길,251,113,138
2015,4,A,골목상권,1000637,구로중앙로7길,185,68,117
2015,4,A,골목상권,1000636,구로중앙로42길,757,553,204
2015,4,A,골목상권,1000635,구로중앙로34길,594,323,271
2015,4,A,골목상권,1000634,구로중앙로28길,2883,1429,1454
2015,4,A,골목상권,1000633,구로중앙로19길,13,7,6
2015,4,A,골목상권,1000632,구로동로8길,157,47,110
2015,4,A,골목상권,1000631,구로동로7길,165,65,100
2015,4,A,골목상권,1000630,구로동로42길,26,19,7
2015,4,A,골목상권,1000629,구로동로41길,454,275,179
2015,4,A,골목상권,1000628,구로동로38길,43,17,26
2015,4,A,골목상권,1000627,구로동로28길,181,72,109
2015,4,A,골목상권,1000626,구로동로15길,23,2,21
2015,4,A,골목상권,1000625,공원로6가길,235,177,58
2015,4,A,골목상권,1000624,고척로52길,229,73,156
2015,4,A,골목상권,1000623,고척로27다길,227,90,137
2015,4,A,골목상권,1000622,고척로27길,233,97,136
2015,4,A,골목상권,1000621,고척로21나길,242,58,184
2015,4,A,골목상권,1000620,경인로47길,724,413,311
2015,4,A,골목상권,1000619,경인로35길,269,116,153
2015,4,A,골목상권,1000618,경인로31길,47,14,33
2015,4,A,골목상권,1000617,경인로15길,121,57,64
2015,4,A,골목상권,1000616,개봉로3길,303,169,134
2015,4,A,골목상권,1000615,개봉로2길,440,127,313
2015,4,A,골목상권,1000614,개봉로23가길,867,497,370
2015,4,A,골목상권,1000613,개봉로20길,115,66,49
2015,4,A,골목상권,1000612,개봉로1길,48,24,24
2015,4,A,골목상권,1000611,개봉로17다길,102,57,45
2015,4,A,골목상권,1000610,개봉로17길,837,400,437
2015,4,A,골목상권,1000609,개봉로11길,52,12,40
2015,4,A,골목상권,1000608,화곡로64길,2650,1398,1252
2015,4,A,골목상권,1000607,화곡로59길,519,195,324
2015,4,A,골목상권,1000606,화곡로44나길,853,722,131
2015,4,A,골목상권,1000605,화곡로31길,1080,388,692
2015,4,A,골목상권,1000604,화곡로20길,484,303,181
2015,4,A,골목상권,1000603,화곡로13길,251,82,169
2015,4,A,골목상권,1000602,초원로16길,445,191,254
2015,4,A,골목상권,1000601,초록마을로8길,171,28,143
2015,4,A,골목상권,1000600,초록마을로3길,48,23,25
2015,4,A,골목상권,1000599,월정로20길,2,1,1
2015,4,A,골목상권,1000598,우장산로6길,352,218,134
2015,4,A,골목상권,1000597,양천로73가길,1371,893,478
2015,4,A,골목상권,1000596,양천로71길,220,133,87
2015,4,A,골목상권,1000595,양천로49길,771,611,160
2015,4,A,골목상권,1000594,양천로26길,105,46,59
2015,4,A,골목상권,1000593,양천로24길,227,112,115
2015,4,A,골목상권,1000592,양천로24가길,691,280,411
2015,4,A,골목상권,1000591,양천로14길,324,200,124
2015,4,A,골목상권,1000590,방화대로6라길,733,491,242
2015,4,A,골목상권,1000589,방화대로21길,763,442,321
2015,4,A,골목상권,1000588,등촌로5길,10,2,8
2015,4,A,골목상권,1000587,등촌로55길,474,329,145
2015,4,A,골목상권,1000586,등촌로51길,10,9,1
2015,4,A,골목상권,1000585,등촌로39길,64,27,37
2015,4,A,골목상권,1000584,등촌로13길,195,100,95
2015,4,A,골목상권,1000583,남부순환로11길,430,313,117
2015,4,A,골목상권,1000582,까치산로4길,127,46,81
2015,4,A,골목상권,1000581,국회대로7길,355,215,140
2015,4,A,골목상권,1000580,공항대로8길,177,76,101
2015,4,A,골목상권,1000579,공항대로61길,250,158,92
2015,4,A,골목상권,1000578,공항대로59다길,844,639,205
2015,4,A,골목상권,1000577,공항대로59길,1093,698,395
2015,4,A,골목상권,1000576,공항대로55길,901,643,258
2015,4,A,골목상권,1000575,공항대로42길,8,5,3
2015,4,A,골목상권,1000574,공항대로38길,246,127,119
2015,4,A,골목상권,1000573,곰달래로60길,525,267,258
2015,4,A,골목상권,1000572,곰달래로53길,60,18,42
2015,4,A,골목상권,1000571,곰달래로47길,38,18,20
2015,4,A,골목상권,1000570,곰달래로31길,7,6,1
2015,4,A,골목상권,1000569,곰달래로25길,529,213,316
2015,4,A,골목상권,1000568,개화동로25길,647,429,218
2015,4,A,골목상권,1000567,개화동로23길,93,53,40
2015,4,A,골목상권,1000566,강서로8길,120,75,45
2015,4,A,골목상권,1000565,강서로5라길,277,156,121
2015,4,A,골목상권,1000564,강서로5나길,112,63,49
2015,4,A,골목상권,1000563,강서로5가길,45,26,19
2015,4,A,골목상권,1000562,강서로47라길,78,42,36
2015,4,A,골목상권,1000561,강서로47길,385,195,190
2015,4,A,골목상권,1000560,강서로45다길,838,370,468
2015,4,A,골목상권,1000559,강서로45길,126,59,67
2015,4,A,골목상권,1000558,강서로35길,152,87,65
2015,4,A,골목상권,1000557,강서로29길,292,166,126
2015,4,A,골목상권,1000556,강서로18길,23,12,11
2015,4,A,골목상권,1000555,강서로17가길,106,43,63
2015,4,A,골목상권,1000554,강서로15길,262,151,111
2015,4,A,골목상권,1000553,가로공원로80길,74,40,34
2015,4,A,골목상권,1000552,가로공원로76가길,18,7,11
2015,4,A,골목상권,1000551,화곡로4길,276,104,172
2015,4,A,골목상권,1000550,화곡로3길,180,65,115
2015,4,A,골목상권,1000549,지양로7길,219,67,152
2015,4,A,골목상권,1000548,중앙로55길,365,187,178
2015,4,A,골목상권,1000547,중앙로51길,124,69,55
2015,4,A,골목상권,1000546,중앙로47길,103,20,83
2015,4,A,골목상권,1000545,중앙로45길,156,49,107
2015,4,A,골목상권,1000544,중앙로36길,2,2,0
2015,4,A,골목상권,1000543,중앙로32길,569,267,302
2015,4,A,골목상권,1000542,중앙로25길,263,81,182
2015,4,A,골목상권,1000541,은행정로7길,469,151,318
2015,4,A,골목상권,1000539,오목로5길,312,182,130
2015,4,A,골목상권,1000538,오목로3길,452,427,25
2015,4,A,골목상권,1000537,오목로30길,178,82,96
2015,4,A,골목상권,1000536,오목로23길,736,402,334
2015,4,A,골목상권,1000535,신월로20길,212,79,133
2015,4,A,골목상권,1000534,신월로15길,783,363,420
2015,4,A,골목상권,1000533,신목로6길,229,124,105
2015,4,A,골목상권,1000532,신목로5길,901,328,573
2015,4,A,골목상권,1000531,신목로2길,98,46,52
2015,4,A,골목상권,1000530,목동중앙서로8가길,172,95,77
2015,4,A,골목상권,1000529,목동중앙서로7길,243,82,161
2015,4,A,골목상권,1000528,목동중앙북로8길,394,174,220
2015,4,A,골목상권,1000527,목동중앙북로16길,268,84,184
2015,4,A,골목상권,1000526,목동중앙본로7길,97,36,61
2015,4,A,골목상권,1000525,목동중앙로3길,104,57,47
2015,4,A,골목상권,1000524,목동중앙로13나길,258,190,68
2015,4,A,골목상권,1000523,목동중앙남로3가길,570,387,183
2015,4,A,골목상권,1000522,목동로9길,2432,1606,826
2015,4,A,골목상권,1000521,목동로19길,1003,378,625
2015,4,A,골목상권,1000519,목동동로12길,414,161,253
2015,4,A,골목상권,1000518,목동남로4길,10,5,5
2015,4,A,골목상권,1000517,남부순환로88길,327,139,188
2015,4,A,골목상권,1000516,남부순환로79길,588,408,180
2015,4,A,골목상권,1000515,남부순환로70길,670,468,202
2015,4,A,골목상권,1000514,남부순환로58길,158,84,74
2015,4,A,골목상권,1000513,남부순환로40길,22,12,10
2015,4,A,골목상권,1000512,남부순환로33길,1144,900,244
2015,4,A,골목상권,1000511,곰달래로5길,48,27,21
2015,4,A,골목상권,1000510,곰달래로3길,411,217,194
2015,4,A,골목상권,1000509,곰달래로2길,288,168,120
2015,4,A,골목상권,1000508,곰달래로10길,320,238,82
2015,4,A,골목상권,1000507,가로공원로58길,95,19,76
2015,4,A,골목상권,1000506,효창원로93길,114,60,54
2015,4,A,골목상권,1000505,토정로37길,122,46,76
2015,4,A,골목상권,1000504,월드컵로8길,1516,866,650
2015,4,A,골목상권,1000503,월드컵로7길,4,2,2
2015,4,A,골목상권,1000502,월드컵로36길,116,32,84
2015,4,A,골목상권,1000501,월드컵로25길,288,157,131
2015,4,A,골목상권,1000500,월드컵로19길,404,171,233
2015,4,A,골목상권,1000499,월드컵로16길,3859,1816,2043
2015,4,A,골목상권,1000498,월드컵로11길,195,71,124
2015,4,A,골목상권,1000497,월드컵로10길,1770,981,789
2015,4,A,골목상권,1000496,와우산로3길,143,87,56
2015,4,A,골목상권,1000495,와우산로29길,140,70,70
2015,4,A,골목상권,1000494,와우산로29가길,17,7,10
2015,4,A,골목상권,1000493,양화진길,441,314,127
2015,4,A,골목상권,1000492,양화로1길,4384,2299,2085
2015,4,A,골목상권,1000491,양화로11길,397,248,149
2015,4,A,골목상권,1000490,신촌로30길,29,14,15
2015,4,A,골목상권,1000489,신촌로28가길,113,48,65
2015,4,A,골목상권,1000488,신촌로12길,1235,596,639
2015,4,A,골목상권,1000487,숭문길,692,366,326
2015,4,A,골목상권,1000486,숭문8길,115,68,47
2015,4,A,골목상권,1000485,성지3길,500,278,222
2015,4,A,골목상권,1000484,성산로4길,3415,2084,1331
2015,4,A,골목상권,1000483,성미산로32길,346,175,171
2015,4,A,골목상권,1000482,성미산로1길,645,497,148
2015,4,A,골목상권,1000481,성미산로11길,982,674,308
2015,4,A,골목상권,1000480,백범로16길,578,316,262
2015,4,A,골목상권,1000479,방울내로9안길,313,174,139
2015,4,A,골목상권,1000478,모래내로7길,235,124,111
2015,4,A,골목상권,1000477,매봉산로2길,1621,1096,525
2015,4,A,골목상권,1000476,망원로2길,186,106,80
2015,4,A,골목상권,1000475,망원로11길,968,529,439
2015,4,A,골목상권,1000474,만리재옛길,1413,519,894
2015,4,A,골목상권,1000473,마포대로4길,143,84,59
2015,4,A,골목상권,1000472,마포대로20길,1113,594,519
2015,4,A,골목상권,1000471,마포대로12길,68,36,32
2015,4,A,골목상권,1000470,동교로38길,218,88,130
2015,4,A,골목상권,1000469,동교로27길,3400,1613,1787
2015,4,A,골목상권,1000468,동교로25길,384,178,206
2015,4,A,골목상권,1000467,동교로19길,4534,2892,1642
2015,4,A,골목상권,1000466,동교로17길,786,411,375
2015,4,A,골목상권,1000465,독막로8길,329,156,173
2015,4,A,골목상권,1000464,독막로32길,458,190,268
2015,4,A,골목상권,1000463,독막로22길,73,40,33
2015,4,A,골목상권,1000462,도화길,1004,488,516
2015,4,A,골목상권,1000461,도화4길,350,114,236
2015,4,A,골목상권,1000460,대흥로28길,55,46,9
2015,4,A,골목상권,1000459,대흥로21길,506,107,399
2015,4,A,골목상권,1000458,광성로6길,112,72,40
2015,4,A,골목상권,1000457,홍제내길,99,59,40
2015,4,A,골목상권,1000456,홍연길,88,55,33
2015,4,A,골목상권,1000455,통일로39길,10,9,1
2015,4,A,골목상권,1000454,통일로37길,342,130,212
2015,4,A,골목상권,1000453,통일로11길,12,10,2
2015,4,A,골목상권,1000452,충정로6길,15437,8539,6898
2015,4,A,골목상권,1000451,충정로4길,2998,2018,980
2015,4,A,골목상권,1000450,증가로6길,205,77,128
2015,4,A,골목상권,1000449,증가로23나길,422,212,210
2015,4,A,골목상권,1000448,증가로20가길,259,99,160
2015,4,A,골목상권,1000447,증가로10길,169,93,76
2015,4,A,골목상권,1000446,응암로1길,325,237,88
2015,4,A,골목상권,1000445,연희로10길,93,64,29
2015,4,A,골목상권,1000444,신촌로37길,148,63,85
2015,4,A,골목상권,1000443,수색로8길,2898,2789,109
2015,4,A,골목상권,1000442,세무서길,338,123,215
2015,4,A,골목상권,1000440,세검정로1길,278,171,107
2015,4,A,골목상권,1000439,북아현로4길,432,109,323
2015,4,A,골목상권,1000438,모래내로15길,81,20,61
2015,4,A,골목상권,1000437,명지대길,342,239,103
2015,4,A,골목상권,1000436,독립문로8길,730,281,449
2015,4,A,골목상권,1000435,가재울로6길,10,7,3
2015,4,A,골목상권,1000434,통일로92길,61,34,27
2015,4,A,골목상권,1000433,통일로87길,233,124,109
2015,4,A,골목상권,1000432,통일로78길,209,63,146
2015,4,A,골목상권,1000430,진흥로1길,491,147,344
2015,4,A,골목상권,1000429,진흥로12길,452,202,250
2015,4,A,골목상권,1000428,증산서길,387,279,108
2015,4,A,골목상권,1000427,증산로9길,98,36,62
2015,4,A,골목상권,1000426,증산로5길,722,373,349
2015,4,A,골목상권,1000425,증산로21길,258,171,87
2015,4,A,골목상권,1000424,증산로17길,802,414,388
2015,4,A,골목상권,1000423,증산로15길,196,74,122
2015,4,A,골목상권,1000422,증산로13길,66,35,31
2015,4,A,골목상권,1000421,응암로34길,104,63,41
2015,4,A,골목상권,1000420,응암로22길,166,54,112
2015,4,A,골목상권,1000419,응암로14길,336,104,232
2015,4,A,골목상권,1000418,응암로13길,264,107,157
2015,4,A,골목상권,1000417,응암로12길,212,97,115
2015,4,A,골목상권,1000416,은평로8길,264,139,125
2015,4,A,골목상권,1000415,은평로3길,294,84,210
2015,4,A,골목상권,1000414,은평로20길,23,9,14
2015,4,A,골목상권,1000413,은평로13길,481,309,172
2015,4,A,골목상권,1000412,은평로10길,305,186,119
2015,4,A,골목상권,1000411,연서로5길,57,22,35
2015,4,A,골목상권,1000410,연서로41길,231,65,166
2015,4,A,골목상권,1000409,연서로3길,104,39,65
2015,4,A,골목상권,1000408,연서로34길,132,40,92
2015,4,A,골목상권,1000407,연서로33길,28,8,20
2015,4,A,골목상권,1000406,연서로29길,325,119,206
2015,4,A,골목상권,1000405,연서로28길,753,343,410
2015,4,A,골목상권,1000404,연서로27길,65,29,36
2015,4,A,골목상권,1000403,연서로21길,335,208,127
2015,4,A,골목상권,1000402,연서로17길,1034,325,709
2015,4,A,골목상권,1000401,연서로16길,293,108,185
2015,4,A,골목상권,1000400,연서로13길,700,228,472
2015,4,A,골목상권,1000399,연서로11길,193,94,99
2015,4,A,골목상권,1000398,역말로9길,21,18,3
2015,4,A,골목상권,1000397,수색로18길,24,13,11
2015,4,A,골목상권,1000396,서오릉로8길,29,12,17
2015,4,A,골목상권,1000395,서오릉로21길,476,152,324
2015,4,A,골목상권,1000394,불광천길,167,82,85
2015,4,A,골목상권,1000393,갈현로7길,977,269,708
2015,4,A,골목상권,1000392,갈현로41길,92,38,54
2015,4,A,골목상권,1000391,갈현로33길,35,8,27
2015,4,A,골목상권,1000390,갈현로1길,131,56,75
2015,4,A,골목상권,1000389,가좌로7길,53,22,31
2015,4,A,골목상권,1000388,한글비석로44길,456,251,205
2015,4,A,골목상권,1000387,한글비석로24길,387,155,232
2015,4,A,골목상권,1000386,한글비석로22길,705,298,407
2015,4,A,골목상권,1000385,석계로1길,112,69,43
2015,4,A,골목상권,1000384,상계로9가길,347,99,248
2015,4,A,골목상권,1000382,상계로12길,13,9,4
2015,4,A,골목상권,1000381,동일로242길,492,373,119
2015,4,A,골목상권,1000380,동일로192길,462,223,239
2015,4,A,골목상권,1000379,동일로173가길,2408,1352,1056
2015,4,A,골목상권,1000378,공릉로58길,103,45,58
2015,4,A,골목상권,1000377,해등로16길,79,64,15
2015,4,A,골목상권,1000376,우이천로4다길,195,111,84
2015,4,A,골목상권,1000375,우이천로32길,96,46,50
2015,4,A,골목상권,1000374,시루봉로23길,39,18,21
2015,4,A,골목상권,1000373,삼양로144길,60,43,17
2015,4,A,골목상권,1000372,방학로6가길,162,87,75
2015,4,A,골목상권,1000371,방학로5길,119,73,46
2015,4,A,골목상권,1000370,방학로15길,346,219,127
2015,4,A,골목상권,1000369,방학로10길,121,49,72
2015,4,A,골목상권,1000367,도봉산4길,326,287,39
2015,4,A,골목상권,1000366,도봉로181길,216,98,118
2015,4,A,골목상권,1000365,도봉로169나길,282,127,155
2015,4,A,골목상권,1000364,도봉로156길,269,140,129
2015,4,A,골목상권,1000363,도봉로152가길,452,395,57
2015,4,A,골목상권,1000362,도봉로147길,578,337,241
2015,4,A,골목상권,1000360,도봉로114길,465,162,303
2015,4,A,골목상권,1000359,도봉로109길,18,6,12
2015,4,A,골목상권,1000358,도당로29길,903,537,366
2015,4,A,골목상권,1000357,도당로19길,162,74,88
2015,4,A,골목상권,1000356,도당로13바길,213,77,136
2015,4,A,골목상권,1000355,도당로13가길,144,63,81
2015,4,A,골목상권,1000354,덕릉로60길,54,27,27
2015,4,A,골목상권,1000353,노해로63다길,556,228,328
2015,4,A,골목상권,1000352,노해로60길,305,130,175
2015,4,A,골목상권,1000351,한천로140길,93,45,48
2015,4,A,골목상권,1000350,한천로139가길,54,29,25
2015,4,A,골목상권,1000349,한천로132길,293,110,183
2015,4,A,골목상권,1000348,한천로130길,287,131,156
2015,4,A,골목상권,1000347,한천로124나길,88,41,47
2015,4,A,골목상권,1000346,한천로109길,616,282,334
2015,4,A,골목상권,1000345,인수봉로79길,171,37,134
2015,4,A,골목상권,1000344,인수봉로72길,93,48,45
2015,4,A,골목상권,1000343,인수봉로56길,12,1,11
2015,4,A,골목상권,1000342,오패산로67길,537,282,255
2015,4,A,골목상권,1000341,오패산로52길,87,26,61
2015,4,A,골목상권,1000339,수유로12길,260,168,92
2015,4,A,골목상권,1000338,솔샘로65길,546,237,309
2015,4,A,골목상권,1000337,솔매로50길,694,269,425
2015,4,A,골목상권,1000336,솔매로45길,221,97,124
2015,4,A,골목상권,1000335,솔매로41길,76,16,60
2015,4,A,골목상권,1000334,삼양로93길,17,4,13
2015,4,A,골목상권,1000333,삼양로77길,401,137,264
2015,4,A,골목상권,1000332,삼양로54길,6,3,3
2015,4,A,골목상권,1000331,삼양로41길,342,167,175
2015,4,A,골목상권,1000329,삼양로24길,78,36,42
2015,4,A,골목상권,1000328,삼양로20길,133,49,84
2015,4,A,골목상권,1000327,삼각산로28길,669,373,296
2015,4,A,골목상권,1000326,도봉로99길,162,92,70
2015,4,A,골목상권,1000325,도봉로8길,271,187,84
2015,4,A,골목상권,1000324,도봉로76길,379,194,185
2015,4,A,골목상권,1000323,도봉로67길,5,3,2
2015,4,A,골목상권,1000322,도봉로45길,151,97,54
2015,4,A,골목상권,1000321,도봉로18길,367,175,192
2015,4,A,골목상권,1000320,도봉로13길,31,12,19
2015,4,A,골목상권,1000319,덕릉로41길,717,595,122
2015,4,A,골목상권,1000318,덕릉로40길,915,701,214
2015,4,A,골목상권,1000317,노해로33길,32,13,19
2015,4,A,골목상권,1000315,노해로17길,268,132,136
2015,4,A,골목상권,1000314,화랑로40길,161,82,79
2015,4,A,골목상권,1000313,화랑로32길,412,287,125
2015,4,A,골목상권,1000312,화랑로1길,201,108,93
2015,4,A,골목상권,1000311,화랑로19길,437,221,216
2015,4,A,골목상권,1000310,화랑로14길,44,20,24
2015,4,A,골목상권,1000309,화랑로13길,91,44,47
2015,4,A,골목상권,1000308,한천로76길,133,77,56
2015,4,A,골목상권,1000307,한천로101가길,61,36,25
2015,4,A,골목상권,1000306,창경궁로43길,28,14,14
2015,4,A,골목상권,1000305,지봉로20길,92,54,38
2015,4,A,골목상권,1000304,종암로5길,109,76,33
2015,4,A,골목상권,1000303,종암로24가길,282,151,131
2015,4,A,골목상권,1000302,종암로21길,131,52,79
2015,4,A,골목상권,1000301,종암로19길,370,103,267
2015,4,A,골목상권,1000300,종암로16길,77,36,41
2015,4,A,골목상권,1000299,정릉로8길,204,118,86
2015,4,A,골목상권,1000298,정릉로27길,223,90,133
2015,4,A,골목상권,1000296,장위로50길,956,527,429
2015,4,A,골목상권,1000295,장월로1길,419,184,235
2015,4,A,골목상권,1000294,인촌로6길,2258,1187,1071
2015,4,A,골목상권,1000293,인촌로5길,25,6,19
2015,4,A,골목상권,1000292,인촌로24길,171,114,57
2015,4,A,골목상권,1000291,개운사길,3066,1943,1123
2015,4,A,골목상권,1000290,인촌로1길,140,97,43
2015,4,A,골목상권,1000289,인촌로17가길,3124,1198,1926
2015,4,A,골목상권,1000288,오패산로4길,576,180,396
2015,4,A,골목상권,1000287,오패산로3길,1176,692,484
2015,4,A,골목상권,1000286,오패산로19길,47,15,32
2015,4,A,골목상권,1000285,안암로5길,568,345,223
2015,4,A,골목상권,1000284,아리랑로4길,628,238,390
2015,4,A,골목상권,1000283,솔샘로6길,149,65,84
2015,4,A,골목상권,1000282,성북로8길,45,23,22
2015,4,A,골목상권,1000281,삼양로8길,77,39,38
2015,4,A,골목상권,1000280,삼선교로16가길,675,400,275
2015,4,A,골목상권,1000279,삼선교로10다길,96,33,63
2015,4,A,골목상권,1000278,삼선교로10길,231,101,130
2015,4,A,골목상권,1000277,보문로32길,948,396,552
2015,4,A,골목상권,1000276,보문로31길,789,296,493
2015,4,A,골목상권,1000274,보문로13길,774,441,333
2015,4,A,골목상권,1000273,보국문로16길,292,202,90
2015,4,A,골목상권,1000270,동소문로26가길,241,132,109
2015,4,A,골목상권,1000269,동소문로15길,61,28,33
2015,4,A,골목상권,1000268,동소문로13길,841,478,363
2015,4,A,골목상권,1000267,돌곶이로8길,203,112,91
2015,4,A,골목상권,1000266,돌곶이로41길,47,21,26
2015,4,A,골목상권,1000265,돌곶이로28길,142,83,59
2015,4,A,골목상권,1000264,돌곶이로27길,53,30,23
2015,4,A,골목상권,1000263,돌곶이로22길,103,51,52
2015,4,A,골목상권,1000261,길음로7길,12,8,4
2015,4,A,골목상권,1000260,중랑천로10길,677,364,313
2015,4,A,골목상권,1000259,용마산로94길,452,279,173
2015,4,A,골목상권,1000258,용마산로118길,534,258,276
2015,4,A,골목상권,1000257,용마산로112길,277,131,146
2015,4,A,골목상권,1000256,용마산로100길,471,331,140
2015,4,A,골목상권,1000255,신내로7가길,281,75,206
2015,4,A,골목상권,1000254,사가정로54길,98,32,66
2015,4,A,골목상권,1000253,사가정로42길,60,22,38
2015,4,A,골목상권,1000252,봉화산로56길,591,158,433
2015,4,A,골목상권,1000251,봉화산로4길,358,127,231
2015,4,A,골목상권,1000250,봉화산로30길,392,246,146
2015,4,A,골목상권,1000249,봉우재로33길,62,23,39
2015,4,A,골목상권,1000248,면목로78길,291,171,120
2015,4,A,골목상권,1000247,면목로56길,223,167,56
2015,4,A,골목상권,1000246,면목로55길,457,143,314
2015,4,A,골목상권,1000245,면목로49길,503,162,341
2015,4,A,골목상권,1000244,면목로48길,104,57,47
2015,4,A,골목상권,1000243,면목로45길,90,36,54
2015,4,A,골목상권,1000242,면목로33길,450,168,282
2015,4,A,골목상권,1000241,면목로21길,27,22,5
2015,4,A,골목상권,1000240,망우로73길,9,4,5
2015,4,A,골목상권,1000239,망우로68길,74,30,44
2015,4,A,골목상권,1000238,동일로163길,126,85,41
2015,4,A,골목상권,1000237,동일로157길,193,95,98
2015,4,A,골목상권,1000236,동일로149길,1124,823,301
2015,4,A,골목상권,1000235,동일로140길,220,85,135
2015,4,A,골목상권,1000234,동일로139길,73,40,33
2015,4,A,골목상권,1000233,동일로139가길,1126,665,461
2015,4,A,골목상권,1000232,동일로130길,96,22,74
2015,4,A,골목상권,1000231,동일로123길,169,93,76
2015,4,A,골목상권,1000230,동일로112길,171,73,98
2015,4,A,골목상권,1000229,동일로101길,323,128,195
2015,4,A,골목상권,1000228,동일로100길,38,18,20
2015,4,A,골목상권,1000227,답십리로75길,88,48,40
2015,4,A,골목상권,1000226,공릉로2길,627,304,323
2015,4,A,골목상권,1000225,공릉로12가길,39,26,13
2015,4,A,골목상권,1000224,겸재로54길,116,65,51
2015,4,A,골목상권,1000223,겸재로36길,284,224,60
2015,4,A,골목상권,1000222,겸재로29길,452,190,262
2015,4,A,골목상권,1000221,휘경로3길,226,124,102
2015,4,A,골목상권,1000220,휘경로2길,7,2,5
2015,4,A,골목상권,1000219,휘경로23길,15,0,15
2015,4,A,골목상권,1000218,휘경로14길,101,42,59
2015,4,A,골목상권,1000217,한천로46길,387,121,266
2015,4,A,골목상권,1000216,한천로40길,278,149,129
2015,4,A,골목상권,1000215,한천로33길,70,31,39
2015,4,A,골목상권,1000214,한천로14길,610,374,236
2015,4,A,골목상권,1000213,천호대로97길,328,206,122
2015,4,A,골목상권,1000212,천호대로77길,2002,1019,983
2015,4,A,골목상권,1000211,천호대로45길,171,107,64
2015,4,A,골목상권,1000210,천호대로17길,2060,1287,773
2015,4,A,골목상권,1000209,천호대로12길,817,541,276
2015,4,A,골목상권,1000208,천장산로7길,1427,887,540
2015,4,A,골목상권,1000207,제기로5길,196,103,93
2015,4,A,골목상권,1000206,제기로21길,216,138,78
2015,4,A,골목상권,1000205,전농로4길,656,427,229
2015,4,A,골목상권,1000204,전농로3길,96,44,52
2015,4,A,골목상권,1000203,전농로29길,307,148,159
2015,4,A,골목상권,1000202,장한로8길,804,482,322
2015,4,A,골목상권,1000201,장한로5길,2857,1991,866
2015,4,A,골목상권,1000200,장한로27길,170,49,121
2015,4,A,골목상권,1000199,장한로27가길,394,197,197
2015,4,A,골목상권,1000198,장한로26길,568,289,279
2015,4,A,골목상권,1000197,장한로26가길,389,170,219
2015,4,A,골목상권,1000196,장한로25길,1000,428,572
2015,4,A,골목상권,1000195,장한로14길,187,158,29
2015,4,A,골목상권,1000194,이문로42길,235,87,148
2015,4,A,골목상권,1000193,왕산로43길,990,489,501
2015,4,A,골목상권,1000192,왕산로33길,175,121,54
2015,4,A,골목상권,1000191,왕산로32길,12,8,4
2015,4,A,골목상권,1000190,약령시로17길,260,137,123
2015,4,A,골목상권,1000189,서울시립대로4길,805,501,304
2015,4,A,골목상권,1000188,서울시립대로29길,234,135,99
2015,4,A,골목상권,1000187,서울시립대로16길,139,34,105
2015,4,A,골목상권,1000186,사가정로2길,81,66,15
2015,4,A,골목상권,1000185,사가정로23가길,116,69,47
2015,4,A,골목상권,1000184,사가정로13길,303,115,188
2015,4,A,골목상권,1000183,무학로45길,407,229,178
2015,4,A,골목상권,1000182,무학로16길,1106,982,124
2015,4,A,골목상권,1000181,망우로21길,187,106,81
2015,4,A,골목상권,1000180,망우로18길,529,216,313
2015,4,A,골목상권,1000179,망우로18가길,63,24,39
2015,4,A,골목상권,1000178,답십리로72길,14,11,3
2015,4,A,골목상권,1000177,답십리로69길,854,385,469
2015,4,A,골목상권,1000176,답십리로68길,172,109,63
2015,4,A,골목상권,1000175,답십리로64길,334,200,134
2015,4,A,골목상권,1000174,답십리로63길,109,65,44
2015,4,A,골목상권,1000173,답십리로60길,9,4,5
2015,4,A,골목상권,1000172,답십리로56길,8,6,2
2015,4,A,골목상권,1000171,답십리로23길,5,4,1
2015,4,A,골목상권,1000170,난계로30길,165,119,46
2015,4,A,골목상권,1000168,경희대로3길,268,165,103
2015,4,A,골목상권,1000167,천호대로129길,200,65,135
2015,4,A,골목상권,1000166,천호대로123길,369,156,213
2015,4,A,골목상권,1000165,천호대로109길,1236,696,540
2015,4,A,골목상권,1000164,자양번영로3길,94,38,56
2015,4,A,골목상권,1000162,자양로50길,20,5,15
2015,4,A,골목상권,1000161,자양로45길,540,295,245
2015,4,A,골목상권,1000160,자양로26길,328,107,221
2015,4,A,골목상권,1000159,자양로15길,435,249,186
2015,4,A,골목상권,1000158,자양로11길,1328,671,657
2015,4,A,골목상권,1000157,용마산로3길,806,444,362
2015,4,A,골목상권,1000156,용마산로21길,149,60,89
2015,4,A,골목상권,1000155,아차산로78길,1608,979,629
2015,4,A,골목상권,1000154,아차산로65길,705,460,245
2015,4,A,골목상권,1000153,아차산로55길,459,231,228
2015,4,A,골목상권,1000152,아차산로51길,272,149,123
2015,4,A,골목상권,1000151,아차산로40길,497,285,212
2015,4,A,골목상권,1000150,면목로17길,230,146,84
2015,4,A,골목상권,1000149,뚝섬로64길,400,232,168
2015,4,A,골목상권,1000148,뚝섬로58길,198,71,127
2015,4,A,골목상권,1000147,뚝섬로54길,148,87,61
2015,4,A,골목상권,1000146,뚝섬로48길,835,371,464
2015,4,A,골목상권,1000145,뚝섬로24길,106,38,68
2015,4,A,골목상권,1000144,뚝섬로23길,100,63,37
2015,4,A,골목상권,1000143,동일로24길,8,2,6
2015,4,A,골목상권,1000142,동일로18길,173,73,100
2015,4,A,골목상권,1000141,능동로4길,239,101,138
2015,4,A,골목상권,1000140,능동로3길,242,101,141
2015,4,A,골목상권,1000139,능동로34길,906,478,428
2015,4,A,골목상권,1000138,능동로19길,347,217,130
2015,4,A,골목상권,1000137,능동로13길,316,104,212
2015,4,A,골목상권,1000136,긴고랑로9길,72,33,39
2015,4,A,골목상권,1000135,긴고랑로8길,232,205,27
2015,4,A,골목상권,1000134,긴고랑로7길,516,249,267
2015,4,A,골목상권,1000133,긴고랑로20길,522,237,285
2015,4,A,골목상권,1000132,광나루로52길,1771,866,905
2015,4,A,골목상권,1000131,광나루로40길,82,41,41
2015,4,A,골목상권,1000130,광나루로37길,318,204,114
2015,4,A,골목상권,1000129,광나루로36길,41,26,15
2015,4,A,골목상권,1000128,광나루로24길,69,39,30
2015,4,A,골목상권,1000127,광나루로12길,914,537,377
2015,4,A,골목상권,1000126,한림말길,66,39,27
2015,4,A,골목상권,1000124,청계천로10나길,1746,1023,723
2015,4,A,골목상권,1000123,장터길,44,18,26
2015,4,A,골목상권,1000122,용답중앙길,77,47,30
2015,4,A,골목상권,1000121,용답29길,1911,987,924
2015,4,A,골목상권,1000120,왕십리로6길,1309,728,581
2015,4,A,골목상권,1000119,왕십리로31길,118,58,60
2015,4,A,골목상권,1000118,왕십리로26길,4148,2276,1872
2015,4,A,골목상권,1000117,왕십리로21길,151,42,109
2015,4,A,골목상권,1000116,왕십리로14길,2349,1789,560
2015,4,A,골목상권,1000115,아차산로5길,2190,1524,666
2015,4,A,골목상권,1000114,아차산로15길,3880,2773,1107
2015,4,A,골목상권,1000113,아차산로11길,3299,2174,1125
2015,4,A,골목상권,1000112,송정4가길,1025,481,544
2015,4,A,골목상권,1000111,송정12라길,251,163,88
2015,4,A,골목상권,1000110,성수일로6길,3115,1767,1348
2015,4,A,골목상권,1000109,성수이로7길,358,236,122
2015,4,A,골목상권,1000108,성수이로18길,2206,1574,632
2015,4,A,골목상권,1000107,성덕정길,641,411,230
2015,4,A,골목상권,1000106,성덕정17길,213,118,95
2015,4,A,골목상권,1000105,서울숲2길,1802,989,813
2015,4,A,골목상권,1000104,상원길,1615,1098,517
2015,4,A,골목상권,1000103,상원12길,181,110,71
2015,4,A,골목상권,1000102,사근동길,30,16,14
2015,4,A,골목상권,1000101,무학봉길,3,3,0
2015,4,A,골목상권,1000100,무학봉28길,157,67,90
2015,4,A,골목상권,1000099,무학로6길,347,213,134
2015,4,A,골목상권,1000098,무수막길,112,55,57
2015,4,A,골목상권,1000097,매봉길,31,19,12
2015,4,A,골목상권,1000096,마조로1길,183,70,113
2015,4,A,골목상권,1000095,마조로16길,773,534,239
2015,4,A,골목상권,1000094,마장로39길,69,40,29
2015,4,A,골목상권,1000093,마장로27길,99,41,58
2015,4,A,골목상권,1000091,둘레9길,406,237,169
2015,4,A,골목상권,1000090,금호산길,388,146,242
2015,4,A,골목상권,1000089,금호산2길,34,15,19
2015,4,A,골목상권,1000088,고산자로6길,15281,6321,8960
2015,4,A,골목상권,1000087,후암로28길,173,73,100
2015,4,A,골목상권,1000086,효창원로39길,53,34,19
2015,4,A,골목상권,1000085,회나무로13길,56,33,23
2015,4,A,골목상권,1000084,한남대로20길,670,380,290
2015,4,A,골목상권,1000082,한강대로7길,425,304,121
2015,4,A,골목상권,1000081,한강대로62길,685,489,196
2015,4,A,골목상권,1000080,한강대로52길,1178,776,402
2015,4,A,골목상권,1000079,한강대로43길,4631,3023,1608
2015,4,A,골목상권,1000078,한강대로15길,1910,431,1479
2015,4,A,골목상권,1000077,한강대로104길,4166,3032,1134
2015,4,A,골목상권,1000076,청파로73길,1315,755,560
2015,4,A,골목상권,1000075,청파로71길,240,125,115
2015,4,A,골목상권,1000074,청파로47나길,119,76,43
2015,4,A,골목상권,1000073,청파로47길,816,377,439
2015,4,A,골목상권,1000072,장문로45길,73,10,63
2015,4,A,골목상권,1000071,이태원로54길,1417,811,606
2015,4,A,골목상권,1000070,이태원로27길,501,290,211
2015,4,A,골목상권,1000069,이촌로22길,207,121,86
2015,4,A,골목상권,1000068,원효로89길,946,761,185
2015,4,A,골목상권,1000067,원효로53길,774,480,294
2015,4,A,골목상권,1000066,원효로41길,2729,1962,767
2015,4,A,골목상권,1000065,원효로19길,951,682,269
2015,4,A,골목상권,1000064,우사단로4길,165,122,43
2015,4,A,골목상권,1000063,우사단로14길,1676,926,750
2015,4,A,골목상권,1000062,우사단로10길,59,28,31
2015,4,A,골목상권,1000061,신흥로20길,183,90,93
2015,4,A,골목상권,1000060,소월로20길,130,44,86
2015,4,A,골목상권,1000059,서빙고로71길,426,250,176
2015,4,A,골목상권,1000058,백범로90길,272,158,114
2015,4,A,골목상권,1000057,백범로79길,963,580,383
2015,4,A,골목상권,1000056,두텁바위로1길,2451,1381,1070
2015,4,A,골목상권,1000055,대사관로34길,306,186,120
2015,4,A,골목상권,1000054,녹사평대로46길,42,30,12
2015,4,A,골목상권,1000053,녹사평대로40나길,34,17,17
2015,4,A,골목상권,1000052,녹사평대로32길,301,149,152
2015,4,A,골목상권,1000051,녹사평대로26길,2122,1195,927
2015,4,A,골목상권,1000050,녹사평대로11길,288,195,93
2015,4,A,골목상권,1000049,퇴계로90길,472,196,276
2015,4,A,골목상권,1000048,퇴계로8길,2326,1364,962
2015,4,A,골목상권,1000047,퇴계로56길,1029,822,207
2015,4,A,골목상권,1000046,퇴계로46길,1844,721,1123
2015,4,A,골목상권,1000045,퇴계로18길,2852,1327,1525
2015,4,A,골목상권,1000044,퇴계로12길,1047,475,572
2015,4,A,골목상권,1000043,청구로1길,193,92,101
2015,4,A,골목상권,1000042,청구로17길,1731,786,945
2015,4,A,골목상권,1000041,장충단로8길,3961,1236,2725
2015,4,A,골목상권,1000040,삼일대로4길,964,584,380
2015,4,A,골목상권,1000039,명동길,35442,17876,17566
2015,4,A,골목상권,1000037,동호로20길,883,401,482
2015,4,A,골목상권,1000036,동호로15길,4480,2457,2023
2015,4,A,골목상권,1000035,동호로11길,20,17,3
2015,4,A,골목상권,1000034,동호로10길,1477,655,822
2015,4,A,골목상권,1000033,다산로39길,1097,653,444
2015,4,A,골목상권,1000032,다산로38길,1689,936,753
2015,4,A,골목상권,1000031,다산로36길,58,31,27
2015,4,A,골목상권,1000030,다산로33길,391,189,202
2015,4,A,골목상권,1000029,난계로21길,203,134,69
2015,4,A,골목상권,1000028,난계로11길,2007,1090,917
2015,4,A,골목상권,1000026,평창길,164,72,92
2015,4,A,골목상권,1000025,통일로12길,236,106,130
2015,4,A,골목상권,1000024,창신길,257,70,187
2015,4,A,골목상권,1000023,창신5길,6,3,3
2015,4,A,골목상권,1000022,창신2길,63,31,32
2015,4,A,골목상권,1000021,창경궁로35길,1375,372,1003
2015,4,A,골목상권,1000020,지봉로8길,156,80,76
2015,4,A,골목상권,1000019,종로65길,679,307,372
2015,4,A,골목상권,1000016,자하문로7길,488,276,212
2015,4,A,골목상권,1000015,이화장길,2018,999,1019
2015,4,A,골목상권,1000014,율곡로16길,11,7,4
2015,4,A,골목상권,1000013,율곡로10길,2294,1702,592
2015,4,A,골목상권,1000012,옥인길,529,242,287
2015,4,A,골목상권,1000011,숭인동길,19,8,11
2015,4,A,골목상권,1000010,성균관로5길,121,74,47
2015,4,A,골목상권,1000009,삼청로5길,440,165,275
2015,4,A,골목상권,1000008,북촌로5나길,1510,1054,456
2015,4,A,골목상권,1000007,북촌로5길,55,23,32
2015,4,A,골목상권,1000006,북촌로11길,24,12,12
2015,4,A,골목상권,1000005,백석동길,95,50,45
2015,4,A,골목상권,1000004,명륜길,15,11,4
2015,4,A,골목상권,1000003,돈화문로11가길,1085,599,486
2015,4,A,골목상권,1000001,계동길,885,398,487
2015,3,U,관광특구,1001496,강남 마이스 관광특구,20112,11820,8292
2015,3,U,관광특구,1001495,잠실 관광특구,26461,16084,10377
2015,3,U,관광특구,1001494,종로?청계 관광특구,30389,19091,11298
2015,3,U,관광특구,1001493,동대문패션타운 관광특구,13416,9078,4338
2015,3,U,관광특구,1001492,명동 남대문 북창동 다동 무교동 관광특구,174824,89070,85754
2015,3,U,관광특구,1001491,이태원 관광특구,5862,3396,2466
2015,3,R,전통시장,1001490,길동복조리시장,569,338,231
2015,3,R,전통시장,1001489,둔촌역전통시장,160,77,83
2015,3,R,전통시장,1001488,성내골목시장,6,2,4
2015,3,R,전통시장,1001487,천호시장,13,8,5
2015,3,R,전통시장,1001483,암사종합시장,642,307,335
2015,3,R,전통시장,1001482,고덕전통시장,406,391,15
2015,3,R,전통시장,1001481,명일골목시장,396,118,278
2015,3,R,전통시장,1001480,새마을시장,289,146,143
2015,3,R,전통시장,1001479,석촌시장,164,108,56
2015,3,R,전통시장,1001478,방이시장,617,413,204
2015,3,R,전통시장,1001477,마천시장,247,58,189
2015,3,R,전통시장,1001476,풍납시장,11,2,9
2015,3,R,전통시장,1001475,강남개포시장,42,36,6
2015,3,R,전통시장,1001474,도곡시장,498,230,268
2015,3,R,전통시장,1001471,영동전통시장,3081,2310,771
2015,3,R,전통시장,1001466,미성동도깨비시장,403,167,236
2015,3,R,전통시장,1001464,삼성동시장,87,34,53
2015,3,R,전통시장,1001463,신림중앙시장,17,11,6
2015,3,R,전통시장,1001462,강남골목시장,225,124,101
2015,3,R,전통시장,1001460,관악신사시장,309,239,70
2015,3,R,전통시장,1001459,신원시장,336,146,190
2015,3,R,전통시장,1001458,인헌시장,226,74,152
2015,3,R,전통시장,1001456,봉천현대시장,14,6,8
2015,3,R,전통시장,1001454,봉천제일종합시장,43,23,20
2015,3,R,전통시장,1001453,낙성대시장,22,16,6
2015,3,R,전통시장,1001452,중부시장,194,63,131
2015,3,R,전통시장,1001450,남성역골목시장,504,250,254
2015,3,R,전통시장,1001449,남성사계시장,1964,911,1053
2015,3,R,전통시장,1001448,흑석시장,164,51,113
2015,3,R,전통시장,1001447,상도4동도깨비골목시장,310,80,230
2015,3,R,전통시장,1001445,영도시장,88,36,52
2015,3,R,전통시장,1001441,본동인정시장,118,57,61
2015,3,R,전통시장,1001439,대림중앙시장,26,17,9
2015,3,R,전통시장,1001438,우리시장,15,5,10
2015,3,R,전통시장,1001437,영진시장A동,46,37,9
2015,3,R,전통시장,1001433,영일시장,9,7,2
2015,3,R,전통시장,1001431,영등포청과시장,169,106,63
2015,3,R,전통시장,1001430,영등포전통시장,4114,2068,2046
2015,3,R,전통시장,1001429,은행나무시장,46,11,35
2015,3,R,전통시장,1001427,현대시장,56,15,41
2015,3,R,전통시장,1001424,남문시장,285,118,167
2015,3,R,전통시장,1001423,독산동 우시장,142,60,82
2015,3,R,전통시장,1001421,개봉중앙시장,7,3,4
2015,3,R,전통시장,1001419,가리봉시장,15,10,5
2015,3,R,전통시장,1001418,남구로시장,6,3,3
2015,3,R,전통시장,1001417,구로시장,44,20,24
2015,3,R,전통시장,1001415,방신전통시장,154,130,24
2015,3,R,전통시장,1001414,송화골목시장,477,171,306
2015,3,R,전통시장,1001413,까치산시장,32,18,14
2015,3,R,전통시장,1001411,남부골목시장,153,67,86
2015,3,R,전통시장,1001409,화곡중앙골목시장,2,2,0
2015,3,R,전통시장,1001407,등마루시장,789,501,288
2015,3,R,전통시장,1001406,신정3동골목시장,240,108,132
2015,3,R,전통시장,1001405,신정2동골목시장,8,6,2
2015,3,R,전통시장,1001402,신월6동골목시장,255,115,140
2015,3,R,전통시장,1001401,신곡종합시장,15,10,5
2015,3,R,전통시장,1001400,신월3동골목시장,50,15,35
2015,3,R,전통시장,1001399,경창시장,190,89,101
2015,3,R,전통시장,1001398,월정로시장,104,56,48
2015,3,R,전통시장,1001397,신영시장,44,20,24
2015,3,R,전통시장,1001396,목4동시장,248,85,163
2015,3,R,전통시장,1001395,목3동시장,624,275,349
2015,3,R,전통시장,1001394,목2동시장,185,88,97
2015,3,R,전통시장,1001393,마포농수산물시장,472,296,176
2015,3,R,전통시장,1001391,망원월드컵시장,14,9,5
2015,3,R,전통시장,1001390,망원시장,36,20,16
2015,3,R,전통시장,1001386,신수시장,140,101,39
2015,3,R,전통시장,1001385,아현시장,32,8,24
2015,3,R,전통시장,1001374,대림골목시장,279,89,190
2015,3,R,전통시장,1001367,상계중앙시장,31,17,14
2015,3,R,전통시장,1001364,방학동도깨비시장,136,60,76
2015,3,R,전통시장,1001363,쌍문역골목시장,51,22,29
2015,3,R,전통시장,1001361,신도봉시장,25,15,10
2015,3,R,전통시장,1001359,창동신창시장,125,48,77
2015,3,R,전통시장,1001358,수유북부시장,9,4,5
2015,3,R,전통시장,1001357,장미원골목시장,60,41,19
2015,3,R,전통시장,1001356,수유중앙시장,127,70,57
2015,3,R,전통시장,1001355,강북종합시장,55,23,32
2015,3,R,전통시장,1001354,우이시장,155,73,82
2015,3,R,전통시장,1001353,수유전통시장,455,140,315
2015,3,R,전통시장,1001352,번동북부골목시장,90,56,34
2015,3,R,전통시장,1001351,솔샘시장,95,36,59
2015,3,R,전통시장,1001349,방천골목시장,79,25,54
2015,3,R,전통시장,1001347,석관황금시장,45,24,21
2015,3,R,전통시장,1001343,장위전통시장,184,70,114
2015,3,R,전통시장,1001340,정릉시장,31,12,19
2015,3,R,전통시장,1001339,정릉아리랑시장,8,5,3
2015,3,R,전통시장,1001338,돈암제일시장,80,40,40
2015,3,R,전통시장,1001336,우림골목시장,220,109,111
2015,3,R,전통시장,1001335,묵1동도깨비시장,245,100,145
2015,3,R,전통시장,1001334,태능시장,2,2,0
2015,3,R,전통시장,1001333,중화제일시장,21,0,21
2015,3,R,전통시장,1001332,사가정시장,260,206,54
2015,3,R,전통시장,1001330,동원시장,61,28,33
2015,3,R,전통시장,1001329,동부골목시장,80,28,52
2015,3,R,전통시장,1001326,회기시장,130,48,82
2015,3,R,전통시장,1001323,답십리시장,21,9,12
2015,3,R,전통시장,1001321,답십리현대시장,105,77,28
2015,3,R,전통시장,1001319,청량리종합시장,8,6,2
2015,3,R,전통시장,1001317,청량리농수산물시장,15,13,2
2015,3,R,전통시장,1001316,서울약령시장,1316,849,467
2015,3,R,전통시장,1001313,청량리수산시장,162,87,75
2015,3,R,전통시장,1001310,구의시장,96,56,40
2015,3,R,전통시장,1001309,조양시장,76,44,32
2015,3,R,전통시장,1001308,영동교골목시장,22,16,6
2015,3,R,전통시장,1001307,능동로골목시장,287,266,21
2015,3,R,전통시장,1001304,자양골목시장,88,44,44
2015,3,R,전통시장,1001301,중곡제일시장,145,73,72
2015,3,R,전통시장,1001299,한아름시장,107,56,51
2015,3,R,전통시장,1001298,성동용답상가시장,253,130,123
2015,3,R,전통시장,1001297,뚝도시장,26,8,18
2015,3,R,전통시장,1001296,금남시장,14,10,4
2015,3,R,전통시장,1001295,행당시장,211,111,100
2015,3,R,전통시장,1001294,마장축산물시장,1545,1055,490
2015,3,R,전통시장,1001289,용문전통시장,25,15,10
2015,3,R,전통시장,1001286,후암시장,30,11,19
2015,3,R,전통시장,1001285,합동(새벽)시장,2298,1239,1059
2015,3,R,전통시장,1001284,서울중앙시장,246,167,79
2015,3,R,전통시장,1001283,백학시장,495,270,225
2015,3,R,전통시장,1001282,약수시장,1542,594,948
2015,3,R,전통시장,1001281,청평화시장,2439,1673,766
2015,3,R,전통시장,1001280,제일평화시장,472,291,181
2015,3,R,전통시장,1001278,남평화시장,156,105,51
2015,3,R,전통시장,1001277,방산종합시장,1701,1133,568
2015,3,R,전통시장,1001275,인현시장,1188,767,421
2015,3,R,전통시장,1001274,신중부시장,2298,1575,723
2015,3,R,전통시장,1001273,남대문시장,7028,3805,3223
2015,3,R,전통시장,1001271,동묘시장,865,552,313
2015,3,R,전통시장,1001270,창신골목시장,216,123,93
2015,3,R,전통시장,1001268,충신시장,320,187,133
2015,3,R,전통시장,1001267,종로신진시장,30,12,18
2015,3,R,전통시장,1001266,동대문종합시장,241,147,94
2015,3,R,전통시장,1001265,광장시장,216,150,66
2015,3,D,발달상권,1001263,서울 노원구 노원역_3,678,275,403
2015,3,D,발달상권,1001261,서울 노원구 노원역_1,909,274,635
2015,3,D,발달상권,1001260,창동역,2306,1504,802
2015,3,D,발달상권,1001259,서울 강북구 수유역_3,49,27,22
2015,3,D,발달상권,1001257,서울 강북구 수유역_2,4014,2106,1908
2015,3,D,발달상권,1001256,서울 강북구 수유역_1,84,66,18
2015,3,D,발달상권,1001255,서울 은평구 연신내역_3,575,183,392
2015,3,D,발달상권,1001254,서울 은평구 연신내역_2,318,138,180
2015,3,D,발달상권,1001253,서울 은평구 연신내역_1,49,25,24
2015,3,D,발달상권,1001252,서울 성북구 미아삼거리역_2,507,243,264
2015,3,D,발달상권,1001251,서울 강북구 미아삼거리역_1,432,153,279
2015,3,D,발달상권,1001250,서울 은평구 불광역_3,51,19,32
2015,3,D,발달상권,1001249,서울 은평구 불광역_2,80,32,48
2015,3,D,발달상권,1001248,서울 은평구 불광역_1,225,89,136
2015,3,D,발달상권,1001247,미아사거리_2,145,82,63
2015,3,D,발달상권,1001246,미아사거리_1,522,215,307
2015,3,D,발달상권,1001245,서울 성북구 성신여대입구역,4859,3013,1846
2015,3,D,발달상권,1001244,경희대학교,334,151,183
2015,3,D,발달상권,1001243,서울 성북구 안암역,91,57,34
2015,3,D,발달상권,1001242,혜화역 대학로_3,10394,3112,7282
2015,3,D,발달상권,1001241,혜화역 대학로_2,1381,802,579
2015,3,D,발달상권,1001240,혜화역 대학로_1,1199,627,572
2015,3,D,발달상권,1001239,디지털미디어시티,20370,12500,7870
2015,3,D,발달상권,1001238,서울 동대문구 청량리역,3144,2047,1097
2015,3,D,발달상권,1001236,서울 종로구 안국역_2,775,310,465
2015,3,D,발달상권,1001235,서울 종로구 안국역_1,11905,9833,2072
2015,3,D,발달상권,1001234,서울 종로구 경복궁역_1,219,90,129
2015,3,D,발달상권,1001233,서울 종로구 종로3가역_3,3053,1719,1334
2015,3,D,발달상권,1001232,서울 종로구 종로3가역_2,1725,968,757
2015,3,D,발달상권,1001231,서울 동대문구 신설동역_2,4316,2209,2107
2015,3,D,발달상권,1001230,인사동,22122,13936,8186
2015,3,D,발달상권,1001229,서울 종로구 종로5가역_4,668,367,301
2015,3,D,발달상권,1001228,서울 종로구 종로5가역_3,5271,3628,1643
2015,3,D,발달상권,1001227,종로구청,14980,8913,6067
2015,3,D,발달상권,1001226,서울 종로구 종로5가역_2,14311,8912,5399
2015,3,D,발달상권,1001225,신설동역,737,442,295
2015,3,D,발달상권,1001224,서울 동대문구 신설동역_1,2,2,0
2015,3,D,발달상권,1001223,서울 종로구 광화문역_2,50961,32188,18773
2015,3,D,발달상권,1001222,동묘앞역,64,41,23
2015,3,D,발달상권,1001221,장안동사거리,540,258,282
2015,3,D,발달상권,1001220,서울 종로구 동대문역_2,968,546,422
2015,3,D,발달상권,1001218,동대문시장_2,504,320,184
2015,3,D,발달상권,1001217,서울 종로구 종로5가역_1,51,34,17
2015,3,D,발달상권,1001216,서울 종로구 종로3가역_1,3353,1527,1826
2015,3,D,발달상권,1001215,서울 종로구 광화문역_1,2332,1632,700
2015,3,D,발달상권,1001214,종각역,20893,13909,6984
2015,3,D,발달상권,1001213,종각역 젊음의 거리,1963,929,1034
2015,3,D,발달상권,1001212,서대문구 서대문역_1,2581,843,1738
2015,3,D,발달상권,1001211,동대문시장_1,452,241,211
2015,3,D,발달상권,1001210,시청역_2,24467,15366,9101
2015,3,D,발달상권,1001209,서울시청,26286,12343,13943
2015,3,D,발달상권,1001208,서울 중구 을지로3가역_2,8590,5507,3083
2015,3,D,발달상권,1001207,서울 중구 신당역_2,1199,630,569
2015,3,D,발달상권,1001206,서대문구 서대문역_2,2227,1513,714
2015,3,D,발달상권,1001205,동대문역사문화공원역,4451,2846,1605
2015,3,D,발달상권,1001204,서울 중구 을지로3가역_1,14127,9632,4495
2015,3,D,발달상권,1001203,명동거리,17531,8960,8571
2015,3,D,발달상권,1001202,롯데백화점,56396,30904,25492
2015,3,D,발달상권,1001201,서울 중구 신당역_1,1109,707,402
2015,3,D,발달상권,1001200,북창동,7555,4811,2744
2015,3,D,발달상권,1001199,서울 중구 충무로역_2,16372,7386,8986
2015,3,D,발달상권,1001198,서울 강서구 송정역,642,449,193
2015,3,D,발달상권,1001197,장한평역_2,12082,9724,2358
2015,3,D,발달상권,1001196,시청역_1,63738,36931,26807
2015,3,D,발달상권,1001195,왕십리역_2,728,343,385
2015,3,D,발달상권,1001194,서울 강서구 발산역,709,467,242
2015,3,D,발달상권,1001193,장한평역_1,2409,1606,803
2015,3,D,발달상권,1001192,서울 중구 충무로역_1,3078,2043,1035
2015,3,D,발달상권,1001190,장한평역,2135,1447,688
2015,3,D,발달상권,1001189,서울 중구 명동역,3611,1900,1711
2015,3,D,발달상권,1001188,장충동 족발거리,203,92,111
2015,3,D,발달상권,1001187,한양시장,239,115,124
2015,3,D,발달상권,1001186,서울 서대문구 이대역,1176,452,724
2015,3,D,발달상권,1001185,서울 서대문구 신촌역,2558,1037,1521
2015,3,D,발달상권,1001184,서울 마포구 홍대입구역_3,940,731,209
2015,3,D,발달상권,1001183,서울 마포구 홍대입구역_2,2597,1075,1522
2015,3,D,발달상권,1001182,홍익대학교 주변,15744,7452,8292
2015,3,D,발달상권,1001181,서울 광진구 군자역,170,109,61
2015,3,D,발달상권,1001180,신촌역,215,120,95
2015,3,D,발달상권,1001179,강서구청,3681,2475,1206
2015,3,D,발달상권,1001178,서울 마포구 홍대입구역_1,746,428,318
2015,3,D,발달상권,1001175,서울 강동구 고덕역,484,283,201
2015,3,D,발달상권,1001173,서울 강동구 명일역,905,353,552
2015,3,D,발달상권,1001172,어린이대공원역,119,78,41
2015,3,D,발달상권,1001171,서울 마포구 공덕역_2,3983,2327,1656
2015,3,D,발달상권,1001170,공덕역,6421,4101,2320
2015,3,D,발달상권,1001169,서울 용산구 숙대입구역,4118,2911,1207
2015,3,D,발달상권,1001168,남영역,13958,6427,7531
2015,3,D,발달상권,1001167,서울 마포구 공덕역_1,4235,2073,2162
2015,3,D,발달상권,1001166,서울 마포구 마포역_2,1002,583,419
2015,3,D,발달상권,1001165,서울 광진구 건대입구역_2,2641,941,1700
2015,3,D,발달상권,1001164,서울 마포구 마포역_1,10341,6302,4039
2015,3,D,발달상권,1001163,서울 강동구 천호역_2,3625,1817,1808
2015,3,D,발달상권,1001162,서울 광진구 건대입구역_1,946,467,479
2015,3,D,발달상권,1001161,건대입구역,795,442,353
2015,3,D,발달상권,1001160,서울 광진구 구의역,896,552,344
2015,3,D,발달상권,1001159,서울 강동구 천호역,972,449,523
2015,3,D,발달상권,1001158,당산역_2,5096,3116,1980
2015,3,D,발달상권,1001156,서울 강동구 길동역,1603,1061,542
2015,3,D,발달상권,1001155,용산 전자상가_5,2185,1659,526
2015,3,D,발달상권,1001153,당산역_1,1141,739,402
2015,3,D,발달상권,1001152,서울 광진구 강변역,2172,1799,373
2015,3,D,발달상권,1001151,용산 전자상가_3,2542,1870,672
2015,3,D,발달상권,1001150,서울 용산구 이태원역,783,466,317
2015,3,D,발달상권,1001149,한남오거리,617,322,295
2015,3,D,발달상권,1001147,용산 전자상가_2,429,345,84
2015,3,D,발달상권,1001146,용산구청,66,43,23
2015,3,D,발달상권,1001145,용산 전자상가_1,8231,6307,1924
2015,3,D,발달상권,1001144,국회의사당역_2,39285,22304,16981
2015,3,D,발달상권,1001143,서울 용산구 신용산역,323,131,192
2015,3,D,발달상권,1001142,국회의사당역_1,5726,4448,1278
2015,3,D,발달상권,1001141,압구정 로데오거리_2,14245,5872,8373
2015,3,D,발달상권,1001140,서울 강남구 압구정역,9661,4504,5157
2015,3,D,발달상권,1001139,서울 영등포구 영등포구청역,4516,1393,3123
2015,3,D,발달상권,1001138,압구정 로데오거리_1,7733,2486,5247
2015,3,D,발달상권,1001137,서울 강동구 둔촌동역,60,26,34
2015,3,D,발달상권,1001136,오목교역,213,103,110
2015,3,D,발달상권,1001135,신사동 가로수길,20767,9661,11106
2015,3,D,발달상권,1001134,서울 영등포구 여의도역_2,46755,31061,15694
2015,3,D,발달상권,1001133,청담사거리_3,1312,428,884
2015,3,D,발달상권,1001132,영등포유통상가,1848,1251,597
2015,3,D,발달상권,1001131,청담역_2,1409,1029,380
2015,3,D,발달상권,1001130,청담역_1,191,151,40
2015,3,D,발달상권,1001129,청담사거리_2,1025,815,210
2015,3,D,발달상권,1001127,서울 영등포구 여의도역_1,53145,32010,21135
2015,3,D,발달상권,1001125,학동사거리_2,2788,1623,1165
2015,3,D,발달상권,1001124,서울 영등포구 영등포시장역,337,271,66
2015,3,D,발달상권,1001123,학동사거리_1,4245,2224,2021
2015,3,D,발달상권,1001122,여의도 시범아파트앞,2386,1587,799
2015,3,D,발달상권,1001121,영등포역_3,831,503,328
2015,3,D,발달상권,1001120,도산공원사거리_1,10478,6531,3947
2015,3,D,발달상권,1001119,영등포역_2,1004,554,450
2015,3,D,발달상권,1001118,문래동 주민센터,67,56,11
2015,3,D,발달상권,1001117,강남구 신사역_2,7208,4808,2400
2015,3,D,발달상권,1001115,서울 강남구 강남구청역_2,4144,2520,1624
2015,3,D,발달상권,1001114,강남구 신사역_1,2616,1161,1455
2015,3,D,발달상권,1001113,서울 동작구 노량진1동_1,93,43,50
2015,3,D,발달상권,1001112,서울 강남구 학동역_3,8237,4838,3399
2015,3,D,발달상권,1001111,서울 강남구 강남구청역_1,3080,1795,1285
2015,3,D,발달상권,1001110,잠실역,5451,4128,1323
2015,3,D,발달상권,1001109,강남구 논현역_4,8275,3749,4526
2015,3,D,발달상권,1001108,학동역,878,427,451
2015,3,D,발달상권,1001107,방이동 먹자골목,5732,3932,1800
2015,3,D,발달상권,1001106,서울 강남구 학동역_2,5730,2722,3008
2015,3,D,발달상권,1001105,서울 동작구 노량진역,3454,2022,1432
2015,3,D,발달상권,1001104,삼성역_3,9386,5407,3979
2015,3,D,발달상권,1001103,코엑스,20112,11820,8292
2015,3,D,발달상권,1001102,서울 강남구 학동역_1,5716,3492,2224
2015,3,D,발달상권,1001101,선정릉역_2,6144,3769,2375
2015,3,D,발달상권,1001100,강남구 논현역_3,1465,850,615
2015,3,D,발달상권,1001099,포스코사거리_2,7635,4698,2937
2015,3,D,발달상권,1001098,포스코사거리_1,49500,32581,16919
2015,3,D,발달상권,1001097,잠실역 롯데월드,3119,1555,1564
2015,3,D,발달상권,1001096,신도림역,3816,2105,1711
2015,3,D,발달상권,1001095,강남구 논현역_2,7585,3554,4031
2015,3,D,발달상권,1001094,선정릉역_1,1536,1050,486
2015,3,D,발달상권,1001093,신천역,5891,3231,2660
2015,3,D,발달상권,1001092,강남구 논현역_1,3121,2030,1091
2015,3,D,발달상권,1001091,삼성역_2,18338,10881,7457
2015,3,D,발달상권,1001090,삼정역_2,2572,1125,1447
2015,3,D,발달상권,1001089,삼정역_1,2982,1586,1396
2015,3,D,발달상권,1001088,삼성역_1,27937,18020,9917
2015,3,D,발달상권,1001087,서울 강남구 선릉역_2,7008,4398,2610
2015,3,D,발달상권,1001086,고속터미널역,15210,4715,10495
2015,3,D,발달상권,1001085,서울 서초구 강남역,32768,18661,14107
2015,3,D,발달상권,1001084,서울 강남구 선릉역_1,20499,9065,11434
2015,3,D,발달상권,1001082,선릉역_2,20180,11037,9143
2015,3,D,발달상권,1001081,서울 강남구 역삼역_2,27354,21522,5832
2015,3,D,발달상권,1001080,서울 송파구 석촌역_1,39,26,13
2015,3,D,발달상권,1001078,서울 강남구 강남역_2,6456,4162,2294
2015,3,D,발달상권,1001077,선릉역_1,56948,29569,27379
2015,3,D,발달상권,1001076,구로역,157,91,66
2015,3,D,발달상권,1001075,역삼역_2,3883,2174,1709
2015,3,D,발달상권,1001074,대림역_2,6950,5401,1549
2015,3,D,발달상권,1001073,서울 강남구 역삼역_1,26140,16356,9784
2015,3,D,발달상권,1001072,신대방삼거리역,297,165,132
2015,3,D,발달상권,1001071,서울 강남구 한티역,1292,495,797
2015,3,D,발달상권,1001070,은마아파트입구사거리_4,65,42,23
2015,3,D,발달상권,1001067,오류동역,1305,686,619
2015,3,D,발달상권,1001066,서울 강남구 강남역,38850,18015,20835
2015,3,D,발달상권,1001063,교대역_4,4907,2934,1973
2015,3,D,발달상권,1001062,서울 강남구 강남역_1,137795,100391,37404
2015,3,D,발달상권,1001061,방배동카페골목,113,43,70
2015,3,D,발달상권,1001060,가락시장,15561,10071,5490
2015,3,D,발달상권,1001059,교대역_3,4376,2722,1654
2015,3,D,발달상권,1001058,역삼역_1,1743,946,797
2015,3,D,발달상권,1001057,교대역_2,3263,2070,1193
2015,3,D,발달상권,1001056,서울 송파구 가락시장역,5166,3330,1836
2015,3,D,발달상권,1001055,서울 서초구 서초역,11056,4719,6337
2015,3,D,발달상권,1001054,서울 강남구 대치역_2,1359,859,500
2015,3,D,발달상권,1001052,뱅뱅사거리_2,23561,14998,8563
2015,3,D,발달상권,1001051,보라매공원,14379,8359,6020
2015,3,D,발달상권,1001050,교대역_1,13151,7745,5406
2015,3,D,발달상권,1001049,개봉동 현대아파트 인근,170,83,87
2015,3,D,발달상권,1001048,뱅뱅사거리,10273,7075,3198
2015,3,D,발달상권,1001047,뱅뱅사거리_1,9554,6787,2767
2015,3,D,발달상권,1001046,서울 관악구 신림역_4,948,466,482
2015,3,D,발달상권,1001045,동작구 총신대입구역_1,228,105,123
2015,3,D,발달상권,1001044,양재역_3,3194,2187,1007
2015,3,D,발달상권,1001043,동작구 총신대입구역_2,1191,606,585
2015,3,D,발달상권,1001042,서울 서초구 남부터미널역_3,1594,980,614
2015,3,D,발달상권,1001041,서울 강남구 수서역,18011,10591,7420
2015,3,D,발달상권,1001039,서울 서초구 남부터미널역_2,11095,5450,5645
2015,3,D,발달상권,1001038,구로디지탈1단지,63830,41310,22520
2015,3,D,발달상권,1001037,양재역,130,69,61
2015,3,D,발달상권,1001035,매봉역,330,157,173
2015,3,D,발달상권,1001034,서울 서초구 방배역,3861,2288,1573
2015,3,D,발달상권,1001033,서울 서초구 남부터미널역_1,738,522,216
2015,3,D,발달상권,1001032,서울 관악구 신림역_2,26,11,15
2015,3,D,발달상권,1001031,서울 관악구 신림역_1,1783,842,941
2015,3,D,발달상권,1001030,양재역_2,8292,4578,3714
2015,3,D,발달상권,1001029,양재역_1,874,613,261
2015,3,D,발달상권,1001028,서울 관악구 서울대입구역_2,42,4,38
2015,3,D,발달상권,1001027,가산디지털단지역_3,30183,18185,11998
2015,3,D,발달상권,1001026,구로디지털단지역,2678,1844,834
2015,3,D,발달상권,1001025,서울 관악구 서울대입구역_1,1832,788,1044
2015,3,D,발달상권,1001024,관악구 사당역_1,3890,1658,2232
2015,3,D,발달상권,1001023,가산디지털단지역_2,59934,36244,23690
2015,3,D,발달상권,1001022,관악구 사당역_2,385,189,196
2015,3,D,발달상권,1001021,가산디지털단지역_1,24455,16478,7977
2015,3,D,발달상권,1001020,장지역,3770,2410,1360
2015,3,D,발달상권,1001019,포이사거리_1,5603,3065,2538
2015,3,D,발달상권,1001018,포이사거리_2,7363,4805,2558
2015,3,D,발달상권,1001016,서울 관악구 대학동_1,80,50,30
2015,3,D,발달상권,1001015,서울 금천구 독산1동_1,2870,2064,806
2015,3,D,발달상권,1001013,양재 화물트럭터미널앞_2,207,97,110
2015,3,D,발달상권,1001012,양재 화물트럭터미널앞_1,4134,3242,892
2015,3,D,발달상권,1001011,서울 금천구 시흥1동_4,944,497,447
2015,3,A,골목상권,1001010,풍성로37가길,40,18,22
2015,3,A,골목상권,1001009,천호옛길,540,383,157
2015,3,A,골목상권,1001008,천호옛14길,557,280,277
2015,3,A,골목상권,1001007,천호대로219길,869,513,356
2015,3,A,골목상권,1001006,천호대로197길,17,4,13
2015,3,A,골목상권,1001005,천호대로187길,838,498,340
2015,3,A,골목상권,1001004,천호대로170길,397,149,248
2015,3,A,골목상권,1001003,천호대로162길,1030,725,305
2015,3,A,골목상권,1001002,천중로51길,412,226,186
2015,3,A,골목상권,1001001,천중로39길,594,206,388
2015,3,A,골목상권,1001000,진황도로47길,1051,557,494
2015,3,A,골목상권,1000999,진황도로27길,449,268,181
2015,3,A,골목상권,1000998,올림픽로98길,55,33,22
2015,3,A,골목상권,1000995,올림픽로77길,8,5,3
2015,3,A,골목상권,1000994,올림픽로71길,346,258,88
2015,3,A,골목상권,1000993,올림픽로48길,5728,3535,2193
2015,3,A,골목상권,1000992,양재대로96길,1361,866,495
2015,3,A,골목상권,1000991,양재대로95길,587,329,258
2015,3,A,골목상권,1000990,양재대로91길,978,531,447
2015,3,A,골목상권,1000989,양재대로133길,276,108,168
2015,3,A,골목상권,1000988,양재대로124길,556,348,208
2015,3,A,골목상권,1000987,양재대로116길,206,90,116
2015,3,A,골목상권,1000986,양재대로101길,1334,747,587
2015,3,A,골목상권,1000985,암사길,365,158,207
2015,3,A,골목상권,1000984,성안로3길,1478,922,556
2015,3,A,골목상권,1000983,성내로5길,986,527,459
2015,3,A,골목상권,1000982,상일로5길,54,31,23
2015,3,A,골목상권,1000981,상암로5길,447,193,254
2015,3,A,골목상권,1000980,상암로51길,716,304,412
2015,3,A,골목상권,1000979,상암로4길,213,170,43
2015,3,A,골목상권,1000978,상암로14길,432,250,182
2015,3,A,골목상권,1000977,명일로13길,124,52,72
2015,3,A,골목상권,1000976,동남로85길,134,73,61
2015,3,A,골목상권,1000975,동남로82길,12,5,7
2015,3,A,골목상권,1000974,동남로65길,86,31,55
2015,3,A,골목상권,1000973,구천면로42길,360,169,191
2015,3,A,골목상권,1000972,구천면로41길,576,250,326
2015,3,A,골목상권,1000971,구천면로36길,53,33,20
2015,3,A,골목상권,1000969,고덕로25길,6,4,2
2015,3,A,골목상권,1000968,고덕로10길,142,70,72
2015,3,A,골목상권,1000967,강동대로53길,827,466,361
2015,3,A,골목상권,1000966,풍성로25길,862,391,471
2015,3,A,골목상권,1000965,오금로46길,1394,703,691
2015,3,A,골목상권,1000964,오금로36길,1605,1286,319
2015,3,A,골목상권,1000963,오금로11길,2246,1447,799
2015,3,A,골목상권,1000962,양재대로72길,677,381,296
2015,3,A,골목상권,1000961,양재대로71길,1091,660,431
2015,3,A,골목상권,1000960,양재대로64길,1547,656,891
2015,3,A,골목상권,1000959,양재대로62길,5847,3584,2263
2015,3,A,골목상권,1000958,송파대로30길,1607,1030,577
2015,3,A,골목상권,1000957,송이로36길,1895,1371,524
2015,3,A,골목상권,1000956,송이로32길,760,420,340
2015,3,A,골목상권,1000955,송이로23길,1792,1014,778
2015,3,A,골목상권,1000954,삼전로13길,1812,1040,772
2015,3,A,골목상권,1000953,백제고분로50길,3385,1663,1722
2015,3,A,골목상권,1000952,백제고분로46길,1627,1036,591
2015,3,A,골목상권,1000951,백제고분로45길,493,333,160
2015,3,A,골목상권,1000950,백제고분로42길,117,77,40
2015,3,A,골목상권,1000949,백제고분로39길,1354,1041,313
2015,3,A,골목상권,1000948,백제고분로34길,1635,1091,544
2015,3,A,골목상권,1000947,백제고분로33길,827,526,301
2015,3,A,골목상권,1000946,백제고분로32길,1038,453,585
2015,3,A,골목상권,1000945,백제고분로31길,296,190,106
2015,3,A,골목상권,1000944,백제고분로22길,1083,641,442
2015,3,A,골목상권,1000943,백제고분로21길,204,139,65
2015,3,A,골목상권,1000942,마천로51길,123,44,79
2015,3,A,골목상권,1000941,동남로20길,178,98,80
2015,3,A,골목상권,1000940,거마로20길,387,175,212
2015,3,A,골목상권,1000939,학동로77길,2926,1500,1426
2015,3,A,골목상권,1000938,학동로6길,1988,1088,900
2015,3,A,골목상권,1000937,학동로56길,979,595,384
2015,3,A,골목상권,1000936,학동로38길,6746,4428,2318
2015,3,A,골목상권,1000935,테헤란로81길,621,171,450
2015,3,A,골목상권,1000934,일원로9길,490,273,217
2015,3,A,골목상권,1000933,일원로3길,218,96,122
2015,3,A,골목상권,1000932,영동대로65길,3096,1832,1264
2015,3,A,골목상권,1000931,영동대로112길,705,494,211
2015,3,A,골목상권,1000930,언주로81길,8354,3980,4374
2015,3,A,골목상권,1000929,압구정로2길,2591,1365,1226
2015,3,A,골목상권,1000928,선릉로18길,513,302,211
2015,3,A,골목상권,1000927,선릉로146길,1722,909,813
2015,3,A,골목상권,1000926,선릉로133길,139,72,67
2015,3,A,골목상권,1000925,선릉로132길,947,496,451
2015,3,A,골목상권,1000924,선릉로121길,1656,882,774
2015,3,A,골목상권,1000923,삼성로75길,2634,1438,1196
2015,3,A,골목상권,1000922,삼성로69길,259,147,112
2015,3,A,골목상권,1000921,삼성로64길,626,329,297
2015,3,A,골목상권,1000920,삼성로63길,154,74,80
2015,3,A,골목상권,1000919,삼성로57길,864,265,599
2015,3,A,골목상권,1000918,삼성로147길,803,342,461
2015,3,A,골목상권,1000917,삼성로115길,320,198,122
2015,3,A,골목상권,1000916,봉은사로68길,199,103,96
2015,3,A,골목상권,1000915,봉은사로57길,571,397,174
2015,3,A,골목상권,1000914,봉은사로43길,958,612,346
2015,3,A,골목상권,1000913,봉은사로29길,145,95,50
2015,3,A,골목상권,1000912,봉은사로109길,294,169,125
2015,3,A,골목상권,1000911,도산대로89길,2450,973,1477
2015,3,A,골목상권,1000910,도산대로81길,4620,1510,3110
2015,3,A,골목상권,1000909,도산대로50길,2717,1937,780
2015,3,A,골목상권,1000908,도산대로38길,172,95,77
2015,3,A,골목상권,1000907,도산대로30길,2936,1434,1502
2015,3,A,골목상권,1000906,도산대로23길,1318,787,531
2015,3,A,골목상권,1000905,도산대로15길,1943,899,1044
2015,3,A,골목상권,1000904,도곡로37길,3335,2224,1111
2015,3,A,골목상권,1000903,논현로8길,777,417,360
2015,3,A,골목상권,1000902,논현로63길,9579,2756,6823
2015,3,A,골목상권,1000901,논현로28길,12967,9386,3581
2015,3,A,골목상권,1000900,논현로26길,6217,3937,2280
2015,3,A,골목상권,1000898,논현로139길,1847,1080,767
2015,3,A,골목상권,1000897,논현로123길,109,68,41
2015,3,A,골목상권,1000896,논현로115길,3165,1788,1377
2015,3,A,골목상권,1000895,논현로10길,2272,1474,798
2015,3,A,골목상권,1000894,논현로106길,2821,1537,1284
2015,3,A,골목상권,1000893,남부순환로365길,186,142,44
2015,3,A,골목상권,1000891,개포로28길,298,218,80
2015,3,A,골목상권,1000890,개포로20길,4156,2337,1819
2015,3,A,골목상권,1000889,개포로17길,3455,1990,1465
2015,3,A,골목상권,1000888,강남대로140길,4382,2392,1990
2015,3,A,골목상권,1000887,강남대로136길,1139,660,479
2015,3,A,골목상권,1000886,강남대로118길,610,333,277
2015,3,A,골목상권,1000885,서초중앙로8길,5426,4156,1270
2015,3,A,골목상권,1000884,방배중앙로21길,2123,701,1422
2015,3,A,골목상권,1000883,효령로72길,194,113,81
2015,3,A,골목상권,1000882,효령로34길,82,37,45
2015,3,A,골목상권,1000881,효령로31길,1467,877,590
2015,3,A,골목상권,1000880,효령로23길,724,442,282
2015,3,A,골목상권,1000879,청두곶길,1882,1319,563
2015,3,A,골목상권,1000878,주흥길,354,225,129
2015,3,A,골목상권,1000877,주흥15길,1435,919,516
2015,3,A,골목상권,1000876,언남길,1951,1432,519
2015,3,A,골목상권,1000875,신반포로45길,453,285,168
2015,3,A,골목상권,1000874,서초대로8길,276,193,83
2015,3,A,골목상권,1000873,서초대로64길,518,352,166
2015,3,A,골목상권,1000872,서초대로4길,848,626,222
2015,3,A,골목상권,1000871,서초대로25길,3442,2011,1431
2015,3,A,골목상권,1000870,서초대로23길,866,491,375
2015,3,A,골목상권,1000869,서초대로15길,1068,514,554
2015,3,A,골목상권,1000868,사평대로57길,216,83,133
2015,3,A,골목상권,1000867,사평대로26길,15,11,4
2015,3,A,골목상권,1000866,사평대로22길,1360,847,513
2015,3,A,골목상권,1000865,사임당로17길,1552,979,573
2015,3,A,골목상권,1000864,방배로42길,186,85,101
2015,3,A,골목상권,1000863,방배로35길,2228,1435,793
2015,3,A,골목상권,1000862,방배로18길,69,36,33
2015,3,A,골목상권,1000861,반포대로9길,706,486,220
2015,3,A,골목상권,1000860,바우뫼로39길,2987,1836,1151
2015,3,A,골목상권,1000859,마방로2길,3621,2394,1227
2015,3,A,골목상권,1000858,방배천로4안길,1572,851,721
2015,3,A,골목상권,1000857,동산로19길,1358,938,420
2015,3,A,골목상권,1000856,동산로10길,2188,1224,964
2015,3,A,골목상권,1000855,동광로39길,47,28,19
2015,3,A,골목상권,1000854,동광로1길,1341,832,509
2015,3,A,골목상권,1000853,동광로12길,701,473,228
2015,3,A,골목상권,1000852,논현로27길,3638,2644,994
2015,3,A,골목상권,1000851,논현로1길,602,362,240
2015,3,A,골목상권,1000850,남부순환로339길,11537,5060,6477
2015,3,A,골목상권,1000849,남부순환로325길,7547,4029,3518
2015,3,A,골목상권,1000848,남부순환로317길,1584,1155,429
2015,3,A,골목상권,1000847,고무래로8길,6857,3838,3019
2015,3,A,골목상권,1000846,강남대로8길,3019,2046,973
2015,3,A,골목상권,1000845,강남대로34길,931,638,293
2015,3,A,골목상권,1000844,강남대로23길,5774,4221,1553
2015,3,A,골목상권,1000843,소담길,26,8,18
2015,3,A,골목상권,1000842,원신길,273,114,159
2015,3,A,골목상권,1000840,양산길,440,314,126
2015,3,A,골목상권,1000839,호암로24길,573,224,349
2015,3,A,골목상권,1000838,호암로20길,45,31,14
2015,3,A,골목상권,1000837,행운길,19,2,17
2015,3,A,골목상권,1000836,행운1길,76,49,27
2015,3,A,골목상권,1000835,청림3길,30,18,12
2015,3,A,골목상권,1000834,청룡길,225,133,92
2015,3,A,골목상권,1000833,청룡8길,8,4,4
2015,3,A,골목상권,1000832,중앙길,290,109,181
2015,3,A,골목상권,1000831,조원중앙로2길,1073,743,330
2015,3,A,골목상권,1000830,조원로18길,948,492,456
2015,3,A,골목상권,1000829,조원로10길,272,131,141
2015,3,A,골목상권,1000828,장군봉2길,322,141,181
2015,3,A,골목상권,1000827,장군봉1길,100,13,87
2015,3,A,골목상권,1000826,인헌길,78,38,40
2015,3,A,골목상권,1000825,은천로25길,286,94,192
2015,3,A,골목상권,1000824,양녕로6길,913,586,327
2015,3,A,골목상권,1000823,신원로3길,26,18,8
2015,3,A,골목상권,1000822,신사로20길,60,33,27
2015,3,A,골목상권,1000820,신림로64길,227,125,102
2015,3,A,골목상권,1000819,신림로48길,82,47,35
2015,3,A,골목상권,1000818,신림로38길,46,20,26
2015,3,A,골목상권,1000817,신림로28길,308,220,88
2015,3,A,골목상권,1000816,신림로11길,442,408,34
2015,3,A,골목상권,1000815,신림동길,438,271,167
2015,3,A,골목상권,1000814,승방길,499,319,180
2015,3,A,골목상권,1000813,서림7길,246,89,157
2015,3,A,골목상권,1000812,봉천로33길,337,221,116
2015,3,A,골목상권,1000811,봉천로13길,271,78,193
2015,3,A,골목상권,1000810,복은길,196,73,123
2015,3,A,골목상권,1000809,법원단지길,2,1,1
2015,3,A,골목상권,1000808,법원단지9길,85,32,53
2015,3,A,골목상권,1000807,미성5길,55,26,29
2015,3,A,골목상권,1000806,대학길,68,32,36
2015,3,A,골목상권,1000805,대학14길,12,2,10
2015,3,A,골목상권,1000804,당곡길,339,151,188
2015,3,A,골목상권,1000803,남현길,211,72,139
2015,3,A,골목상권,1000802,남현3길,521,305,216
2015,3,A,골목상권,1000800,남부순환로248길,271,138,133
2015,3,A,골목상권,1000799,남부순환로234길,126,82,44
2015,3,A,골목상권,1000798,남부순환로172길,1603,912,691
2015,3,A,골목상권,1000797,남부순환로161길,15,4,11
2015,3,A,골목상권,1000796,남부순환로151길,122,74,48
2015,3,A,골목상권,1000795,남부순환로142길,54,20,34
2015,3,A,골목상권,1000794,난향길,161,38,123
2015,3,A,골목상권,1000793,난우길,416,188,228
2015,3,A,골목상권,1000792,난곡로74길,161,62,99
2015,3,A,골목상권,1000791,난곡로34길,26,9,17
2015,3,A,골목상권,1000790,난곡로26길,91,39,52
2015,3,A,골목상권,1000789,난곡로24길,34,15,19
2015,3,A,골목상권,1000788,낙성대역길,776,492,284
2015,3,A,골목상권,1000787,국회단지길,515,230,285
2015,3,A,골목상권,1000786,구암길,73,29,44
2015,3,A,골목상권,1000785,관천로22길,17,7,10
2015,3,A,골목상권,1000784,관천로15길,129,70,59
2015,3,A,골목상권,1000783,관악로30길,200,63,137
2015,3,A,골목상권,1000782,관악로28길,152,76,76
2015,3,A,골목상권,1000781,관악로14길,473,269,204
2015,3,A,골목상권,1000780,관악로10길,252,179,73
2015,3,A,골목상권,1000779,흑석로9길,181,75,106
2015,3,A,골목상권,1000778,흑석로13길,145,23,122
2015,3,A,골목상권,1000777,장승배기로27길,31,15,16
2015,3,A,골목상권,1000776,장승배기로19길,2,1,1
2015,3,A,골목상권,1000774,여의대방로46길,374,110,264
2015,3,A,골목상권,1000773,여의대방로24길,14842,6826,8016
2015,3,A,골목상권,1000772,여의대방로22카길,254,102,152
2015,3,A,골목상권,1000771,여의대방로22나길,129,46,83
2015,3,A,골목상권,1000770,여의대방로22길,246,122,124
2015,3,A,골목상권,1000769,양녕로26길,125,66,59
2015,3,A,골목상권,1000768,신대방길,116,77,39
2015,3,A,골목상권,1000766,성대로1길,340,138,202
2015,3,A,골목상권,1000765,서달로8가길,196,82,114
2015,3,A,골목상권,1000763,서달로14길,40,16,24
2015,3,A,골목상권,1000762,서달로10길,73,31,42
2015,3,A,골목상권,1000761,상도로62길,176,62,114
2015,3,A,골목상권,1000760,상도로61길,63,35,28
2015,3,A,골목상권,1000759,상도로47길,70,50,20
2015,3,A,골목상권,1000758,상도로37길,1919,990,929
2015,3,A,골목상권,1000757,상도로15길,286,134,152
2015,3,A,골목상권,1000756,사당로8길,127,67,60
2015,3,A,골목상권,1000755,사당로30길,323,221,102
2015,3,A,골목상권,1000754,사당로2차길,89,54,35
2015,3,A,골목상권,1000753,사당로29길,18,15,3
2015,3,A,골목상권,1000752,사당로26길,251,143,108
2015,3,A,골목상권,1000751,사당로23나길,136,44,92
2015,3,A,골목상권,1000750,사당로23길,25,19,6
2015,3,A,골목상권,1000749,사당로20길,164,116,48
2015,3,A,골목상권,1000748,사당로16길,124,35,89
2015,3,A,골목상권,1000747,사당로16가길,870,558,312
2015,3,A,골목상권,1000746,만양로8길,65,27,38
2015,3,A,골목상권,1000745,만양로14길,399,186,213
2015,3,A,골목상권,1000744,등용로14길,539,413,126
2015,3,A,골목상권,1000743,동작대로7길,1711,751,960
2015,3,A,골목상권,1000742,동작대로35길,243,92,151
2015,3,A,골목상권,1000741,동작대로33길,112,61,51
2015,3,A,골목상권,1000740,동작대로29길,45,24,21
2015,3,A,골목상권,1000739,동작대로17길,1329,730,599
2015,3,A,골목상권,1000738,대방동2길,444,210,234
2015,3,A,골목상권,1000737,대방동27길,127,68,59
2015,3,A,골목상권,1000736,노량진로6길,115,32,83
2015,3,A,골목상권,1000735,국사봉길,32,5,27
2015,3,A,골목상권,1000734,국사봉2길,94,60,34
2015,3,A,골목상권,1000733,국사봉1길,7,3,4
2015,3,A,골목상권,1000732,영신로9길,310,157,153
2015,3,A,골목상권,1000731,영등포로84길,321,83,238
2015,3,A,골목상권,1000730,영등포로80길,64,39,25
2015,3,A,골목상권,1000729,영등포로62길,3,2,1
2015,3,A,골목상권,1000728,영등포로35길,48,35,13
2015,3,A,골목상권,1000727,영등포로27길,303,171,132
2015,3,A,골목상권,1000724,여의대방로43나길,2276,1857,419
2015,3,A,골목상권,1000723,여의대방로39길,16,12,4
2015,3,A,골목상권,1000722,여의대방로35길,711,381,330
2015,3,A,골목상권,1000721,양평로28길,665,537,128
2015,3,A,골목상권,1000720,양평로22라길,44,27,17
2015,3,A,골목상권,1000719,양평로19길,3810,3112,698
2015,3,A,골목상권,1000718,신길로60길,418,175,243
2015,3,A,골목상권,1000717,신길로42길,389,202,187
2015,3,A,골목상권,1000716,신길로42가길,90,27,63
2015,3,A,골목상권,1000715,신길로39길,106,49,57
2015,3,A,골목상권,1000714,신길로17길,44,30,14
2015,3,A,골목상권,1000713,선유서로28길,412,227,185
2015,3,A,골목상권,1000712,선유서로25길,2218,1653,565
2015,3,A,골목상권,1000711,선유서로24길,151,84,67
2015,3,A,골목상권,1000710,선유로55길,2223,1398,825
2015,3,A,골목상권,1000709,디지털로74길,55,33,22
2015,3,A,골목상권,1000708,디지털로57길,7,2,5
2015,3,A,골목상권,1000707,디지털로37길,210,103,107
2015,3,A,골목상권,1000706,도신로62길,196,50,146
2015,3,A,골목상권,1000705,도신로60길,86,12,74
2015,3,A,골목상권,1000704,도신로29길,72,37,35
2015,3,A,골목상권,1000703,도신로15길,82,46,36
2015,3,A,골목상권,1000702,도림천로21길,99,49,50
2015,3,A,골목상권,1000701,도림로63길,34,21,13
2015,3,A,골목상권,1000700,도림로147길,1562,1164,398
2015,3,A,골목상권,1000699,도림로112길,8,7,1
2015,3,A,골목상권,1000698,대림로8길,1846,629,1217
2015,3,A,골목상권,1000697,대림로7길,15,5,10
2015,3,A,골목상권,1000696,대림로44길,44,26,18
2015,3,A,골목상권,1000695,대림로34길,180,71,109
2015,3,A,골목상권,1000694,대림로31길,872,444,428
2015,3,A,골목상권,1000693,대림로29길,1509,723,786
2015,3,A,골목상권,1000692,대림로22길,291,166,125
2015,3,A,골목상권,1000691,당산로46길,3136,1716,1420
2015,3,A,골목상권,1000690,당산로38길,337,267,70
2015,3,A,골목상권,1000689,당산로37길,3436,2175,1261
2015,3,A,골목상권,1000688,당산로31길,3977,2217,1760
2015,3,A,골목상권,1000687,국회대로56길,1542,980,562
2015,3,A,골목상권,1000686,경인로90길,321,199,122
2015,3,A,골목상권,1000685,경인로80길,1576,1146,430
2015,3,A,골목상권,1000684,경인로77길,611,441,170
2015,3,A,골목상권,1000683,가마산로61길,202,84,118
2015,3,A,골목상권,1000682,시흥대로94길,758,398,360
2015,3,A,골목상권,1000681,시흥대로84길,170,66,104
2015,3,A,골목상권,1000680,시흥대로68길,344,122,222
2015,3,A,골목상권,1000679,시흥대로63길,2664,1417,1247
2015,3,A,골목상권,1000678,시흥대로62가길,421,115,306
2015,3,A,골목상권,1000677,시흥대로36길,342,206,136
2015,3,A,골목상권,1000676,시흥대로22길,467,336,131
2015,3,A,골목상권,1000675,시흥대로153길,658,364,294
2015,3,A,골목상권,1000674,시흥대로150길,550,248,302
2015,3,A,골목상권,1000673,시흥대로141길,670,407,263
2015,3,A,골목상권,1000672,시흥대로138길,14,7,7
2015,3,A,골목상권,1000671,시흥대로120길,538,360,178
2015,3,A,골목상권,1000670,벚꽃로56길,1697,1187,510
2015,3,A,골목상권,1000669,범안로17길,186,91,95
2015,3,A,골목상권,1000668,범안로11길,1045,853,192
2015,3,A,골목상권,1000667,문성로5길,170,53,117
2015,3,A,골목상권,1000666,독산로85길,69,24,45
2015,3,A,골목상권,1000665,독산로78다길,234,99,135
2015,3,A,골목상권,1000664,독산로70길,4,3,1
2015,3,A,골목상권,1000663,독산로64길,155,40,115
2015,3,A,골목상권,1000662,독산로50길,49,24,25
2015,3,A,골목상권,1000661,독산로40길,50,18,32
2015,3,A,골목상권,1000660,독산로108길,768,328,440
2015,3,A,골목상권,1000659,남부순환로112길,9,5,4
2015,3,A,골목상권,1000658,금하로24길,163,56,107
2015,3,A,골목상권,1000657,금하로1길,54,27,27
2015,3,A,골목상권,1000656,금하로14길,2,1,1
2015,3,A,골목상권,1000655,가산로5길,504,392,112
2015,3,A,골목상권,1000654,가산로3길,2494,1914,580
2015,3,A,골목상권,1000653,중앙로1길,1390,992,398
2015,3,A,골목상권,1000652,중앙로15길,195,63,132
2015,3,A,골목상권,1000651,우마길,30,19,11
2015,3,A,골목상권,1000650,오류로8길,212,101,111
2015,3,A,골목상권,1000649,신도림로13길,697,536,161
2015,3,A,골목상권,1000648,새말로18길,1158,439,719
2015,3,A,골목상권,1000647,부일로1길,768,627,141
2015,3,A,골목상권,1000646,부일로15길,182,156,26
2015,3,A,골목상권,1000645,부일로11길,24,7,17
2015,3,A,골목상권,1000644,디지털로32길,1246,683,563
2015,3,A,골목상권,1000643,디지털로32가길,6866,4903,1963
2015,3,A,골목상권,1000642,디지털로27길,398,250,148
2015,3,A,골목상권,1000641,도림로6길,120,52,68
2015,3,A,골목상권,1000640,도림로12길,94,37,57
2015,3,A,골목상권,1000639,남부순환로97길,258,80,178
2015,3,A,골목상권,1000638,구로중앙로8길,254,103,151
2015,3,A,골목상권,1000637,구로중앙로7길,182,71,111
2015,3,A,골목상권,1000636,구로중앙로42길,726,563,163
2015,3,A,골목상권,1000635,구로중앙로34길,566,316,250
2015,3,A,골목상권,1000634,구로중앙로28길,2863,1405,1458
2015,3,A,골목상권,1000633,구로중앙로19길,11,6,5
2015,3,A,골목상권,1000632,구로동로8길,158,54,104
2015,3,A,골목상권,1000631,구로동로7길,164,65,99
2015,3,A,골목상권,1000630,구로동로42길,27,20,7
2015,3,A,골목상권,1000629,구로동로41길,455,277,178
2015,3,A,골목상권,1000628,구로동로38길,46,20,26
2015,3,A,골목상권,1000627,구로동로28길,178,70,108
2015,3,A,골목상권,1000626,구로동로15길,23,2,21
2015,3,A,골목상권,1000625,공원로6가길,248,186,62
2015,3,A,골목상권,1000624,고척로52길,232,75,157
2015,3,A,골목상권,1000623,고척로27다길,206,82,124
2015,3,A,골목상권,1000622,고척로27길,229,91,138
2015,3,A,골목상권,1000621,고척로21나길,257,56,201
2015,3,A,골목상권,1000620,경인로47길,771,433,338
2015,3,A,골목상권,1000619,경인로35길,274,121,153
2015,3,A,골목상권,1000618,경인로31길,51,14,37
2015,3,A,골목상권,1000617,경인로15길,112,52,60
2015,3,A,골목상권,1000616,개봉로3길,303,178,125
2015,3,A,골목상권,1000615,개봉로2길,476,119,357
2015,3,A,골목상권,1000614,개봉로23가길,872,497,375
2015,3,A,골목상권,1000613,개봉로20길,114,64,50
2015,3,A,골목상권,1000612,개봉로1길,39,20,19
2015,3,A,골목상권,1000611,개봉로17다길,122,51,71
2015,3,A,골목상권,1000610,개봉로17길,800,380,420
2015,3,A,골목상권,1000609,개봉로11길,49,11,38
2015,3,A,골목상권,1000608,화곡로64길,2502,1314,1188
2015,3,A,골목상권,1000607,화곡로59길,505,202,303
2015,3,A,골목상권,1000606,화곡로44나길,871,731,140
2015,3,A,골목상권,1000605,화곡로31길,1303,559,744
2015,3,A,골목상권,1000604,화곡로20길,494,313,181
2015,3,A,골목상권,1000603,화곡로13길,258,87,171
2015,3,A,골목상권,1000602,초원로16길,472,226,246
2015,3,A,골목상권,1000601,초록마을로8길,174,31,143
2015,3,A,골목상권,1000600,초록마을로3길,44,23,21
2015,3,A,골목상권,1000599,월정로20길,4,1,3
2015,3,A,골목상권,1000598,우장산로6길,321,185,136
2015,3,A,골목상권,1000597,양천로73가길,1391,904,487
2015,3,A,골목상권,1000596,양천로71길,206,127,79
2015,3,A,골목상권,1000595,양천로49길,813,640,173
2015,3,A,골목상권,1000594,양천로26길,101,44,57
2015,3,A,골목상권,1000593,양천로24길,214,106,108
2015,3,A,골목상권,1000592,양천로24가길,685,284,401
2015,3,A,골목상권,1000591,양천로14길,372,220,152
2015,3,A,골목상권,1000590,방화대로6라길,732,483,249
2015,3,A,골목상권,1000589,방화대로21길,746,443,303
2015,3,A,골목상권,1000588,등촌로5길,10,2,8
2015,3,A,골목상권,1000587,등촌로55길,460,335,125
2015,3,A,골목상권,1000586,등촌로51길,9,9,0
2015,3,A,골목상권,1000585,등촌로39길,48,18,30
2015,3,A,골목상권,1000584,등촌로13길,216,109,107
2015,3,A,골목상권,1000583,남부순환로11길,398,282,116
2015,3,A,골목상권,1000582,까치산로4길,125,45,80
2015,3,A,골목상권,1000581,국회대로7길,331,203,128
2015,3,A,골목상권,1000580,공항대로8길,244,141,103
2015,3,A,골목상권,1000579,공항대로61길,233,148,85
2015,3,A,골목상권,1000578,공항대로59다길,855,632,223
2015,3,A,골목상권,1000577,공항대로59길,1228,802,426
2015,3,A,골목상권,1000576,공항대로55길,903,646,257
2015,3,A,골목상권,1000575,공항대로42길,10,6,4
2015,3,A,골목상권,1000574,공항대로38길,236,121,115
2015,3,A,골목상권,1000573,곰달래로60길,538,272,266
2015,3,A,골목상권,1000572,곰달래로53길,59,15,44
2015,3,A,골목상권,1000571,곰달래로47길,30,11,19
2015,3,A,골목상권,1000570,곰달래로31길,10,8,2
2015,3,A,골목상권,1000569,곰달래로25길,521,199,322
2015,3,A,골목상권,1000568,개화동로25길,649,435,214
2015,3,A,골목상권,1000567,개화동로23길,93,56,37
2015,3,A,골목상권,1000566,강서로8길,108,69,39
2015,3,A,골목상권,1000565,강서로5라길,253,150,103
2015,3,A,골목상권,1000564,강서로5나길,112,70,42
2015,3,A,골목상권,1000563,강서로5가길,36,22,14
2015,3,A,골목상권,1000562,강서로47라길,72,40,32
2015,3,A,골목상권,1000561,강서로47길,384,198,186
2015,3,A,골목상권,1000560,강서로45다길,706,230,476
2015,3,A,골목상권,1000559,강서로45길,112,56,56
2015,3,A,골목상권,1000558,강서로35길,155,93,62
2015,3,A,골목상권,1000557,강서로29길,277,151,126
2015,3,A,골목상권,1000556,강서로18길,25,14,11
2015,3,A,골목상권,1000555,강서로17가길,106,44,62
2015,3,A,골목상권,1000554,강서로15길,253,131,122
2015,3,A,골목상권,1000553,가로공원로80길,84,47,37
2015,3,A,골목상권,1000552,가로공원로76가길,20,8,12
2015,3,A,골목상권,1000551,화곡로4길,279,108,171
2015,3,A,골목상권,1000550,화곡로3길,160,50,110
2015,3,A,골목상권,1000549,지양로7길,223,72,151
2015,3,A,골목상권,1000548,중앙로55길,369,195,174
2015,3,A,골목상권,1000547,중앙로51길,114,67,47
2015,3,A,골목상권,1000546,중앙로47길,98,18,80
2015,3,A,골목상권,1000545,중앙로45길,163,55,108
2015,3,A,골목상권,1000544,중앙로36길,2,2,0
2015,3,A,골목상권,1000543,중앙로32길,548,267,281
2015,3,A,골목상권,1000542,중앙로25길,258,74,184
2015,3,A,골목상권,1000541,은행정로7길,445,153,292
2015,3,A,골목상권,1000539,오목로5길,311,176,135
2015,3,A,골목상권,1000538,오목로3길,462,436,26
2015,3,A,골목상권,1000537,오목로30길,162,81,81
2015,3,A,골목상권,1000536,오목로23길,708,380,328
2015,3,A,골목상권,1000535,신월로20길,213,79,134
2015,3,A,골목상권,1000534,신월로15길,758,354,404
2015,3,A,골목상권,1000533,신목로6길,256,133,123
2015,3,A,골목상권,1000532,신목로5길,919,346,573
2015,3,A,골목상권,1000531,신목로2길,99,45,54
2015,3,A,골목상권,1000530,목동중앙서로8가길,202,105,97
2015,3,A,골목상권,1000529,목동중앙서로7길,238,86,152
2015,3,A,골목상권,1000528,목동중앙북로8길,402,177,225
2015,3,A,골목상권,1000527,목동중앙북로16길,260,79,181
2015,3,A,골목상권,1000526,목동중앙본로7길,93,33,60
2015,3,A,골목상권,1000525,목동중앙로3길,103,58,45
2015,3,A,골목상권,1000524,목동중앙로13나길,245,172,73
2015,3,A,골목상권,1000523,목동중앙남로3가길,556,380,176
2015,3,A,골목상권,1000522,목동로9길,2280,1501,779
2015,3,A,골목상권,1000521,목동로19길,963,377,586
2015,3,A,골목상권,1000519,목동동로12길,419,169,250
2015,3,A,골목상권,1000518,목동남로4길,10,5,5
2015,3,A,골목상권,1000517,남부순환로88길,316,129,187
2015,3,A,골목상권,1000516,남부순환로79길,520,388,132
2015,3,A,골목상권,1000515,남부순환로70길,677,490,187
2015,3,A,골목상권,1000514,남부순환로58길,142,77,65
2015,3,A,골목상권,1000513,남부순환로40길,21,12,9
2015,3,A,골목상권,1000512,남부순환로33길,1166,921,245
2015,3,A,골목상권,1000511,곰달래로5길,48,26,22
2015,3,A,골목상권,1000510,곰달래로3길,425,218,207
2015,3,A,골목상권,1000509,곰달래로2길,296,180,116
2015,3,A,골목상권,1000508,곰달래로10길,358,278,80
2015,3,A,골목상권,1000507,가로공원로58길,94,20,74
2015,3,A,골목상권,1000506,효창원로93길,109,57,52
2015,3,A,골목상권,1000505,토정로37길,142,56,86
2015,3,A,골목상권,1000504,월드컵로8길,1537,879,658
2015,3,A,골목상권,1000503,월드컵로7길,4,2,2
2015,3,A,골목상권,1000502,월드컵로36길,115,32,83
2015,3,A,골목상권,1000501,월드컵로25길,292,159,133
2015,3,A,골목상권,1000500,월드컵로19길,419,177,242
2015,3,A,골목상권,1000499,월드컵로16길,2333,1458,875
2015,3,A,골목상권,1000498,월드컵로11길,207,72,135
2015,3,A,골목상권,1000497,월드컵로10길,1711,915,796
2015,3,A,골목상권,1000496,와우산로3길,164,96,68
2015,3,A,골목상권,1000495,와우산로29길,126,63,63
2015,3,A,골목상권,1000494,와우산로29가길,16,5,11
2015,3,A,골목상권,1000493,양화진길,462,330,132
2015,3,A,골목상권,1000492,양화로1길,4265,2218,2047
2015,3,A,골목상권,1000491,양화로11길,386,246,140
2015,3,A,골목상권,1000490,신촌로30길,27,13,14
2015,3,A,골목상권,1000489,신촌로28가길,118,49,69
2015,3,A,골목상권,1000488,신촌로12길,1181,545,636
2015,3,A,골목상권,1000487,숭문길,712,399,313
2015,3,A,골목상권,1000486,숭문8길,114,67,47
2015,3,A,골목상권,1000485,성지3길,498,274,224
2015,3,A,골목상권,1000484,성산로4길,2210,1442,768
2015,3,A,골목상권,1000483,성미산로32길,283,155,128
2015,3,A,골목상권,1000482,성미산로1길,599,478,121
2015,3,A,골목상권,1000481,성미산로11길,970,659,311
2015,3,A,골목상권,1000480,백범로16길,543,289,254
2015,3,A,골목상권,1000479,방울내로9안길,331,197,134
2015,3,A,골목상권,1000478,모래내로7길,244,129,115
2015,3,A,골목상권,1000477,매봉산로2길,1803,1200,603
2015,3,A,골목상권,1000476,망원로2길,190,125,65
2015,3,A,골목상권,1000475,망원로11길,860,473,387
2015,3,A,골목상권,1000474,만리재옛길,1250,508,742
2015,3,A,골목상권,1000473,마포대로4길,292,127,165
2015,3,A,골목상권,1000472,마포대로20길,1197,615,582
2015,3,A,골목상권,1000471,마포대로12길,68,35,33
2015,3,A,골목상권,1000470,동교로38길,198,77,121
2015,3,A,골목상권,1000469,동교로27길,3012,1415,1597
2015,3,A,골목상권,1000468,동교로25길,360,203,157
2015,3,A,골목상권,1000467,동교로19길,4203,2570,1633
2015,3,A,골목상권,1000466,동교로17길,785,394,391
2015,3,A,골목상권,1000465,독막로8길,345,162,183
2015,3,A,골목상권,1000464,독막로32길,464,191,273
2015,3,A,골목상권,1000463,독막로22길,81,43,38
2015,3,A,골목상권,1000462,도화길,1079,534,545
2015,3,A,골목상권,1000461,도화4길,347,118,229
2015,3,A,골목상권,1000460,대흥로28길,60,50,10
2015,3,A,골목상권,1000459,대흥로21길,570,109,461
2015,3,A,골목상권,1000458,광성로6길,105,72,33
2015,3,A,골목상권,1000457,홍제내길,96,56,40
2015,3,A,골목상권,1000456,홍연길,79,49,30
2015,3,A,골목상권,1000455,통일로39길,9,8,1
2015,3,A,골목상권,1000454,통일로37길,367,149,218
2015,3,A,골목상권,1000453,통일로11길,14,11,3
2015,3,A,골목상권,1000452,충정로6길,14839,8168,6671
2015,3,A,골목상권,1000451,충정로4길,2802,1894,908
2015,3,A,골목상권,1000450,증가로6길,247,90,157
2015,3,A,골목상권,1000449,증가로23나길,444,219,225
2015,3,A,골목상권,1000448,증가로20가길,294,103,191
2015,3,A,골목상권,1000447,증가로10길,172,94,78
2015,3,A,골목상권,1000446,응암로1길,317,241,76
2015,3,A,골목상권,1000445,연희로10길,94,63,31
2015,3,A,골목상권,1000444,신촌로37길,155,66,89
2015,3,A,골목상권,1000443,수색로8길,2700,2618,82
2015,3,A,골목상권,1000442,세무서길,327,119,208
2015,3,A,골목상권,1000440,세검정로1길,241,142,99
2015,3,A,골목상권,1000439,북아현로4길,402,95,307
2015,3,A,골목상권,1000438,모래내로15길,86,27,59
2015,3,A,골목상권,1000437,명지대길,335,245,90
2015,3,A,골목상권,1000436,독립문로8길,660,249,411
2015,3,A,골목상권,1000435,가재울로6길,10,7,3
2015,3,A,골목상권,1000434,통일로92길,61,30,31
2015,3,A,골목상권,1000433,통일로87길,218,100,118
2015,3,A,골목상권,1000432,통일로78길,206,64,142
2015,3,A,골목상권,1000430,진흥로1길,538,182,356
2015,3,A,골목상권,1000429,진흥로12길,411,184,227
2015,3,A,골목상권,1000428,증산서길,374,280,94
2015,3,A,골목상권,1000427,증산로9길,92,33,59
2015,3,A,골목상권,1000426,증산로5길,721,367,354
2015,3,A,골목상권,1000425,증산로21길,252,171,81
2015,3,A,골목상권,1000424,증산로17길,774,380,394
2015,3,A,골목상권,1000423,증산로15길,179,64,115
2015,3,A,골목상권,1000422,증산로13길,70,36,34
2015,3,A,골목상권,1000421,응암로34길,94,61,33
2015,3,A,골목상권,1000420,응암로22길,163,56,107
2015,3,A,골목상권,1000419,응암로14길,331,103,228
2015,3,A,골목상권,1000418,응암로13길,233,90,143
2015,3,A,골목상권,1000417,응암로12길,202,94,108
2015,3,A,골목상권,1000416,은평로8길,255,138,117
2015,3,A,골목상권,1000415,은평로3길,298,94,204
2015,3,A,골목상권,1000414,은평로20길,21,9,12
2015,3,A,골목상권,1000413,은평로13길,529,348,181
2015,3,A,골목상권,1000412,은평로10길,311,194,117
2015,3,A,골목상권,1000411,연서로5길,55,23,32
2015,3,A,골목상권,1000410,연서로41길,234,67,167
2015,3,A,골목상권,1000409,연서로3길,114,47,67
2015,3,A,골목상권,1000408,연서로34길,124,36,88
2015,3,A,골목상권,1000407,연서로33길,21,5,16
2015,3,A,골목상권,1000406,연서로29길,317,119,198
2015,3,A,골목상권,1000405,연서로28길,741,368,373
2015,3,A,골목상권,1000404,연서로27길,64,30,34
2015,3,A,골목상권,1000403,연서로21길,269,137,132
2015,3,A,골목상권,1000402,연서로17길,1041,388,653
2015,3,A,골목상권,1000401,연서로16길,323,118,205
2015,3,A,골목상권,1000400,연서로13길,702,232,470
2015,3,A,골목상권,1000399,연서로11길,179,96,83
2015,3,A,골목상권,1000398,역말로9길,21,18,3
2015,3,A,골목상권,1000397,수색로18길,643,530,113
2015,3,A,골목상권,1000396,서오릉로8길,31,14,17
2015,3,A,골목상권,1000395,서오릉로21길,451,143,308
2015,3,A,골목상권,1000394,불광천길,171,82,89
2015,3,A,골목상권,1000393,갈현로7길,968,255,713
2015,3,A,골목상권,1000392,갈현로41길,88,28,60
2015,3,A,골목상권,1000391,갈현로33길,42,11,31
2015,3,A,골목상권,1000390,갈현로1길,134,62,72
2015,3,A,골목상권,1000389,가좌로7길,51,24,27
2015,3,A,골목상권,1000388,한글비석로44길,450,254,196
2015,3,A,골목상권,1000387,한글비석로24길,356,147,209
2015,3,A,골목상권,1000386,한글비석로22길,681,286,395
2015,3,A,골목상권,1000385,석계로1길,106,67,39
2015,3,A,골목상권,1000384,상계로9가길,266,91,175
2015,3,A,골목상권,1000382,상계로12길,13,9,4
2015,3,A,골목상권,1000381,동일로242길,521,411,110
2015,3,A,골목상권,1000380,동일로192길,442,225,217
2015,3,A,골목상권,1000379,동일로173가길,2361,1304,1057
2015,3,A,골목상권,1000378,공릉로58길,92,39,53
2015,3,A,골목상권,1000377,해등로16길,75,60,15
2015,3,A,골목상권,1000376,우이천로4다길,187,109,78
2015,3,A,골목상권,1000375,우이천로32길,95,46,49
2015,3,A,골목상권,1000374,시루봉로23길,37,16,21
2015,3,A,골목상권,1000373,삼양로144길,74,55,19
2015,3,A,골목상권,1000372,방학로6가길,159,90,69
2015,3,A,골목상권,1000371,방학로5길,148,81,67
2015,3,A,골목상권,1000370,방학로15길,330,220,110
2015,3,A,골목상권,1000369,방학로10길,141,76,65
2015,3,A,골목상권,1000367,도봉산4길,314,277,37
2015,3,A,골목상권,1000366,도봉로181길,252,123,129
2015,3,A,골목상권,1000365,도봉로169나길,230,124,106
2015,3,A,골목상권,1000364,도봉로156길,263,144,119
2015,3,A,골목상권,1000363,도봉로152가길,441,384,57
2015,3,A,골목상권,1000362,도봉로147길,613,352,261
2015,3,A,골목상권,1000360,도봉로114길,454,144,310
2015,3,A,골목상권,1000359,도봉로109길,16,6,10
2015,3,A,골목상권,1000358,도당로29길,903,544,359
2015,3,A,골목상권,1000357,도당로19길,164,74,90
2015,3,A,골목상권,1000356,도당로13바길,204,72,132
2015,3,A,골목상권,1000355,도당로13가길,133,60,73
2015,3,A,골목상권,1000354,덕릉로60길,68,39,29
2015,3,A,골목상권,1000353,노해로63다길,494,217,277
2015,3,A,골목상권,1000352,노해로60길,303,140,163
2015,3,A,골목상권,1000351,한천로140길,113,66,47
2015,3,A,골목상권,1000350,한천로139가길,59,34,25
2015,3,A,골목상권,1000349,한천로132길,314,113,201
2015,3,A,골목상권,1000348,한천로130길,274,117,157
2015,3,A,골목상권,1000347,한천로124나길,93,44,49
2015,3,A,골목상권,1000346,한천로109길,603,276,327
2015,3,A,골목상권,1000345,인수봉로79길,167,34,133
2015,3,A,골목상권,1000344,인수봉로72길,89,48,41
2015,3,A,골목상권,1000343,인수봉로56길,9,1,8
2015,3,A,골목상권,1000342,오패산로67길,530,291,239
2015,3,A,골목상권,1000341,오패산로52길,82,24,58
2015,3,A,골목상권,1000339,수유로12길,245,151,94
2015,3,A,골목상권,1000338,솔샘로65길,519,235,284
2015,3,A,골목상권,1000337,솔매로50길,687,276,411
2015,3,A,골목상권,1000336,솔매로45길,250,99,151
2015,3,A,골목상권,1000335,솔매로41길,86,25,61
2015,3,A,골목상권,1000334,삼양로93길,17,4,13
2015,3,A,골목상권,1000333,삼양로77길,403,140,263
2015,3,A,골목상권,1000332,삼양로54길,4,2,2
2015,3,A,골목상권,1000331,삼양로41길,329,154,175
2015,3,A,골목상권,1000329,삼양로24길,77,33,44
2015,3,A,골목상권,1000328,삼양로20길,122,44,78
2015,3,A,골목상권,1000327,삼각산로28길,669,386,283
2015,3,A,골목상권,1000326,도봉로99길,171,98,73
2015,3,A,골목상권,1000325,도봉로8길,266,184,82
2015,3,A,골목상권,1000324,도봉로76길,324,166,158
2015,3,A,골목상권,1000323,도봉로67길,8,4,4
2015,3,A,골목상권,1000322,도봉로45길,156,98,58
2015,3,A,골목상권,1000321,도봉로18길,537,253,284
2015,3,A,골목상권,1000320,도봉로13길,25,10,15
2015,3,A,골목상권,1000319,덕릉로41길,688,577,111
2015,3,A,골목상권,1000318,덕릉로40길,906,693,213
2015,3,A,골목상권,1000317,노해로33길,31,12,19
2015,3,A,골목상권,1000315,노해로17길,241,131,110
2015,3,A,골목상권,1000314,화랑로40길,139,73,66
2015,3,A,골목상권,1000313,화랑로32길,408,295,113
2015,3,A,골목상권,1000312,화랑로1길,191,100,91
2015,3,A,골목상권,1000311,화랑로19길,437,231,206
2015,3,A,골목상권,1000310,화랑로14길,40,19,21
2015,3,A,골목상권,1000309,화랑로13길,101,50,51
2015,3,A,골목상권,1000308,한천로76길,115,68,47
2015,3,A,골목상권,1000307,한천로101가길,66,44,22
2015,3,A,골목상권,1000306,창경궁로43길,30,15,15
2015,3,A,골목상권,1000305,지봉로20길,112,67,45
2015,3,A,골목상권,1000304,종암로5길,107,77,30
2015,3,A,골목상권,1000303,종암로24가길,270,145,125
2015,3,A,골목상권,1000302,종암로21길,122,44,78
2015,3,A,골목상권,1000301,종암로19길,369,108,261
2015,3,A,골목상권,1000300,종암로16길,68,31,37
2015,3,A,골목상권,1000299,정릉로8길,209,124,85
2015,3,A,골목상권,1000298,정릉로27길,211,96,115
2015,3,A,골목상권,1000296,장위로50길,987,540,447
2015,3,A,골목상권,1000295,장월로1길,397,156,241
2015,3,A,골목상권,1000294,인촌로6길,2186,1150,1036
2015,3,A,골목상권,1000293,인촌로5길,26,6,20
2015,3,A,골목상권,1000292,인촌로24길,347,160,187
2015,3,A,골목상권,1000291,개운사길,2756,1817,939
2015,3,A,골목상권,1000290,인촌로1길,143,98,45
2015,3,A,골목상권,1000289,인촌로17가길,2997,1157,1840
2015,3,A,골목상권,1000288,오패산로4길,530,180,350
2015,3,A,골목상권,1000287,오패산로3길,1278,739,539
2015,3,A,골목상권,1000286,오패산로19길,44,19,25
2015,3,A,골목상권,1000285,안암로5길,550,346,204
2015,3,A,골목상권,1000284,아리랑로4길,697,252,445
2015,3,A,골목상권,1000283,솔샘로6길,138,66,72
2015,3,A,골목상권,1000282,성북로8길,61,29,32
2015,3,A,골목상권,1000281,삼양로8길,81,45,36
2015,3,A,골목상권,1000280,삼선교로16가길,668,379,289
2015,3,A,골목상권,1000279,삼선교로10다길,103,34,69
2015,3,A,골목상권,1000278,삼선교로10길,242,101,141
2015,3,A,골목상권,1000277,보문로32길,966,408,558
2015,3,A,골목상권,1000276,보문로31길,820,337,483
2015,3,A,골목상권,1000274,보문로13길,740,425,315
2015,3,A,골목상권,1000273,보국문로16길,279,192,87
2015,3,A,골목상권,1000270,동소문로26가길,244,127,117
2015,3,A,골목상권,1000269,동소문로15길,68,31,37
2015,3,A,골목상권,1000268,동소문로13길,663,322,341
2015,3,A,골목상권,1000267,돌곶이로8길,202,116,86
2015,3,A,골목상권,1000266,돌곶이로41길,27,11,16
2015,3,A,골목상권,1000265,돌곶이로28길,129,74,55
2015,3,A,골목상권,1000264,돌곶이로27길,49,31,18
2015,3,A,골목상권,1000263,돌곶이로22길,103,54,49
2015,3,A,골목상권,1000261,길음로7길,10,6,4
2015,3,A,골목상권,1000260,중랑천로10길,645,349,296
2015,3,A,골목상권,1000259,용마산로94길,431,273,158
2015,3,A,골목상권,1000258,용마산로118길,457,221,236
2015,3,A,골목상권,1000257,용마산로112길,265,130,135
2015,3,A,골목상권,1000256,용마산로100길,481,348,133
2015,3,A,골목상권,1000255,신내로7가길,286,72,214
2015,3,A,골목상권,1000254,사가정로54길,96,30,66
2015,3,A,골목상권,1000253,사가정로42길,66,26,40
2015,3,A,골목상권,1000252,봉화산로56길,564,147,417
2015,3,A,골목상권,1000251,봉화산로4길,316,122,194
2015,3,A,골목상권,1000250,봉화산로30길,381,255,126
2015,3,A,골목상권,1000249,봉우재로33길,59,23,36
2015,3,A,골목상권,1000248,면목로78길,274,158,116
2015,3,A,골목상권,1000247,면목로56길,229,178,51
2015,3,A,골목상권,1000246,면목로55길,419,120,299
2015,3,A,골목상권,1000245,면목로49길,524,171,353
2015,3,A,골목상권,1000244,면목로48길,96,54,42
2015,3,A,골목상권,1000243,면목로45길,83,38,45
2015,3,A,골목상권,1000242,면목로33길,435,160,275
2015,3,A,골목상권,1000241,면목로21길,38,28,10
2015,3,A,골목상권,1000240,망우로73길,10,5,5
2015,3,A,골목상권,1000239,망우로68길,85,37,48
2015,3,A,골목상권,1000238,동일로163길,120,82,38
2015,3,A,골목상권,1000237,동일로157길,186,94,92
2015,3,A,골목상권,1000236,동일로149길,1102,815,287
2015,3,A,골목상권,1000235,동일로140길,222,89,133
2015,3,A,골목상권,1000234,동일로139길,71,45,26
2015,3,A,골목상권,1000233,동일로139가길,1053,627,426
2015,3,A,골목상권,1000232,동일로130길,91,21,70
2015,3,A,골목상권,1000231,동일로123길,191,103,88
2015,3,A,골목상권,1000230,동일로112길,186,72,114
2015,3,A,골목상권,1000229,동일로101길,327,135,192
2015,3,A,골목상권,1000228,동일로100길,35,17,18
2015,3,A,골목상권,1000227,답십리로75길,83,44,39
2015,3,A,골목상권,1000226,공릉로2길,568,278,290
2015,3,A,골목상권,1000225,공릉로12가길,45,29,16
2015,3,A,골목상권,1000224,겸재로54길,95,51,44
2015,3,A,골목상권,1000223,겸재로36길,302,241,61
2015,3,A,골목상권,1000222,겸재로29길,437,190,247
2015,3,A,골목상권,1000221,휘경로3길,196,97,99
2015,3,A,골목상권,1000220,휘경로2길,7,2,5
2015,3,A,골목상권,1000219,휘경로23길,15,0,15
2015,3,A,골목상권,1000218,휘경로14길,102,48,54
2015,3,A,골목상권,1000217,한천로46길,381,123,258
2015,3,A,골목상권,1000216,한천로40길,287,161,126
2015,3,A,골목상권,1000215,한천로33길,78,34,44
2015,3,A,골목상권,1000214,한천로14길,601,372,229
2015,3,A,골목상권,1000213,천호대로97길,338,221,117
2015,3,A,골목상권,1000212,천호대로77길,1926,959,967
2015,3,A,골목상권,1000211,천호대로45길,167,108,59
2015,3,A,골목상권,1000210,천호대로17길,2024,1273,751
2015,3,A,골목상권,1000209,천호대로12길,810,543,267
2015,3,A,골목상권,1000208,천장산로7길,1389,872,517
2015,3,A,골목상권,1000207,제기로5길,198,109,89
2015,3,A,골목상권,1000206,제기로21길,217,142,75
2015,3,A,골목상권,1000205,전농로4길,650,427,223
2015,3,A,골목상권,1000204,전농로3길,96,41,55
2015,3,A,골목상권,1000203,전농로29길,313,152,161
2015,3,A,골목상권,1000202,장한로8길,725,411,314
2015,3,A,골목상권,1000201,장한로5길,2975,2073,902
2015,3,A,골목상권,1000200,장한로27길,176,51,125
2015,3,A,골목상권,1000199,장한로27가길,379,175,204
2015,3,A,골목상권,1000198,장한로26길,564,280,284
2015,3,A,골목상권,1000197,장한로26가길,359,173,186
2015,3,A,골목상권,1000196,장한로25길,1000,464,536
2015,3,A,골목상권,1000195,장한로14길,195,170,25
2015,3,A,골목상권,1000194,이문로42길,237,96,141
2015,3,A,골목상권,1000193,왕산로43길,967,467,500
2015,3,A,골목상권,1000192,왕산로33길,170,115,55
2015,3,A,골목상권,1000191,왕산로32길,13,8,5
2015,3,A,골목상권,1000190,약령시로17길,252,134,118
2015,3,A,골목상권,1000189,서울시립대로4길,795,502,293
2015,3,A,골목상권,1000188,서울시립대로29길,201,118,83
2015,3,A,골목상권,1000187,서울시립대로16길,116,33,83
2015,3,A,골목상권,1000186,사가정로2길,131,97,34
2015,3,A,골목상권,1000185,사가정로23가길,102,67,35
2015,3,A,골목상권,1000184,사가정로13길,307,114,193
2015,3,A,골목상권,1000183,무학로45길,384,213,171
2015,3,A,골목상권,1000182,무학로16길,1084,954,130
2015,3,A,골목상권,1000181,망우로21길,188,104,84
2015,3,A,골목상권,1000180,망우로18길,521,229,292
2015,3,A,골목상권,1000179,망우로18가길,65,21,44
2015,3,A,골목상권,1000178,답십리로72길,11,9,2
2015,3,A,골목상권,1000177,답십리로69길,814,369,445
2015,3,A,골목상권,1000176,답십리로68길,171,110,61
2015,3,A,골목상권,1000175,답십리로64길,324,184,140
2015,3,A,골목상권,1000174,답십리로63길,110,73,37
2015,3,A,골목상권,1000173,답십리로60길,16,9,7
2015,3,A,골목상권,1000172,답십리로56길,8,6,2
2015,3,A,골목상권,1000171,답십리로23길,5,4,1
2015,3,A,골목상권,1000170,난계로30길,144,107,37
2015,3,A,골목상권,1000168,경희대로3길,243,151,92
2015,3,A,골목상권,1000167,천호대로129길,187,63,124
2015,3,A,골목상권,1000166,천호대로123길,353,154,199
2015,3,A,골목상권,1000165,천호대로109길,1318,779,539
2015,3,A,골목상권,1000164,자양번영로3길,79,37,42
2015,3,A,골목상권,1000162,자양로50길,18,5,13
2015,3,A,골목상권,1000161,자양로45길,563,306,257
2015,3,A,골목상권,1000160,자양로26길,312,107,205
2015,3,A,골목상권,1000159,자양로15길,320,215,105
2015,3,A,골목상권,1000158,자양로11길,1296,645,651
2015,3,A,골목상권,1000157,용마산로3길,856,481,375
2015,3,A,골목상권,1000156,용마산로21길,135,57,78
2015,3,A,골목상권,1000155,아차산로78길,1703,1049,654
2015,3,A,골목상권,1000154,아차산로65길,653,420,233
2015,3,A,골목상권,1000153,아차산로55길,515,252,263
2015,3,A,골목상권,1000152,아차산로51길,259,147,112
2015,3,A,골목상권,1000151,아차산로40길,434,248,186
2015,3,A,골목상권,1000150,면목로17길,214,139,75
2015,3,A,골목상권,1000149,뚝섬로64길,421,253,168
2015,3,A,골목상권,1000148,뚝섬로58길,180,59,121
2015,3,A,골목상권,1000147,뚝섬로54길,129,71,58
2015,3,A,골목상권,1000146,뚝섬로48길,829,379,450
2015,3,A,골목상권,1000145,뚝섬로24길,105,38,67
2015,3,A,골목상권,1000144,뚝섬로23길,95,59,36
2015,3,A,골목상권,1000143,동일로24길,8,3,5
2015,3,A,골목상권,1000142,동일로18길,152,65,87
2015,3,A,골목상권,1000141,능동로4길,224,94,130
2015,3,A,골목상권,1000140,능동로3길,205,93,112
2015,3,A,골목상권,1000139,능동로34길,892,497,395
2015,3,A,골목상권,1000138,능동로19길,345,219,126
2015,3,A,골목상권,1000137,능동로13길,297,97,200
2015,3,A,골목상권,1000136,긴고랑로9길,69,32,37
2015,3,A,골목상권,1000135,긴고랑로8길,230,204,26
2015,3,A,골목상권,1000134,긴고랑로7길,470,235,235
2015,3,A,골목상권,1000133,긴고랑로20길,516,235,281
2015,3,A,골목상권,1000132,광나루로52길,1723,844,879
2015,3,A,골목상권,1000131,광나루로40길,88,39,49
2015,3,A,골목상권,1000130,광나루로37길,313,197,116
2015,3,A,골목상권,1000129,광나루로36길,34,21,13
2015,3,A,골목상권,1000128,광나루로24길,67,33,34
2015,3,A,골목상권,1000127,광나루로12길,910,556,354
2015,3,A,골목상권,1000126,한림말길,73,46,27
2015,3,A,골목상권,1000124,청계천로10나길,1840,1074,766
2015,3,A,골목상권,1000123,장터길,42,19,23
2015,3,A,골목상권,1000122,용답중앙길,107,56,51
2015,3,A,골목상권,1000121,용답29길,1776,896,880
2015,3,A,골목상권,1000120,왕십리로6길,1314,753,561
2015,3,A,골목상권,1000119,왕십리로31길,125,60,65
2015,3,A,골목상권,1000118,왕십리로26길,3999,2182,1817
2015,3,A,골목상권,1000117,왕십리로21길,152,47,105
2015,3,A,골목상권,1000116,왕십리로14길,2213,1705,508
2015,3,A,골목상권,1000115,아차산로5길,2044,1412,632
2015,3,A,골목상권,1000114,아차산로15길,3779,2707,1072
2015,3,A,골목상권,1000113,아차산로11길,3350,2163,1187
2015,3,A,골목상권,1000112,송정4가길,966,457,509
2015,3,A,골목상권,1000111,송정12라길,232,169,63
2015,3,A,골목상권,1000110,성수일로6길,3171,1812,1359
2015,3,A,골목상권,1000109,성수이로7길,425,236,189
2015,3,A,골목상권,1000108,성수이로18길,2149,1539,610
2015,3,A,골목상권,1000107,성덕정길,603,389,214
2015,3,A,골목상권,1000106,성덕정17길,216,117,99
2015,3,A,골목상권,1000105,서울숲2길,1716,932,784
2015,3,A,골목상권,1000104,상원길,1574,1060,514
2015,3,A,골목상권,1000103,상원12길,164,96,68
2015,3,A,골목상권,1000102,사근동길,32,18,14
2015,3,A,골목상권,1000101,무학봉길,8,7,1
2015,3,A,골목상권,1000100,무학봉28길,160,72,88
2015,3,A,골목상권,1000099,무학로6길,352,207,145
2015,3,A,골목상권,1000098,무수막길,103,52,51
2015,3,A,골목상권,1000097,매봉길,30,19,11
2015,3,A,골목상권,1000096,마조로1길,166,64,102
2015,3,A,골목상권,1000095,마조로16길,774,546,228
2015,3,A,골목상권,1000094,마장로39길,55,38,17
2015,3,A,골목상권,1000093,마장로27길,105,43,62
2015,3,A,골목상권,1000091,둘레9길,413,254,159
2015,3,A,골목상권,1000090,금호산길,383,147,236
2015,3,A,골목상권,1000089,금호산2길,33,15,18
2015,3,A,골목상권,1000088,고산자로6길,15565,6418,9147
2015,3,A,골목상권,1000087,후암로28길,174,72,102
2015,3,A,골목상권,1000086,효창원로39길,50,33,17
2015,3,A,골목상권,1000085,회나무로13길,47,34,13
2015,3,A,골목상권,1000084,한남대로20길,731,436,295
2015,3,A,골목상권,1000082,한강대로7길,440,310,130
2015,3,A,골목상권,1000081,한강대로62길,690,485,205
2015,3,A,골목상권,1000080,한강대로52길,6484,2067,4417
2015,3,A,골목상권,1000079,한강대로43길,4691,3055,1636
2015,3,A,골목상권,1000078,한강대로15길,1969,419,1550
2015,3,A,골목상권,1000077,한강대로104길,4228,3115,1113
2015,3,A,골목상권,1000076,청파로73길,1377,778,599
2015,3,A,골목상권,1000075,청파로71길,245,131,114
2015,3,A,골목상권,1000074,청파로47나길,112,78,34
2015,3,A,골목상권,1000073,청파로47길,790,357,433
2015,3,A,골목상권,1000072,장문로45길,85,12,73
2015,3,A,골목상권,1000071,이태원로54길,1348,755,593
2015,3,A,골목상권,1000070,이태원로27길,510,309,201
2015,3,A,골목상권,1000069,이촌로22길,208,125,83
2015,3,A,골목상권,1000068,원효로89길,894,723,171
2015,3,A,골목상권,1000067,원효로53길,745,471,274
2015,3,A,골목상권,1000066,원효로41길,2843,2051,792
2015,3,A,골목상권,1000065,원효로19길,923,668,255
2015,3,A,골목상권,1000064,우사단로4길,156,117,39
2015,3,A,골목상권,1000063,우사단로14길,1698,945,753
2015,3,A,골목상권,1000062,우사단로10길,50,29,21
2015,3,A,골목상권,1000061,신흥로20길,183,85,98
2015,3,A,골목상권,1000060,소월로20길,138,49,89
2015,3,A,골목상권,1000059,서빙고로71길,445,266,179
2015,3,A,골목상권,1000058,백범로90길,262,155,107
2015,3,A,골목상권,1000057,백범로79길,948,575,373
2015,3,A,골목상권,1000056,두텁바위로1길,2624,1511,1113
2015,3,A,골목상권,1000055,대사관로34길,303,183,120
2015,3,A,골목상권,1000054,녹사평대로46길,14,10,4
2015,3,A,골목상권,1000053,녹사평대로40나길,29,15,14
2015,3,A,골목상권,1000052,녹사평대로32길,306,152,154
2015,3,A,골목상권,1000051,녹사평대로26길,2321,1376,945
2015,3,A,골목상권,1000050,녹사평대로11길,282,187,95
2015,3,A,골목상권,1000049,퇴계로90길,471,195,276
2015,3,A,골목상권,1000048,퇴계로8길,2475,1340,1135
2015,3,A,골목상권,1000047,퇴계로56길,914,704,210
2015,3,A,골목상권,1000046,퇴계로46길,1829,678,1151
2015,3,A,골목상권,1000045,퇴계로18길,2878,1368,1510
2015,3,A,골목상권,1000044,퇴계로12길,1097,467,630
2015,3,A,골목상권,1000043,청구로1길,198,97,101
2015,3,A,골목상권,1000042,청구로17길,1753,793,960
2015,3,A,골목상권,1000041,장충단로8길,3914,1196,2718
2015,3,A,골목상권,1000040,삼일대로4길,1377,965,412
2015,3,A,골목상권,1000039,명동길,35999,18292,17707
2015,3,A,골목상권,1000037,동호로20길,972,430,542
2015,3,A,골목상권,1000036,동호로15길,4444,2425,2019
2015,3,A,골목상권,1000035,동호로11길,12,9,3
2015,3,A,골목상권,1000034,동호로10길,4276,2298,1978
2015,3,A,골목상권,1000033,다산로39길,888,548,340
2015,3,A,골목상권,1000032,다산로38길,1303,718,585
2015,3,A,골목상권,1000031,다산로36길,49,26,23
2015,3,A,골목상권,1000030,다산로33길,378,193,185
2015,3,A,골목상권,1000029,난계로21길,195,127,68
2015,3,A,골목상권,1000028,난계로11길,1868,999,869
2015,3,A,골목상권,1000026,평창길,168,72,96
2015,3,A,골목상권,1000025,통일로12길,128,37,91
2015,3,A,골목상권,1000024,창신길,265,76,189
2015,3,A,골목상권,1000023,창신5길,7,4,3
2015,3,A,골목상권,1000022,창신2길,59,31,28
2015,3,A,골목상권,1000021,창경궁로35길,1405,392,1013
2015,3,A,골목상권,1000020,지봉로8길,146,68,78
2015,3,A,골목상권,1000019,종로65길,609,283,326
2015,3,A,골목상권,1000016,자하문로7길,493,288,205
2015,3,A,골목상권,1000015,이화장길,2046,1026,1020
2015,3,A,골목상권,1000014,율곡로16길,60,21,39
2015,3,A,골목상권,1000013,율곡로10길,2287,1687,600
2015,3,A,골목상권,1000012,옥인길,481,219,262
2015,3,A,골목상권,1000011,숭인동길,14,5,9
2015,3,A,골목상권,1000010,성균관로5길,114,69,45
2015,3,A,골목상권,1000009,삼청로5길,448,170,278
2015,3,A,골목상권,1000008,북촌로5나길,1541,1067,474
2015,3,A,골목상권,1000007,북촌로5길,49,21,28
2015,3,A,골목상권,1000006,북촌로11길,25,12,13
2015,3,A,골목상권,1000005,백석동길,88,43,45
2015,3,A,골목상권,1000004,명륜길,10,8,2
2015,3,A,골목상권,1000003,돈화문로11가길,1020,539,481
2015,3,A,골목상권,1000001,계동길,781,357,424
2015,2,U,관광특구,1001496,강남 마이스 관광특구,20112,11820,8292
2015,2,U,관광특구,1001495,잠실 관광특구,26461,16084,10377
2015,2,U,관광특구,1001494,종로?청계 관광특구,30389,19091,11298
2015,2,U,관광특구,1001493,동대문패션타운 관광특구,13416,9078,4338
2015,2,U,관광특구,1001492,명동 남대문 북창동 다동 무교동 관광특구,174824,89070,85754
2015,2,U,관광특구,1001491,이태원 관광특구,5862,3396,2466
2015,2,R,전통시장,1001490,길동복조리시장,569,338,231
2015,2,R,전통시장,1001489,둔촌역전통시장,160,77,83
2015,2,R,전통시장,1001488,성내골목시장,6,2,4
2015,2,R,전통시장,1001487,천호시장,13,8,5
2015,2,R,전통시장,1001483,암사종합시장,642,307,335
2015,2,R,전통시장,1001482,고덕전통시장,406,391,15
2015,2,R,전통시장,1001481,명일골목시장,396,118,278
2015,2,R,전통시장,1001480,새마을시장,289,146,143
2015,2,R,전통시장,1001479,석촌시장,164,108,56
2015,2,R,전통시장,1001478,방이시장,617,413,204
2015,2,R,전통시장,1001477,마천시장,247,58,189
2015,2,R,전통시장,1001476,풍납시장,11,2,9
2015,2,R,전통시장,1001475,강남개포시장,42,36,6
2015,2,R,전통시장,1001474,도곡시장,498,230,268
2015,2,R,전통시장,1001471,영동전통시장,3081,2310,771
2015,2,R,전통시장,1001466,미성동도깨비시장,403,167,236
2015,2,R,전통시장,1001464,삼성동시장,87,34,53
2015,2,R,전통시장,1001463,신림중앙시장,17,11,6
2015,2,R,전통시장,1001462,강남골목시장,225,124,101
2015,2,R,전통시장,1001460,관악신사시장,309,239,70
2015,2,R,전통시장,1001459,신원시장,336,146,190
2015,2,R,전통시장,1001458,인헌시장,226,74,152
2015,2,R,전통시장,1001456,봉천현대시장,14,6,8
2015,2,R,전통시장,1001454,봉천제일종합시장,43,23,20
2015,2,R,전통시장,1001453,낙성대시장,22,16,6
2015,2,R,전통시장,1001452,중부시장,194,63,131
2015,2,R,전통시장,1001450,남성역골목시장,504,250,254
2015,2,R,전통시장,1001449,남성사계시장,1964,911,1053
2015,2,R,전통시장,1001448,흑석시장,164,51,113
2015,2,R,전통시장,1001447,상도4동도깨비골목시장,310,80,230
2015,2,R,전통시장,1001445,영도시장,88,36,52
2015,2,R,전통시장,1001441,본동인정시장,118,57,61
2015,2,R,전통시장,1001439,대림중앙시장,26,17,9
2015,2,R,전통시장,1001438,우리시장,15,5,10
2015,2,R,전통시장,1001437,영진시장A동,46,37,9
2015,2,R,전통시장,1001433,영일시장,9,7,2
2015,2,R,전통시장,1001431,영등포청과시장,169,106,63
2015,2,R,전통시장,1001430,영등포전통시장,4114,2068,2046
2015,2,R,전통시장,1001429,은행나무시장,46,11,35
2015,2,R,전통시장,1001427,현대시장,56,15,41
2015,2,R,전통시장,1001424,남문시장,285,118,167
2015,2,R,전통시장,1001423,독산동 우시장,142,60,82
2015,2,R,전통시장,1001421,개봉중앙시장,7,3,4
2015,2,R,전통시장,1001419,가리봉시장,15,10,5
2015,2,R,전통시장,1001418,남구로시장,6,3,3
2015,2,R,전통시장,1001417,구로시장,44,20,24
2015,2,R,전통시장,1001415,방신전통시장,154,130,24
2015,2,R,전통시장,1001414,송화골목시장,477,171,306
2015,2,R,전통시장,1001413,까치산시장,32,18,14
2015,2,R,전통시장,1001411,남부골목시장,153,67,86
2015,2,R,전통시장,1001409,화곡중앙골목시장,2,2,0
2015,2,R,전통시장,1001407,등마루시장,789,501,288
2015,2,R,전통시장,1001406,신정3동골목시장,240,108,132
2015,2,R,전통시장,1001405,신정2동골목시장,8,6,2
2015,2,R,전통시장,1001402,신월6동골목시장,255,115,140
2015,2,R,전통시장,1001401,신곡종합시장,15,10,5
2015,2,R,전통시장,1001400,신월3동골목시장,50,15,35
2015,2,R,전통시장,1001399,경창시장,190,89,101
2015,2,R,전통시장,1001398,월정로시장,104,56,48
2015,2,R,전통시장,1001397,신영시장,44,20,24
2015,2,R,전통시장,1001396,목4동시장,248,85,163
2015,2,R,전통시장,1001395,목3동시장,624,275,349
2015,2,R,전통시장,1001394,목2동시장,185,88,97
2015,2,R,전통시장,1001393,마포농수산물시장,472,296,176
2015,2,R,전통시장,1001391,망원월드컵시장,14,9,5
2015,2,R,전통시장,1001390,망원시장,36,20,16
2015,2,R,전통시장,1001386,신수시장,140,101,39
2015,2,R,전통시장,1001385,아현시장,32,8,24
2015,2,R,전통시장,1001374,대림골목시장,279,89,190
2015,2,R,전통시장,1001367,상계중앙시장,31,17,14
2015,2,R,전통시장,1001364,방학동도깨비시장,136,60,76
2015,2,R,전통시장,1001363,쌍문역골목시장,51,22,29
2015,2,R,전통시장,1001361,신도봉시장,25,15,10
2015,2,R,전통시장,1001359,창동신창시장,125,48,77
2015,2,R,전통시장,1001358,수유북부시장,9,4,5
2015,2,R,전통시장,1001357,장미원골목시장,60,41,19
2015,2,R,전통시장,1001356,수유중앙시장,127,70,57
2015,2,R,전통시장,1001355,강북종합시장,55,23,32
2015,2,R,전통시장,1001354,우이시장,155,73,82
2015,2,R,전통시장,1001353,수유전통시장,455,140,315
2015,2,R,전통시장,1001352,번동북부골목시장,90,56,34
2015,2,R,전통시장,1001351,솔샘시장,95,36,59
2015,2,R,전통시장,1001349,방천골목시장,79,25,54
2015,2,R,전통시장,1001347,석관황금시장,45,24,21
2015,2,R,전통시장,1001343,장위전통시장,184,70,114
2015,2,R,전통시장,1001340,정릉시장,31,12,19
2015,2,R,전통시장,1001339,정릉아리랑시장,8,5,3
2015,2,R,전통시장,1001338,돈암제일시장,80,40,40
2015,2,R,전통시장,1001336,우림골목시장,220,109,111
2015,2,R,전통시장,1001335,묵1동도깨비시장,245,100,145
2015,2,R,전통시장,1001334,태능시장,2,2,0
2015,2,R,전통시장,1001333,중화제일시장,21,0,21
2015,2,R,전통시장,1001332,사가정시장,260,206,54
2015,2,R,전통시장,1001330,동원시장,61,28,33
2015,2,R,전통시장,1001329,동부골목시장,80,28,52
2015,2,R,전통시장,1001326,회기시장,130,48,82
2015,2,R,전통시장,1001323,답십리시장,21,9,12
2015,2,R,전통시장,1001321,답십리현대시장,105,77,28
2015,2,R,전통시장,1001319,청량리종합시장,8,6,2
2015,2,R,전통시장,1001317,청량리농수산물시장,15,13,2
2015,2,R,전통시장,1001316,서울약령시장,1316,849,467
2015,2,R,전통시장,1001313,청량리수산시장,162,87,75
2015,2,R,전통시장,1001310,구의시장,96,56,40
2015,2,R,전통시장,1001309,조양시장,76,44,32
2015,2,R,전통시장,1001308,영동교골목시장,22,16,6
2015,2,R,전통시장,1001307,능동로골목시장,287,266,21
2015,2,R,전통시장,1001304,자양골목시장,88,44,44
2015,2,R,전통시장,1001301,중곡제일시장,145,73,72
2015,2,R,전통시장,1001299,한아름시장,107,56,51
2015,2,R,전통시장,1001298,성동용답상가시장,253,130,123
2015,2,R,전통시장,1001297,뚝도시장,26,8,18
2015,2,R,전통시장,1001296,금남시장,14,10,4
2015,2,R,전통시장,1001295,행당시장,211,111,100
2015,2,R,전통시장,1001294,마장축산물시장,1545,1055,490
2015,2,R,전통시장,1001289,용문전통시장,25,15,10
2015,2,R,전통시장,1001286,후암시장,30,11,19
2015,2,R,전통시장,1001285,합동(새벽)시장,2298,1239,1059
2015,2,R,전통시장,1001284,서울중앙시장,246,167,79
2015,2,R,전통시장,1001283,백학시장,495,270,225
2015,2,R,전통시장,1001282,약수시장,1542,594,948
2015,2,R,전통시장,1001281,청평화시장,2439,1673,766
2015,2,R,전통시장,1001280,제일평화시장,472,291,181
2015,2,R,전통시장,1001278,남평화시장,156,105,51
2015,2,R,전통시장,1001277,방산종합시장,1701,1133,568
2015,2,R,전통시장,1001275,인현시장,1188,767,421
2015,2,R,전통시장,1001274,신중부시장,2298,1575,723
2015,2,R,전통시장,1001273,남대문시장,7028,3805,3223
2015,2,R,전통시장,1001271,동묘시장,865,552,313
2015,2,R,전통시장,1001270,창신골목시장,216,123,93
2015,2,R,전통시장,1001268,충신시장,320,187,133
2015,2,R,전통시장,1001267,종로신진시장,30,12,18
2015,2,R,전통시장,1001266,동대문종합시장,241,147,94
2015,2,R,전통시장,1001265,광장시장,216,150,66
2015,2,D,발달상권,1001263,서울 노원구 노원역_3,678,275,403
2015,2,D,발달상권,1001261,서울 노원구 노원역_1,909,274,635
2015,2,D,발달상권,1001260,창동역,2306,1504,802
2015,2,D,발달상권,1001259,서울 강북구 수유역_3,49,27,22
2015,2,D,발달상권,1001257,서울 강북구 수유역_2,4014,2106,1908
2015,2,D,발달상권,1001256,서울 강북구 수유역_1,84,66,18
2015,2,D,발달상권,1001255,서울 은평구 연신내역_3,575,183,392
2015,2,D,발달상권,1001254,서울 은평구 연신내역_2,318,138,180
2015,2,D,발달상권,1001253,서울 은평구 연신내역_1,49,25,24
2015,2,D,발달상권,1001252,서울 성북구 미아삼거리역_2,507,243,264
2015,2,D,발달상권,1001251,서울 강북구 미아삼거리역_1,432,153,279
2015,2,D,발달상권,1001250,서울 은평구 불광역_3,51,19,32
2015,2,D,발달상권,1001249,서울 은평구 불광역_2,80,32,48
2015,2,D,발달상권,1001248,서울 은평구 불광역_1,225,89,136
2015,2,D,발달상권,1001247,미아사거리_2,145,82,63
2015,2,D,발달상권,1001246,미아사거리_1,522,215,307
2015,2,D,발달상권,1001245,서울 성북구 성신여대입구역,4859,3013,1846
2015,2,D,발달상권,1001244,경희대학교,334,151,183
2015,2,D,발달상권,1001243,서울 성북구 안암역,91,57,34
2015,2,D,발달상권,1001242,혜화역 대학로_3,10394,3112,7282
2015,2,D,발달상권,1001241,혜화역 대학로_2,1381,802,579
2015,2,D,발달상권,1001240,혜화역 대학로_1,1199,627,572
2015,2,D,발달상권,1001239,디지털미디어시티,20370,12500,7870
2015,2,D,발달상권,1001238,서울 동대문구 청량리역,3144,2047,1097
2015,2,D,발달상권,1001236,서울 종로구 안국역_2,775,310,465
2015,2,D,발달상권,1001235,서울 종로구 안국역_1,11905,9833,2072
2015,2,D,발달상권,1001234,서울 종로구 경복궁역_1,219,90,129
2015,2,D,발달상권,1001233,서울 종로구 종로3가역_3,3053,1719,1334
2015,2,D,발달상권,1001232,서울 종로구 종로3가역_2,1725,968,757
2015,2,D,발달상권,1001231,서울 동대문구 신설동역_2,4316,2209,2107
2015,2,D,발달상권,1001230,인사동,22122,13936,8186
2015,2,D,발달상권,1001229,서울 종로구 종로5가역_4,668,367,301
2015,2,D,발달상권,1001228,서울 종로구 종로5가역_3,5271,3628,1643
2015,2,D,발달상권,1001227,종로구청,14980,8913,6067
2015,2,D,발달상권,1001226,서울 종로구 종로5가역_2,14311,8912,5399
2015,2,D,발달상권,1001225,신설동역,737,442,295
2015,2,D,발달상권,1001224,서울 동대문구 신설동역_1,2,2,0
2015,2,D,발달상권,1001223,서울 종로구 광화문역_2,50961,32188,18773
2015,2,D,발달상권,1001222,동묘앞역,64,41,23
2015,2,D,발달상권,1001221,장안동사거리,540,258,282
2015,2,D,발달상권,1001220,서울 종로구 동대문역_2,968,546,422
2015,2,D,발달상권,1001218,동대문시장_2,504,320,184
2015,2,D,발달상권,1001217,서울 종로구 종로5가역_1,51,34,17
2015,2,D,발달상권,1001216,서울 종로구 종로3가역_1,3353,1527,1826
2015,2,D,발달상권,1001215,서울 종로구 광화문역_1,2332,1632,700
2015,2,D,발달상권,1001214,종각역,20893,13909,6984
2015,2,D,발달상권,1001213,종각역 젊음의 거리,1963,929,1034
2015,2,D,발달상권,1001212,서대문구 서대문역_1,2581,843,1738
2015,2,D,발달상권,1001211,동대문시장_1,452,241,211
2015,2,D,발달상권,1001210,시청역_2,24467,15366,9101
2015,2,D,발달상권,1001209,서울시청,26286,12343,13943
2015,2,D,발달상권,1001208,서울 중구 을지로3가역_2,8590,5507,3083
2015,2,D,발달상권,1001207,서울 중구 신당역_2,1199,630,569
2015,2,D,발달상권,1001206,서대문구 서대문역_2,2227,1513,714
2015,2,D,발달상권,1001205,동대문역사문화공원역,4451,2846,1605
2015,2,D,발달상권,1001204,서울 중구 을지로3가역_1,14127,9632,4495
2015,2,D,발달상권,1001203,명동거리,17531,8960,8571
2015,2,D,발달상권,1001202,롯데백화점,56396,30904,25492
2015,2,D,발달상권,1001201,서울 중구 신당역_1,1109,707,402
2015,2,D,발달상권,1001200,북창동,7555,4811,2744
2015,2,D,발달상권,1001199,서울 중구 충무로역_2,16372,7386,8986
2015,2,D,발달상권,1001198,서울 강서구 송정역,642,449,193
2015,2,D,발달상권,1001197,장한평역_2,12082,9724,2358
2015,2,D,발달상권,1001196,시청역_1,63738,36931,26807
2015,2,D,발달상권,1001195,왕십리역_2,728,343,385
2015,2,D,발달상권,1001194,서울 강서구 발산역,709,467,242
2015,2,D,발달상권,1001193,장한평역_1,2409,1606,803
2015,2,D,발달상권,1001192,서울 중구 충무로역_1,3078,2043,1035
2015,2,D,발달상권,1001190,장한평역,2135,1447,688
2015,2,D,발달상권,1001189,서울 중구 명동역,3611,1900,1711
2015,2,D,발달상권,1001188,장충동 족발거리,203,92,111
2015,2,D,발달상권,1001187,한양시장,239,115,124
2015,2,D,발달상권,1001186,서울 서대문구 이대역,1176,452,724
2015,2,D,발달상권,1001185,서울 서대문구 신촌역,2558,1037,1521
2015,2,D,발달상권,1001184,서울 마포구 홍대입구역_3,940,731,209
2015,2,D,발달상권,1001183,서울 마포구 홍대입구역_2,2597,1075,1522
2015,2,D,발달상권,1001182,홍익대학교 주변,15744,7452,8292
2015,2,D,발달상권,1001181,서울 광진구 군자역,170,109,61
2015,2,D,발달상권,1001180,신촌역,215,120,95
2015,2,D,발달상권,1001179,강서구청,3681,2475,1206
2015,2,D,발달상권,1001178,서울 마포구 홍대입구역_1,746,428,318
2015,2,D,발달상권,1001175,서울 강동구 고덕역,484,283,201
2015,2,D,발달상권,1001173,서울 강동구 명일역,905,353,552
2015,2,D,발달상권,1001172,어린이대공원역,119,78,41
2015,2,D,발달상권,1001171,서울 마포구 공덕역_2,3983,2327,1656
2015,2,D,발달상권,1001170,공덕역,6421,4101,2320
2015,2,D,발달상권,1001169,서울 용산구 숙대입구역,4118,2911,1207
2015,2,D,발달상권,1001168,남영역,13958,6427,7531
2015,2,D,발달상권,1001167,서울 마포구 공덕역_1,4235,2073,2162
2015,2,D,발달상권,1001166,서울 마포구 마포역_2,1002,583,419
2015,2,D,발달상권,1001165,서울 광진구 건대입구역_2,2641,941,1700
2015,2,D,발달상권,1001164,서울 마포구 마포역_1,10341,6302,4039
2015,2,D,발달상권,1001163,서울 강동구 천호역_2,3625,1817,1808
2015,2,D,발달상권,1001162,서울 광진구 건대입구역_1,946,467,479
2015,2,D,발달상권,1001161,건대입구역,795,442,353
2015,2,D,발달상권,1001160,서울 광진구 구의역,896,552,344
2015,2,D,발달상권,1001159,서울 강동구 천호역,972,449,523
2015,2,D,발달상권,1001158,당산역_2,5096,3116,1980
2015,2,D,발달상권,1001156,서울 강동구 길동역,1603,1061,542
2015,2,D,발달상권,1001155,용산 전자상가_5,2185,1659,526
2015,2,D,발달상권,1001153,당산역_1,1141,739,402
2015,2,D,발달상권,1001152,서울 광진구 강변역,2172,1799,373
2015,2,D,발달상권,1001151,용산 전자상가_3,2542,1870,672
2015,2,D,발달상권,1001150,서울 용산구 이태원역,783,466,317
2015,2,D,발달상권,1001149,한남오거리,617,322,295
2015,2,D,발달상권,1001147,용산 전자상가_2,429,345,84
2015,2,D,발달상권,1001146,용산구청,66,43,23
2015,2,D,발달상권,1001145,용산 전자상가_1,8231,6307,1924
2015,2,D,발달상권,1001144,국회의사당역_2,39285,22304,16981
2015,2,D,발달상권,1001143,서울 용산구 신용산역,323,131,192
2015,2,D,발달상권,1001142,국회의사당역_1,5726,4448,1278
2015,2,D,발달상권,1001141,압구정 로데오거리_2,14245,5872,8373
2015,2,D,발달상권,1001140,서울 강남구 압구정역,9661,4504,5157
2015,2,D,발달상권,1001139,서울 영등포구 영등포구청역,4516,1393,3123
2015,2,D,발달상권,1001138,압구정 로데오거리_1,7733,2486,5247
2015,2,D,발달상권,1001137,서울 강동구 둔촌동역,60,26,34
2015,2,D,발달상권,1001136,오목교역,213,103,110
2015,2,D,발달상권,1001135,신사동 가로수길,20767,9661,11106
2015,2,D,발달상권,1001134,서울 영등포구 여의도역_2,46755,31061,15694
2015,2,D,발달상권,1001133,청담사거리_3,1312,428,884
2015,2,D,발달상권,1001132,영등포유통상가,1848,1251,597
2015,2,D,발달상권,1001131,청담역_2,1409,1029,380
2015,2,D,발달상권,1001130,청담역_1,191,151,40
2015,2,D,발달상권,1001129,청담사거리_2,1025,815,210
2015,2,D,발달상권,1001127,서울 영등포구 여의도역_1,53145,32010,21135
2015,2,D,발달상권,1001125,학동사거리_2,2788,1623,1165
2015,2,D,발달상권,1001124,서울 영등포구 영등포시장역,337,271,66
2015,2,D,발달상권,1001123,학동사거리_1,4245,2224,2021
2015,2,D,발달상권,1001122,여의도 시범아파트앞,2386,1587,799
2015,2,D,발달상권,1001121,영등포역_3,831,503,328
2015,2,D,발달상권,1001120,도산공원사거리_1,10478,6531,3947
2015,2,D,발달상권,1001119,영등포역_2,1004,554,450
2015,2,D,발달상권,1001118,문래동 주민센터,67,56,11
2015,2,D,발달상권,1001117,강남구 신사역_2,7208,4808,2400
2015,2,D,발달상권,1001115,서울 강남구 강남구청역_2,4144,2520,1624
2015,2,D,발달상권,1001114,강남구 신사역_1,2616,1161,1455
2015,2,D,발달상권,1001113,서울 동작구 노량진1동_1,93,43,50
2015,2,D,발달상권,1001112,서울 강남구 학동역_3,8237,4838,3399
2015,2,D,발달상권,1001111,서울 강남구 강남구청역_1,3080,1795,1285
2015,2,D,발달상권,1001110,잠실역,5451,4128,1323
2015,2,D,발달상권,1001109,강남구 논현역_4,8275,3749,4526
2015,2,D,발달상권,1001108,학동역,878,427,451
2015,2,D,발달상권,1001107,방이동 먹자골목,5732,3932,1800
2015,2,D,발달상권,1001106,서울 강남구 학동역_2,5730,2722,3008
2015,2,D,발달상권,1001105,서울 동작구 노량진역,3454,2022,1432
2015,2,D,발달상권,1001104,삼성역_3,9386,5407,3979
2015,2,D,발달상권,1001103,코엑스,20112,11820,8292
2015,2,D,발달상권,1001102,서울 강남구 학동역_1,5716,3492,2224
2015,2,D,발달상권,1001101,선정릉역_2,6144,3769,2375
2015,2,D,발달상권,1001100,강남구 논현역_3,1465,850,615
2015,2,D,발달상권,1001099,포스코사거리_2,7635,4698,2937
2015,2,D,발달상권,1001098,포스코사거리_1,49500,32581,16919
2015,2,D,발달상권,1001097,잠실역 롯데월드,3119,1555,1564
2015,2,D,발달상권,1001096,신도림역,3816,2105,1711
2015,2,D,발달상권,1001095,강남구 논현역_2,7585,3554,4031
2015,2,D,발달상권,1001094,선정릉역_1,1536,1050,486
2015,2,D,발달상권,1001093,신천역,5891,3231,2660
2015,2,D,발달상권,1001092,강남구 논현역_1,3121,2030,1091
2015,2,D,발달상권,1001091,삼성역_2,18338,10881,7457
2015,2,D,발달상권,1001090,삼정역_2,2572,1125,1447
2015,2,D,발달상권,1001089,삼정역_1,2982,1586,1396
2015,2,D,발달상권,1001088,삼성역_1,27937,18020,9917
2015,2,D,발달상권,1001087,서울 강남구 선릉역_2,7008,4398,2610
2015,2,D,발달상권,1001086,고속터미널역,15210,4715,10495
2015,2,D,발달상권,1001085,서울 서초구 강남역,32768,18661,14107
2015,2,D,발달상권,1001084,서울 강남구 선릉역_1,20499,9065,11434
2015,2,D,발달상권,1001082,선릉역_2,20180,11037,9143
2015,2,D,발달상권,1001081,서울 강남구 역삼역_2,27354,21522,5832
2015,2,D,발달상권,1001080,서울 송파구 석촌역_1,39,26,13
2015,2,D,발달상권,1001078,서울 강남구 강남역_2,6456,4162,2294
2015,2,D,발달상권,1001077,선릉역_1,56948,29569,27379
2015,2,D,발달상권,1001076,구로역,157,91,66
2015,2,D,발달상권,1001075,역삼역_2,3883,2174,1709
2015,2,D,발달상권,1001074,대림역_2,6950,5401,1549
2015,2,D,발달상권,1001073,서울 강남구 역삼역_1,26140,16356,9784
2015,2,D,발달상권,1001072,신대방삼거리역,297,165,132
2015,2,D,발달상권,1001071,서울 강남구 한티역,1292,495,797
2015,2,D,발달상권,1001070,은마아파트입구사거리_4,65,42,23
2015,2,D,발달상권,1001067,오류동역,1305,686,619
2015,2,D,발달상권,1001066,서울 강남구 강남역,38850,18015,20835
2015,2,D,발달상권,1001063,교대역_4,4907,2934,1973
2015,2,D,발달상권,1001062,서울 강남구 강남역_1,137795,100391,37404
2015,2,D,발달상권,1001061,방배동카페골목,113,43,70
2015,2,D,발달상권,1001060,가락시장,15561,10071,5490
2015,2,D,발달상권,1001059,교대역_3,4376,2722,1654
2015,2,D,발달상권,1001058,역삼역_1,1743,946,797
2015,2,D,발달상권,1001057,교대역_2,3263,2070,1193
2015,2,D,발달상권,1001056,서울 송파구 가락시장역,5166,3330,1836
2015,2,D,발달상권,1001055,서울 서초구 서초역,11056,4719,6337
2015,2,D,발달상권,1001054,서울 강남구 대치역_2,1359,859,500
2015,2,D,발달상권,1001052,뱅뱅사거리_2,23561,14998,8563
2015,2,D,발달상권,1001051,보라매공원,14379,8359,6020
2015,2,D,발달상권,1001050,교대역_1,13151,7745,5406
2015,2,D,발달상권,1001049,개봉동 현대아파트 인근,170,83,87
2015,2,D,발달상권,1001048,뱅뱅사거리,10273,7075,3198
2015,2,D,발달상권,1001047,뱅뱅사거리_1,9554,6787,2767
2015,2,D,발달상권,1001046,서울 관악구 신림역_4,948,466,482
2015,2,D,발달상권,1001045,동작구 총신대입구역_1,228,105,123
2015,2,D,발달상권,1001044,양재역_3,3194,2187,1007
2015,2,D,발달상권,1001043,동작구 총신대입구역_2,1191,606,585
2015,2,D,발달상권,1001042,서울 서초구 남부터미널역_3,1594,980,614
2015,2,D,발달상권,1001041,서울 강남구 수서역,18011,10591,7420
2015,2,D,발달상권,1001039,서울 서초구 남부터미널역_2,11095,5450,5645
2015,2,D,발달상권,1001038,구로디지탈1단지,63830,41310,22520
2015,2,D,발달상권,1001037,양재역,130,69,61
2015,2,D,발달상권,1001035,매봉역,330,157,173
2015,2,D,발달상권,1001034,서울 서초구 방배역,3861,2288,1573
2015,2,D,발달상권,1001033,서울 서초구 남부터미널역_1,738,522,216
2015,2,D,발달상권,1001032,서울 관악구 신림역_2,26,11,15
2015,2,D,발달상권,1001031,서울 관악구 신림역_1,1783,842,941
2015,2,D,발달상권,1001030,양재역_2,8292,4578,3714
2015,2,D,발달상권,1001029,양재역_1,874,613,261
2015,2,D,발달상권,1001028,서울 관악구 서울대입구역_2,42,4,38
2015,2,D,발달상권,1001027,가산디지털단지역_3,30183,18185,11998
2015,2,D,발달상권,1001026,구로디지털단지역,2678,1844,834
2015,2,D,발달상권,1001025,서울 관악구 서울대입구역_1,1832,788,1044
2015,2,D,발달상권,1001024,관악구 사당역_1,3890,1658,2232
2015,2,D,발달상권,1001023,가산디지털단지역_2,59934,36244,23690
2015,2,D,발달상권,1001022,관악구 사당역_2,385,189,196
2015,2,D,발달상권,1001021,가산디지털단지역_1,24455,16478,7977
2015,2,D,발달상권,1001020,장지역,3770,2410,1360
2015,2,D,발달상권,1001019,포이사거리_1,5603,3065,2538
2015,2,D,발달상권,1001018,포이사거리_2,7363,4805,2558
2015,2,D,발달상권,1001016,서울 관악구 대학동_1,80,50,30
2015,2,D,발달상권,1001015,서울 금천구 독산1동_1,2870,2064,806
2015,2,D,발달상권,1001013,양재 화물트럭터미널앞_2,207,97,110
2015,2,D,발달상권,1001012,양재 화물트럭터미널앞_1,4134,3242,892
2015,2,D,발달상권,1001011,서울 금천구 시흥1동_4,944,497,447
2015,2,A,골목상권,1001010,풍성로37가길,40,18,22
2015,2,A,골목상권,1001009,천호옛길,540,383,157
2015,2,A,골목상권,1001008,천호옛14길,557,280,277
2015,2,A,골목상권,1001007,천호대로219길,869,513,356
2015,2,A,골목상권,1001006,천호대로197길,17,4,13
2015,2,A,골목상권,1001005,천호대로187길,838,498,340
2015,2,A,골목상권,1001004,천호대로170길,397,149,248
2015,2,A,골목상권,1001003,천호대로162길,1030,725,305
2015,2,A,골목상권,1001002,천중로51길,412,226,186
2015,2,A,골목상권,1001001,천중로39길,594,206,388
2015,2,A,골목상권,1001000,진황도로47길,1051,557,494
2015,2,A,골목상권,1000999,진황도로27길,449,268,181
2015,2,A,골목상권,1000998,올림픽로98길,55,33,22
2015,2,A,골목상권,1000995,올림픽로77길,8,5,3
2015,2,A,골목상권,1000994,올림픽로71길,346,258,88
2015,2,A,골목상권,1000993,올림픽로48길,5728,3535,2193
2015,2,A,골목상권,1000992,양재대로96길,1361,866,495
2015,2,A,골목상권,1000991,양재대로95길,587,329,258
2015,2,A,골목상권,1000990,양재대로91길,978,531,447
2015,2,A,골목상권,1000989,양재대로133길,276,108,168
2015,2,A,골목상권,1000988,양재대로124길,556,348,208
2015,2,A,골목상권,1000987,양재대로116길,206,90,116
2015,2,A,골목상권,1000986,양재대로101길,1334,747,587
2015,2,A,골목상권,1000985,암사길,365,158,207
2015,2,A,골목상권,1000984,성안로3길,1478,922,556
2015,2,A,골목상권,1000983,성내로5길,986,527,459
2015,2,A,골목상권,1000982,상일로5길,54,31,23
2015,2,A,골목상권,1000981,상암로5길,447,193,254
2015,2,A,골목상권,1000980,상암로51길,716,304,412
2015,2,A,골목상권,1000979,상암로4길,213,170,43
2015,2,A,골목상권,1000978,상암로14길,432,250,182
2015,2,A,골목상권,1000977,명일로13길,124,52,72
2015,2,A,골목상권,1000976,동남로85길,134,73,61
2015,2,A,골목상권,1000975,동남로82길,12,5,7
2015,2,A,골목상권,1000974,동남로65길,86,31,55
2015,2,A,골목상권,1000973,구천면로42길,360,169,191
2015,2,A,골목상권,1000972,구천면로41길,576,250,326
2015,2,A,골목상권,1000971,구천면로36길,53,33,20
2015,2,A,골목상권,1000969,고덕로25길,6,4,2
2015,2,A,골목상권,1000968,고덕로10길,142,70,72
2015,2,A,골목상권,1000967,강동대로53길,827,466,361
2015,2,A,골목상권,1000966,풍성로25길,862,391,471
2015,2,A,골목상권,1000965,오금로46길,1394,703,691
2015,2,A,골목상권,1000964,오금로36길,1605,1286,319
2015,2,A,골목상권,1000963,오금로11길,2246,1447,799
2015,2,A,골목상권,1000962,양재대로72길,677,381,296
2015,2,A,골목상권,1000961,양재대로71길,1091,660,431
2015,2,A,골목상권,1000960,양재대로64길,1547,656,891
2015,2,A,골목상권,1000959,양재대로62길,5847,3584,2263
2015,2,A,골목상권,1000958,송파대로30길,1607,1030,577
2015,2,A,골목상권,1000957,송이로36길,1895,1371,524
2015,2,A,골목상권,1000956,송이로32길,760,420,340
2015,2,A,골목상권,1000955,송이로23길,1792,1014,778
2015,2,A,골목상권,1000954,삼전로13길,1812,1040,772
2015,2,A,골목상권,1000953,백제고분로50길,3385,1663,1722
2015,2,A,골목상권,1000952,백제고분로46길,1627,1036,591
2015,2,A,골목상권,1000951,백제고분로45길,493,333,160
2015,2,A,골목상권,1000950,백제고분로42길,117,77,40
2015,2,A,골목상권,1000949,백제고분로39길,1354,1041,313
2015,2,A,골목상권,1000948,백제고분로34길,1635,1091,544
2015,2,A,골목상권,1000947,백제고분로33길,827,526,301
2015,2,A,골목상권,1000946,백제고분로32길,1038,453,585
2015,2,A,골목상권,1000945,백제고분로31길,296,190,106
2015,2,A,골목상권,1000944,백제고분로22길,1083,641,442
2015,2,A,골목상권,1000943,백제고분로21길,204,139,65
2015,2,A,골목상권,1000942,마천로51길,123,44,79
2015,2,A,골목상권,1000941,동남로20길,178,98,80
2015,2,A,골목상권,1000940,거마로20길,387,175,212
2015,2,A,골목상권,1000939,학동로77길,2926,1500,1426
2015,2,A,골목상권,1000938,학동로6길,1988,1088,900
2015,2,A,골목상권,1000937,학동로56길,979,595,384
2015,2,A,골목상권,1000936,학동로38길,6746,4428,2318
2015,2,A,골목상권,1000935,테헤란로81길,621,171,450
2015,2,A,골목상권,1000934,일원로9길,490,273,217
2015,2,A,골목상권,1000933,일원로3길,218,96,122
2015,2,A,골목상권,1000932,영동대로65길,3096,1832,1264
2015,2,A,골목상권,1000931,영동대로112길,705,494,211
2015,2,A,골목상권,1000930,언주로81길,8354,3980,4374
2015,2,A,골목상권,1000929,압구정로2길,2591,1365,1226
2015,2,A,골목상권,1000928,선릉로18길,513,302,211
2015,2,A,골목상권,1000927,선릉로146길,1722,909,813
2015,2,A,골목상권,1000926,선릉로133길,139,72,67
2015,2,A,골목상권,1000925,선릉로132길,947,496,451
2015,2,A,골목상권,1000924,선릉로121길,1656,882,774
2015,2,A,골목상권,1000923,삼성로75길,2634,1438,1196
2015,2,A,골목상권,1000922,삼성로69길,259,147,112
2015,2,A,골목상권,1000921,삼성로64길,626,329,297
2015,2,A,골목상권,1000920,삼성로63길,154,74,80
2015,2,A,골목상권,1000919,삼성로57길,864,265,599
2015,2,A,골목상권,1000918,삼성로147길,803,342,461
2015,2,A,골목상권,1000917,삼성로115길,320,198,122
2015,2,A,골목상권,1000916,봉은사로68길,199,103,96
2015,2,A,골목상권,1000915,봉은사로57길,571,397,174
2015,2,A,골목상권,1000914,봉은사로43길,958,612,346
2015,2,A,골목상권,1000913,봉은사로29길,145,95,50
2015,2,A,골목상권,1000912,봉은사로109길,294,169,125
2015,2,A,골목상권,1000911,도산대로89길,2450,973,1477
2015,2,A,골목상권,1000910,도산대로81길,4620,1510,3110
2015,2,A,골목상권,1000909,도산대로50길,2717,1937,780
2015,2,A,골목상권,1000908,도산대로38길,172,95,77
2015,2,A,골목상권,1000907,도산대로30길,2936,1434,1502
2015,2,A,골목상권,1000906,도산대로23길,1318,787,531
2015,2,A,골목상권,1000905,도산대로15길,1943,899,1044
2015,2,A,골목상권,1000904,도곡로37길,3335,2224,1111
2015,2,A,골목상권,1000903,논현로8길,777,417,360
2015,2,A,골목상권,1000902,논현로63길,9579,2756,6823
2015,2,A,골목상권,1000901,논현로28길,12967,9386,3581
2015,2,A,골목상권,1000900,논현로26길,6217,3937,2280
2015,2,A,골목상권,1000898,논현로139길,1847,1080,767
2015,2,A,골목상권,1000897,논현로123길,109,68,41
2015,2,A,골목상권,1000896,논현로115길,3165,1788,1377
2015,2,A,골목상권,1000895,논현로10길,2272,1474,798
2015,2,A,골목상권,1000894,논현로106길,2821,1537,1284
2015,2,A,골목상권,1000893,남부순환로365길,186,142,44
2015,2,A,골목상권,1000891,개포로28길,298,218,80
2015,2,A,골목상권,1000890,개포로20길,4156,2337,1819
2015,2,A,골목상권,1000889,개포로17길,3455,1990,1465
2015,2,A,골목상권,1000888,강남대로140길,4382,2392,1990
2015,2,A,골목상권,1000887,강남대로136길,1139,660,479
2015,2,A,골목상권,1000886,강남대로118길,610,333,277
2015,2,A,골목상권,1000885,서초중앙로8길,5426,4156,1270
2015,2,A,골목상권,1000884,방배중앙로21길,2123,701,1422
2015,2,A,골목상권,1000883,효령로72길,194,113,81
2015,2,A,골목상권,1000882,효령로34길,82,37,45
2015,2,A,골목상권,1000881,효령로31길,1467,877,590
2015,2,A,골목상권,1000880,효령로23길,724,442,282
2015,2,A,골목상권,1000879,청두곶길,1882,1319,563
2015,2,A,골목상권,1000878,주흥길,354,225,129
2015,2,A,골목상권,1000877,주흥15길,1435,919,516
2015,2,A,골목상권,1000876,언남길,1951,1432,519
2015,2,A,골목상권,1000875,신반포로45길,453,285,168
2015,2,A,골목상권,1000874,서초대로8길,276,193,83
2015,2,A,골목상권,1000873,서초대로64길,518,352,166
2015,2,A,골목상권,1000872,서초대로4길,848,626,222
2015,2,A,골목상권,1000871,서초대로25길,3442,2011,1431
2015,2,A,골목상권,1000870,서초대로23길,866,491,375
2015,2,A,골목상권,1000869,서초대로15길,1068,514,554
2015,2,A,골목상권,1000868,사평대로57길,216,83,133
2015,2,A,골목상권,1000867,사평대로26길,15,11,4
2015,2,A,골목상권,1000866,사평대로22길,1360,847,513
2015,2,A,골목상권,1000865,사임당로17길,1552,979,573
2015,2,A,골목상권,1000864,방배로42길,186,85,101
2015,2,A,골목상권,1000863,방배로35길,2228,1435,793
2015,2,A,골목상권,1000862,방배로18길,69,36,33
2015,2,A,골목상권,1000861,반포대로9길,706,486,220
2015,2,A,골목상권,1000860,바우뫼로39길,2987,1836,1151
2015,2,A,골목상권,1000859,마방로2길,3621,2394,1227
2015,2,A,골목상권,1000858,방배천로4안길,1572,851,721
2015,2,A,골목상권,1000857,동산로19길,1358,938,420
2015,2,A,골목상권,1000856,동산로10길,2188,1224,964
2015,2,A,골목상권,1000855,동광로39길,47,28,19
2015,2,A,골목상권,1000854,동광로1길,1341,832,509
2015,2,A,골목상권,1000853,동광로12길,701,473,228
2015,2,A,골목상권,1000852,논현로27길,3638,2644,994
2015,2,A,골목상권,1000851,논현로1길,602,362,240
2015,2,A,골목상권,1000850,남부순환로339길,11537,5060,6477
2015,2,A,골목상권,1000849,남부순환로325길,7547,4029,3518
2015,2,A,골목상권,1000848,남부순환로317길,1584,1155,429
2015,2,A,골목상권,1000847,고무래로8길,6857,3838,3019
2015,2,A,골목상권,1000846,강남대로8길,3019,2046,973
2015,2,A,골목상권,1000845,강남대로34길,931,638,293
2015,2,A,골목상권,1000844,강남대로23길,5774,4221,1553
2015,2,A,골목상권,1000843,소담길,26,8,18
2015,2,A,골목상권,1000842,원신길,273,114,159
2015,2,A,골목상권,1000840,양산길,440,314,126
2015,2,A,골목상권,1000839,호암로24길,573,224,349
2015,2,A,골목상권,1000838,호암로20길,45,31,14
2015,2,A,골목상권,1000837,행운길,19,2,17
2015,2,A,골목상권,1000836,행운1길,76,49,27
2015,2,A,골목상권,1000835,청림3길,30,18,12
2015,2,A,골목상권,1000834,청룡길,225,133,92
2015,2,A,골목상권,1000833,청룡8길,8,4,4
2015,2,A,골목상권,1000832,중앙길,290,109,181
2015,2,A,골목상권,1000831,조원중앙로2길,1073,743,330
2015,2,A,골목상권,1000830,조원로18길,948,492,456
2015,2,A,골목상권,1000829,조원로10길,272,131,141
2015,2,A,골목상권,1000828,장군봉2길,322,141,181
2015,2,A,골목상권,1000827,장군봉1길,100,13,87
2015,2,A,골목상권,1000826,인헌길,78,38,40
2015,2,A,골목상권,1000825,은천로25길,286,94,192
2015,2,A,골목상권,1000824,양녕로6길,913,586,327
2015,2,A,골목상권,1000823,신원로3길,26,18,8
2015,2,A,골목상권,1000822,신사로20길,60,33,27
2015,2,A,골목상권,1000820,신림로64길,227,125,102
2015,2,A,골목상권,1000819,신림로48길,82,47,35
2015,2,A,골목상권,1000818,신림로38길,46,20,26
2015,2,A,골목상권,1000817,신림로28길,308,220,88
2015,2,A,골목상권,1000816,신림로11길,442,408,34
2015,2,A,골목상권,1000815,신림동길,438,271,167
2015,2,A,골목상권,1000814,승방길,499,319,180
2015,2,A,골목상권,1000813,서림7길,246,89,157
2015,2,A,골목상권,1000812,봉천로33길,337,221,116
2015,2,A,골목상권,1000811,봉천로13길,271,78,193
2015,2,A,골목상권,1000810,복은길,196,73,123
2015,2,A,골목상권,1000809,법원단지길,2,1,1
2015,2,A,골목상권,1000808,법원단지9길,85,32,53
2015,2,A,골목상권,1000807,미성5길,55,26,29
2015,2,A,골목상권,1000806,대학길,68,32,36
2015,2,A,골목상권,1000805,대학14길,12,2,10
2015,2,A,골목상권,1000804,당곡길,339,151,188
2015,2,A,골목상권,1000803,남현길,211,72,139
2015,2,A,골목상권,1000802,남현3길,521,305,216
2015,2,A,골목상권,1000800,남부순환로248길,271,138,133
2015,2,A,골목상권,1000799,남부순환로234길,126,82,44
2015,2,A,골목상권,1000798,남부순환로172길,1603,912,691
2015,2,A,골목상권,1000797,남부순환로161길,15,4,11
2015,2,A,골목상권,1000796,남부순환로151길,122,74,48
2015,2,A,골목상권,1000795,남부순환로142길,54,20,34
2015,2,A,골목상권,1000794,난향길,161,38,123
2015,2,A,골목상권,1000793,난우길,416,188,228
2015,2,A,골목상권,1000792,난곡로74길,161,62,99
2015,2,A,골목상권,1000791,난곡로34길,26,9,17
2015,2,A,골목상권,1000790,난곡로26길,91,39,52
2015,2,A,골목상권,1000789,난곡로24길,34,15,19
2015,2,A,골목상권,1000788,낙성대역길,776,492,284
2015,2,A,골목상권,1000787,국회단지길,515,230,285
2015,2,A,골목상권,1000786,구암길,73,29,44
2015,2,A,골목상권,1000785,관천로22길,17,7,10
2015,2,A,골목상권,1000784,관천로15길,129,70,59
2015,2,A,골목상권,1000783,관악로30길,200,63,137
2015,2,A,골목상권,1000782,관악로28길,152,76,76
2015,2,A,골목상권,1000781,관악로14길,473,269,204
2015,2,A,골목상권,1000780,관악로10길,252,179,73
2015,2,A,골목상권,1000779,흑석로9길,181,75,106
2015,2,A,골목상권,1000778,흑석로13길,145,23,122
2015,2,A,골목상권,1000777,장승배기로27길,31,15,16
2015,2,A,골목상권,1000776,장승배기로19길,2,1,1
2015,2,A,골목상권,1000774,여의대방로46길,374,110,264
2015,2,A,골목상권,1000773,여의대방로24길,14842,6826,8016
2015,2,A,골목상권,1000772,여의대방로22카길,254,102,152
2015,2,A,골목상권,1000771,여의대방로22나길,129,46,83
2015,2,A,골목상권,1000770,여의대방로22길,246,122,124
2015,2,A,골목상권,1000769,양녕로26길,125,66,59
2015,2,A,골목상권,1000768,신대방길,116,77,39
2015,2,A,골목상권,1000766,성대로1길,340,138,202
2015,2,A,골목상권,1000765,서달로8가길,196,82,114
2015,2,A,골목상권,1000763,서달로14길,40,16,24
2015,2,A,골목상권,1000762,서달로10길,73,31,42
2015,2,A,골목상권,1000761,상도로62길,176,62,114
2015,2,A,골목상권,1000760,상도로61길,63,35,28
2015,2,A,골목상권,1000759,상도로47길,70,50,20
2015,2,A,골목상권,1000758,상도로37길,1919,990,929
2015,2,A,골목상권,1000757,상도로15길,286,134,152
2015,2,A,골목상권,1000756,사당로8길,127,67,60
2015,2,A,골목상권,1000755,사당로30길,323,221,102
2015,2,A,골목상권,1000754,사당로2차길,89,54,35
2015,2,A,골목상권,1000753,사당로29길,18,15,3
2015,2,A,골목상권,1000752,사당로26길,251,143,108
2015,2,A,골목상권,1000751,사당로23나길,136,44,92
2015,2,A,골목상권,1000750,사당로23길,25,19,6
2015,2,A,골목상권,1000749,사당로20길,164,116,48
2015,2,A,골목상권,1000748,사당로16길,124,35,89
2015,2,A,골목상권,1000747,사당로16가길,870,558,312
2015,2,A,골목상권,1000746,만양로8길,65,27,38
2015,2,A,골목상권,1000745,만양로14길,399,186,213
2015,2,A,골목상권,1000744,등용로14길,539,413,126
2015,2,A,골목상권,1000743,동작대로7길,1711,751,960
2015,2,A,골목상권,1000742,동작대로35길,243,92,151
2015,2,A,골목상권,1000741,동작대로33길,112,61,51
2015,2,A,골목상권,1000740,동작대로29길,45,24,21
2015,2,A,골목상권,1000739,동작대로17길,1329,730,599
2015,2,A,골목상권,1000738,대방동2길,444,210,234
2015,2,A,골목상권,1000737,대방동27길,127,68,59
2015,2,A,골목상권,1000736,노량진로6길,115,32,83
2015,2,A,골목상권,1000735,국사봉길,32,5,27
2015,2,A,골목상권,1000734,국사봉2길,94,60,34
2015,2,A,골목상권,1000733,국사봉1길,7,3,4
2015,2,A,골목상권,1000732,영신로9길,310,157,153
2015,2,A,골목상권,1000731,영등포로84길,321,83,238
2015,2,A,골목상권,1000730,영등포로80길,64,39,25
2015,2,A,골목상권,1000729,영등포로62길,3,2,1
2015,2,A,골목상권,1000728,영등포로35길,48,35,13
2015,2,A,골목상권,1000727,영등포로27길,303,171,132
2015,2,A,골목상권,1000724,여의대방로43나길,2276,1857,419
2015,2,A,골목상권,1000723,여의대방로39길,16,12,4
2015,2,A,골목상권,1000722,여의대방로35길,711,381,330
2015,2,A,골목상권,1000721,양평로28길,665,537,128
2015,2,A,골목상권,1000720,양평로22라길,44,27,17
2015,2,A,골목상권,1000719,양평로19길,3810,3112,698
2015,2,A,골목상권,1000718,신길로60길,418,175,243
2015,2,A,골목상권,1000717,신길로42길,389,202,187
2015,2,A,골목상권,1000716,신길로42가길,90,27,63
2015,2,A,골목상권,1000715,신길로39길,106,49,57
2015,2,A,골목상권,1000714,신길로17길,44,30,14
2015,2,A,골목상권,1000713,선유서로28길,412,227,185
2015,2,A,골목상권,1000712,선유서로25길,2218,1653,565
2015,2,A,골목상권,1000711,선유서로24길,151,84,67
2015,2,A,골목상권,1000710,선유로55길,2223,1398,825
2015,2,A,골목상권,1000709,디지털로74길,55,33,22
2015,2,A,골목상권,1000708,디지털로57길,7,2,5
2015,2,A,골목상권,1000707,디지털로37길,210,103,107
2015,2,A,골목상권,1000706,도신로62길,196,50,146
2015,2,A,골목상권,1000705,도신로60길,86,12,74
2015,2,A,골목상권,1000704,도신로29길,72,37,35
2015,2,A,골목상권,1000703,도신로15길,82,46,36
2015,2,A,골목상권,1000702,도림천로21길,99,49,50
2015,2,A,골목상권,1000701,도림로63길,34,21,13
2015,2,A,골목상권,1000700,도림로147길,1562,1164,398
2015,2,A,골목상권,1000699,도림로112길,8,7,1
2015,2,A,골목상권,1000698,대림로8길,1846,629,1217
2015,2,A,골목상권,1000697,대림로7길,15,5,10
2015,2,A,골목상권,1000696,대림로44길,44,26,18
2015,2,A,골목상권,1000695,대림로34길,180,71,109
2015,2,A,골목상권,1000694,대림로31길,872,444,428
2015,2,A,골목상권,1000693,대림로29길,1509,723,786
2015,2,A,골목상권,1000692,대림로22길,291,166,125
2015,2,A,골목상권,1000691,당산로46길,3136,1716,1420
2015,2,A,골목상권,1000690,당산로38길,337,267,70
2015,2,A,골목상권,1000689,당산로37길,3436,2175,1261
2015,2,A,골목상권,1000688,당산로31길,3977,2217,1760
2015,2,A,골목상권,1000687,국회대로56길,1542,980,562
2015,2,A,골목상권,1000686,경인로90길,321,199,122
2015,2,A,골목상권,1000685,경인로80길,1576,1146,430
2015,2,A,골목상권,1000684,경인로77길,611,441,170
2015,2,A,골목상권,1000683,가마산로61길,202,84,118
2015,2,A,골목상권,1000682,시흥대로94길,758,398,360
2015,2,A,골목상권,1000681,시흥대로84길,170,66,104
2015,2,A,골목상권,1000680,시흥대로68길,344,122,222
2015,2,A,골목상권,1000679,시흥대로63길,2664,1417,1247
2015,2,A,골목상권,1000678,시흥대로62가길,421,115,306
2015,2,A,골목상권,1000677,시흥대로36길,342,206,136
2015,2,A,골목상권,1000676,시흥대로22길,467,336,131
2015,2,A,골목상권,1000675,시흥대로153길,658,364,294
2015,2,A,골목상권,1000674,시흥대로150길,550,248,302
2015,2,A,골목상권,1000673,시흥대로141길,670,407,263
2015,2,A,골목상권,1000672,시흥대로138길,14,7,7
2015,2,A,골목상권,1000671,시흥대로120길,538,360,178
2015,2,A,골목상권,1000670,벚꽃로56길,1697,1187,510
2015,2,A,골목상권,1000669,범안로17길,186,91,95
2015,2,A,골목상권,1000668,범안로11길,1045,853,192
2015,2,A,골목상권,1000667,문성로5길,170,53,117
2015,2,A,골목상권,1000666,독산로85길,69,24,45
2015,2,A,골목상권,1000665,독산로78다길,234,99,135
2015,2,A,골목상권,1000664,독산로70길,4,3,1
2015,2,A,골목상권,1000663,독산로64길,155,40,115
2015,2,A,골목상권,1000662,독산로50길,49,24,25
2015,2,A,골목상권,1000661,독산로40길,50,18,32
2015,2,A,골목상권,1000660,독산로108길,768,328,440
2015,2,A,골목상권,1000659,남부순환로112길,9,5,4
2015,2,A,골목상권,1000658,금하로24길,163,56,107
2015,2,A,골목상권,1000657,금하로1길,54,27,27
2015,2,A,골목상권,1000656,금하로14길,2,1,1
2015,2,A,골목상권,1000655,가산로5길,504,392,112
2015,2,A,골목상권,1000654,가산로3길,2494,1914,580
2015,2,A,골목상권,1000653,중앙로1길,1390,992,398
2015,2,A,골목상권,1000652,중앙로15길,195,63,132
2015,2,A,골목상권,1000651,우마길,30,19,11
2015,2,A,골목상권,1000650,오류로8길,212,101,111
2015,2,A,골목상권,1000649,신도림로13길,697,536,161
2015,2,A,골목상권,1000648,새말로18길,1158,439,719
2015,2,A,골목상권,1000647,부일로1길,768,627,141
2015,2,A,골목상권,1000646,부일로15길,182,156,26
2015,2,A,골목상권,1000645,부일로11길,24,7,17
2015,2,A,골목상권,1000644,디지털로32길,1246,683,563
2015,2,A,골목상권,1000643,디지털로32가길,6866,4903,1963
2015,2,A,골목상권,1000642,디지털로27길,398,250,148
2015,2,A,골목상권,1000641,도림로6길,120,52,68
2015,2,A,골목상권,1000640,도림로12길,94,37,57
2015,2,A,골목상권,1000639,남부순환로97길,258,80,178
2015,2,A,골목상권,1000638,구로중앙로8길,254,103,151
2015,2,A,골목상권,1000637,구로중앙로7길,182,71,111
2015,2,A,골목상권,1000636,구로중앙로42길,726,563,163
2015,2,A,골목상권,1000635,구로중앙로34길,566,316,250
2015,2,A,골목상권,1000634,구로중앙로28길,2863,1405,1458
2015,2,A,골목상권,1000633,구로중앙로19길,11,6,5
2015,2,A,골목상권,1000632,구로동로8길,158,54,104
2015,2,A,골목상권,1000631,구로동로7길,164,65,99
2015,2,A,골목상권,1000630,구로동로42길,27,20,7
2015,2,A,골목상권,1000629,구로동로41길,455,277,178
2015,2,A,골목상권,1000628,구로동로38길,46,20,26
2015,2,A,골목상권,1000627,구로동로28길,178,70,108
2015,2,A,골목상권,1000626,구로동로15길,23,2,21
2015,2,A,골목상권,1000625,공원로6가길,248,186,62
2015,2,A,골목상권,1000624,고척로52길,232,75,157
2015,2,A,골목상권,1000623,고척로27다길,206,82,124
2015,2,A,골목상권,1000622,고척로27길,229,91,138
2015,2,A,골목상권,1000621,고척로21나길,257,56,201
2015,2,A,골목상권,1000620,경인로47길,771,433,338
2015,2,A,골목상권,1000619,경인로35길,274,121,153
2015,2,A,골목상권,1000618,경인로31길,51,14,37
2015,2,A,골목상권,1000617,경인로15길,112,52,60
2015,2,A,골목상권,1000616,개봉로3길,303,178,125
2015,2,A,골목상권,1000615,개봉로2길,476,119,357
2015,2,A,골목상권,1000614,개봉로23가길,872,497,375
2015,2,A,골목상권,1000613,개봉로20길,114,64,50
2015,2,A,골목상권,1000612,개봉로1길,39,20,19
2015,2,A,골목상권,1000611,개봉로17다길,122,51,71
2015,2,A,골목상권,1000610,개봉로17길,800,380,420
2015,2,A,골목상권,1000609,개봉로11길,49,11,38
2015,2,A,골목상권,1000608,화곡로64길,2502,1314,1188
2015,2,A,골목상권,1000607,화곡로59길,505,202,303
2015,2,A,골목상권,1000606,화곡로44나길,871,731,140
2015,2,A,골목상권,1000605,화곡로31길,1303,559,744
2015,2,A,골목상권,1000604,화곡로20길,494,313,181
2015,2,A,골목상권,1000603,화곡로13길,258,87,171
2015,2,A,골목상권,1000602,초원로16길,472,226,246
2015,2,A,골목상권,1000601,초록마을로8길,174,31,143
2015,2,A,골목상권,1000600,초록마을로3길,44,23,21
2015,2,A,골목상권,1000599,월정로20길,4,1,3
2015,2,A,골목상권,1000598,우장산로6길,321,185,136
2015,2,A,골목상권,1000597,양천로73가길,1391,904,487
2015,2,A,골목상권,1000596,양천로71길,206,127,79
2015,2,A,골목상권,1000595,양천로49길,813,640,173
2015,2,A,골목상권,1000594,양천로26길,101,44,57
2015,2,A,골목상권,1000593,양천로24길,214,106,108
2015,2,A,골목상권,1000592,양천로24가길,685,284,401
2015,2,A,골목상권,1000591,양천로14길,372,220,152
2015,2,A,골목상권,1000590,방화대로6라길,732,483,249
2015,2,A,골목상권,1000589,방화대로21길,746,443,303
2015,2,A,골목상권,1000588,등촌로5길,10,2,8
2015,2,A,골목상권,1000587,등촌로55길,460,335,125
2015,2,A,골목상권,1000586,등촌로51길,9,9,0
2015,2,A,골목상권,1000585,등촌로39길,48,18,30
2015,2,A,골목상권,1000584,등촌로13길,216,109,107
2015,2,A,골목상권,1000583,남부순환로11길,398,282,116
2015,2,A,골목상권,1000582,까치산로4길,125,45,80
2015,2,A,골목상권,1000581,국회대로7길,331,203,128
2015,2,A,골목상권,1000580,공항대로8길,244,141,103
2015,2,A,골목상권,1000579,공항대로61길,233,148,85
2015,2,A,골목상권,1000578,공항대로59다길,855,632,223
2015,2,A,골목상권,1000577,공항대로59길,1228,802,426
2015,2,A,골목상권,1000576,공항대로55길,903,646,257
2015,2,A,골목상권,1000575,공항대로42길,10,6,4
2015,2,A,골목상권,1000574,공항대로38길,236,121,115
2015,2,A,골목상권,1000573,곰달래로60길,538,272,266
2015,2,A,골목상권,1000572,곰달래로53길,59,15,44
2015,2,A,골목상권,1000571,곰달래로47길,30,11,19
2015,2,A,골목상권,1000570,곰달래로31길,10,8,2
2015,2,A,골목상권,1000569,곰달래로25길,521,199,322
2015,2,A,골목상권,1000568,개화동로25길,649,435,214
2015,2,A,골목상권,1000567,개화동로23길,93,56,37
2015,2,A,골목상권,1000566,강서로8길,108,69,39
2015,2,A,골목상권,1000565,강서로5라길,253,150,103
2015,2,A,골목상권,1000564,강서로5나길,112,70,42
2015,2,A,골목상권,1000563,강서로5가길,36,22,14
2015,2,A,골목상권,1000562,강서로47라길,72,40,32
2015,2,A,골목상권,1000561,강서로47길,384,198,186
2015,2,A,골목상권,1000560,강서로45다길,706,230,476
2015,2,A,골목상권,1000559,강서로45길,112,56,56
2015,2,A,골목상권,1000558,강서로35길,155,93,62
2015,2,A,골목상권,1000557,강서로29길,277,151,126
2015,2,A,골목상권,1000556,강서로18길,25,14,11
2015,2,A,골목상권,1000555,강서로17가길,106,44,62
2015,2,A,골목상권,1000554,강서로15길,253,131,122
2015,2,A,골목상권,1000553,가로공원로80길,84,47,37
2015,2,A,골목상권,1000552,가로공원로76가길,20,8,12
2015,2,A,골목상권,1000551,화곡로4길,279,108,171
2015,2,A,골목상권,1000550,화곡로3길,160,50,110
2015,2,A,골목상권,1000549,지양로7길,223,72,151
2015,2,A,골목상권,1000548,중앙로55길,369,195,174
2015,2,A,골목상권,1000547,중앙로51길,114,67,47
2015,2,A,골목상권,1000546,중앙로47길,98,18,80
2015,2,A,골목상권,1000545,중앙로45길,163,55,108
2015,2,A,골목상권,1000544,중앙로36길,2,2,0
2015,2,A,골목상권,1000543,중앙로32길,548,267,281
2015,2,A,골목상권,1000542,중앙로25길,258,74,184
2015,2,A,골목상권,1000541,은행정로7길,445,153,292
2015,2,A,골목상권,1000539,오목로5길,311,176,135
2015,2,A,골목상권,1000538,오목로3길,462,436,26
2015,2,A,골목상권,1000537,오목로30길,162,81,81
2015,2,A,골목상권,1000536,오목로23길,708,380,328
2015,2,A,골목상권,1000535,신월로20길,213,79,134
2015,2,A,골목상권,1000534,신월로15길,758,354,404
2015,2,A,골목상권,1000533,신목로6길,256,133,123
2015,2,A,골목상권,1000532,신목로5길,919,346,573
2015,2,A,골목상권,1000531,신목로2길,99,45,54
2015,2,A,골목상권,1000530,목동중앙서로8가길,202,105,97
2015,2,A,골목상권,1000529,목동중앙서로7길,238,86,152
2015,2,A,골목상권,1000528,목동중앙북로8길,402,177,225
2015,2,A,골목상권,1000527,목동중앙북로16길,260,79,181
2015,2,A,골목상권,1000526,목동중앙본로7길,93,33,60
2015,2,A,골목상권,1000525,목동중앙로3길,103,58,45
2015,2,A,골목상권,1000524,목동중앙로13나길,245,172,73
2015,2,A,골목상권,1000523,목동중앙남로3가길,556,380,176
2015,2,A,골목상권,1000522,목동로9길,2280,1501,779
2015,2,A,골목상권,1000521,목동로19길,963,377,586
2015,2,A,골목상권,1000519,목동동로12길,419,169,250
2015,2,A,골목상권,1000518,목동남로4길,10,5,5
2015,2,A,골목상권,1000517,남부순환로88길,316,129,187
2015,2,A,골목상권,1000516,남부순환로79길,520,388,132
2015,2,A,골목상권,1000515,남부순환로70길,677,490,187
2015,2,A,골목상권,1000514,남부순환로58길,142,77,65
2015,2,A,골목상권,1000513,남부순환로40길,21,12,9
2015,2,A,골목상권,1000512,남부순환로33길,1166,921,245
2015,2,A,골목상권,1000511,곰달래로5길,48,26,22
2015,2,A,골목상권,1000510,곰달래로3길,425,218,207
2015,2,A,골목상권,1000509,곰달래로2길,296,180,116
2015,2,A,골목상권,1000508,곰달래로10길,358,278,80
2015,2,A,골목상권,1000507,가로공원로58길,94,20,74
2015,2,A,골목상권,1000506,효창원로93길,109,57,52
2015,2,A,골목상권,1000505,토정로37길,142,56,86
2015,2,A,골목상권,1000504,월드컵로8길,1537,879,658
2015,2,A,골목상권,1000503,월드컵로7길,4,2,2
2015,2,A,골목상권,1000502,월드컵로36길,115,32,83
2015,2,A,골목상권,1000501,월드컵로25길,292,159,133
2015,2,A,골목상권,1000500,월드컵로19길,419,177,242
2015,2,A,골목상권,1000499,월드컵로16길,2333,1458,875
2015,2,A,골목상권,1000498,월드컵로11길,207,72,135
2015,2,A,골목상권,1000497,월드컵로10길,1711,915,796
2015,2,A,골목상권,1000496,와우산로3길,164,96,68
2015,2,A,골목상권,1000495,와우산로29길,126,63,63
2015,2,A,골목상권,1000494,와우산로29가길,16,5,11
2015,2,A,골목상권,1000493,양화진길,462,330,132
2015,2,A,골목상권,1000492,양화로1길,4265,2218,2047
2015,2,A,골목상권,1000491,양화로11길,386,246,140
2015,2,A,골목상권,1000490,신촌로30길,27,13,14
2015,2,A,골목상권,1000489,신촌로28가길,118,49,69
2015,2,A,골목상권,1000488,신촌로12길,1181,545,636
2015,2,A,골목상권,1000487,숭문길,712,399,313
2015,2,A,골목상권,1000486,숭문8길,114,67,47
2015,2,A,골목상권,1000485,성지3길,498,274,224
2015,2,A,골목상권,1000484,성산로4길,2210,1442,768
2015,2,A,골목상권,1000483,성미산로32길,283,155,128
2015,2,A,골목상권,1000482,성미산로1길,599,478,121
2015,2,A,골목상권,1000481,성미산로11길,970,659,311
2015,2,A,골목상권,1000480,백범로16길,543,289,254
2015,2,A,골목상권,1000479,방울내로9안길,331,197,134
2015,2,A,골목상권,1000478,모래내로7길,244,129,115
2015,2,A,골목상권,1000477,매봉산로2길,1803,1200,603
2015,2,A,골목상권,1000476,망원로2길,190,125,65
2015,2,A,골목상권,1000475,망원로11길,860,473,387
2015,2,A,골목상권,1000474,만리재옛길,1250,508,742
2015,2,A,골목상권,1000473,마포대로4길,292,127,165
2015,2,A,골목상권,1000472,마포대로20길,1197,615,582
2015,2,A,골목상권,1000471,마포대로12길,68,35,33
2015,2,A,골목상권,1000470,동교로38길,198,77,121
2015,2,A,골목상권,1000469,동교로27길,3012,1415,1597
2015,2,A,골목상권,1000468,동교로25길,360,203,157
2015,2,A,골목상권,1000467,동교로19길,4203,2570,1633
2015,2,A,골목상권,1000466,동교로17길,785,394,391
2015,2,A,골목상권,1000465,독막로8길,345,162,183
2015,2,A,골목상권,1000464,독막로32길,464,191,273
2015,2,A,골목상권,1000463,독막로22길,81,43,38
2015,2,A,골목상권,1000462,도화길,1079,534,545
2015,2,A,골목상권,1000461,도화4길,347,118,229
2015,2,A,골목상권,1000460,대흥로28길,60,50,10
2015,2,A,골목상권,1000459,대흥로21길,570,109,461
2015,2,A,골목상권,1000458,광성로6길,105,72,33
2015,2,A,골목상권,1000457,홍제내길,96,56,40
2015,2,A,골목상권,1000456,홍연길,79,49,30
2015,2,A,골목상권,1000455,통일로39길,9,8,1
2015,2,A,골목상권,1000454,통일로37길,367,149,218
2015,2,A,골목상권,1000453,통일로11길,14,11,3
2015,2,A,골목상권,1000452,충정로6길,14839,8168,6671
2015,2,A,골목상권,1000451,충정로4길,2802,1894,908
2015,2,A,골목상권,1000450,증가로6길,247,90,157
2015,2,A,골목상권,1000449,증가로23나길,444,219,225
2015,2,A,골목상권,1000448,증가로20가길,294,103,191
2015,2,A,골목상권,1000447,증가로10길,172,94,78
2015,2,A,골목상권,1000446,응암로1길,317,241,76
2015,2,A,골목상권,1000445,연희로10길,94,63,31
2015,2,A,골목상권,1000444,신촌로37길,155,66,89
2015,2,A,골목상권,1000443,수색로8길,2700,2618,82
2015,2,A,골목상권,1000442,세무서길,327,119,208
2015,2,A,골목상권,1000440,세검정로1길,241,142,99
2015,2,A,골목상권,1000439,북아현로4길,402,95,307
2015,2,A,골목상권,1000438,모래내로15길,86,27,59
2015,2,A,골목상권,1000437,명지대길,335,245,90
2015,2,A,골목상권,1000436,독립문로8길,660,249,411
2015,2,A,골목상권,1000435,가재울로6길,10,7,3
2015,2,A,골목상권,1000434,통일로92길,61,30,31
2015,2,A,골목상권,1000433,통일로87길,218,100,118
2015,2,A,골목상권,1000432,통일로78길,206,64,142
2015,2,A,골목상권,1000430,진흥로1길,538,182,356
2015,2,A,골목상권,1000429,진흥로12길,411,184,227
2015,2,A,골목상권,1000428,증산서길,374,280,94
2015,2,A,골목상권,1000427,증산로9길,92,33,59
2015,2,A,골목상권,1000426,증산로5길,721,367,354
2015,2,A,골목상권,1000425,증산로21길,252,171,81
2015,2,A,골목상권,1000424,증산로17길,774,380,394
2015,2,A,골목상권,1000423,증산로15길,179,64,115
2015,2,A,골목상권,1000422,증산로13길,70,36,34
2015,2,A,골목상권,1000421,응암로34길,94,61,33
2015,2,A,골목상권,1000420,응암로22길,163,56,107
2015,2,A,골목상권,1000419,응암로14길,331,103,228
2015,2,A,골목상권,1000418,응암로13길,233,90,143
2015,2,A,골목상권,1000417,응암로12길,202,94,108
2015,2,A,골목상권,1000416,은평로8길,255,138,117
2015,2,A,골목상권,1000415,은평로3길,298,94,204
2015,2,A,골목상권,1000414,은평로20길,21,9,12
2015,2,A,골목상권,1000413,은평로13길,529,348,181
2015,2,A,골목상권,1000412,은평로10길,311,194,117
2015,2,A,골목상권,1000411,연서로5길,55,23,32
2015,2,A,골목상권,1000410,연서로41길,234,67,167
2015,2,A,골목상권,1000409,연서로3길,114,47,67
2015,2,A,골목상권,1000408,연서로34길,124,36,88
2015,2,A,골목상권,1000407,연서로33길,21,5,16
2015,2,A,골목상권,1000406,연서로29길,317,119,198
2015,2,A,골목상권,1000405,연서로28길,741,368,373
2015,2,A,골목상권,1000404,연서로27길,64,30,34
2015,2,A,골목상권,1000403,연서로21길,269,137,132
2015,2,A,골목상권,1000402,연서로17길,1041,388,653
2015,2,A,골목상권,1000401,연서로16길,323,118,205
2015,2,A,골목상권,1000400,연서로13길,702,232,470
2015,2,A,골목상권,1000399,연서로11길,179,96,83
2015,2,A,골목상권,1000398,역말로9길,21,18,3
2015,2,A,골목상권,1000397,수색로18길,643,530,113
2015,2,A,골목상권,1000396,서오릉로8길,31,14,17
2015,2,A,골목상권,1000395,서오릉로21길,451,143,308
2015,2,A,골목상권,1000394,불광천길,171,82,89
2015,2,A,골목상권,1000393,갈현로7길,968,255,713
2015,2,A,골목상권,1000392,갈현로41길,88,28,60
2015,2,A,골목상권,1000391,갈현로33길,42,11,31
2015,2,A,골목상권,1000390,갈현로1길,134,62,72
2015,2,A,골목상권,1000389,가좌로7길,51,24,27
2015,2,A,골목상권,1000388,한글비석로44길,450,254,196
2015,2,A,골목상권,1000387,한글비석로24길,356,147,209
2015,2,A,골목상권,1000386,한글비석로22길,681,286,395
2015,2,A,골목상권,1000385,석계로1길,106,67,39
2015,2,A,골목상권,1000384,상계로9가길,266,91,175
2015,2,A,골목상권,1000382,상계로12길,13,9,4
2015,2,A,골목상권,1000381,동일로242길,521,411,110
2015,2,A,골목상권,1000380,동일로192길,442,225,217
2015,2,A,골목상권,1000379,동일로173가길,2361,1304,1057
2015,2,A,골목상권,1000378,공릉로58길,92,39,53
2015,2,A,골목상권,1000377,해등로16길,75,60,15
2015,2,A,골목상권,1000376,우이천로4다길,187,109,78
2015,2,A,골목상권,1000375,우이천로32길,95,46,49
2015,2,A,골목상권,1000374,시루봉로23길,37,16,21
2015,2,A,골목상권,1000373,삼양로144길,74,55,19
2015,2,A,골목상권,1000372,방학로6가길,159,90,69
2015,2,A,골목상권,1000371,방학로5길,148,81,67
2015,2,A,골목상권,1000370,방학로15길,330,220,110
2015,2,A,골목상권,1000369,방학로10길,141,76,65
2015,2,A,골목상권,1000367,도봉산4길,314,277,37
2015,2,A,골목상권,1000366,도봉로181길,252,123,129
2015,2,A,골목상권,1000365,도봉로169나길,230,124,106
2015,2,A,골목상권,1000364,도봉로156길,263,144,119
2015,2,A,골목상권,1000363,도봉로152가길,441,384,57
2015,2,A,골목상권,1000362,도봉로147길,613,352,261
2015,2,A,골목상권,1000360,도봉로114길,454,144,310
2015,2,A,골목상권,1000359,도봉로109길,16,6,10
2015,2,A,골목상권,1000358,도당로29길,903,544,359
2015,2,A,골목상권,1000357,도당로19길,164,74,90
2015,2,A,골목상권,1000356,도당로13바길,204,72,132
2015,2,A,골목상권,1000355,도당로13가길,133,60,73
2015,2,A,골목상권,1000354,덕릉로60길,68,39,29
2015,2,A,골목상권,1000353,노해로63다길,494,217,277
2015,2,A,골목상권,1000352,노해로60길,303,140,163
2015,2,A,골목상권,1000351,한천로140길,113,66,47
2015,2,A,골목상권,1000350,한천로139가길,59,34,25
2015,2,A,골목상권,1000349,한천로132길,314,113,201
2015,2,A,골목상권,1000348,한천로130길,274,117,157
2015,2,A,골목상권,1000347,한천로124나길,93,44,49
2015,2,A,골목상권,1000346,한천로109길,603,276,327
2015,2,A,골목상권,1000345,인수봉로79길,167,34,133
2015,2,A,골목상권,1000344,인수봉로72길,89,48,41
2015,2,A,골목상권,1000343,인수봉로56길,9,1,8
2015,2,A,골목상권,1000342,오패산로67길,530,291,239
2015,2,A,골목상권,1000341,오패산로52길,82,24,58
2015,2,A,골목상권,1000339,수유로12길,245,151,94
2015,2,A,골목상권,1000338,솔샘로65길,519,235,284
2015,2,A,골목상권,1000337,솔매로50길,687,276,411
2015,2,A,골목상권,1000336,솔매로45길,250,99,151
2015,2,A,골목상권,1000335,솔매로41길,86,25,61
2015,2,A,골목상권,1000334,삼양로93길,17,4,13
2015,2,A,골목상권,1000333,삼양로77길,403,140,263
2015,2,A,골목상권,1000332,삼양로54길,4,2,2
2015,2,A,골목상권,1000331,삼양로41길,329,154,175
2015,2,A,골목상권,1000329,삼양로24길,77,33,44
2015,2,A,골목상권,1000328,삼양로20길,122,44,78
2015,2,A,골목상권,1000327,삼각산로28길,669,386,283
2015,2,A,골목상권,1000326,도봉로99길,171,98,73
2015,2,A,골목상권,1000325,도봉로8길,266,184,82
2015,2,A,골목상권,1000324,도봉로76길,324,166,158
2015,2,A,골목상권,1000323,도봉로67길,8,4,4
2015,2,A,골목상권,1000322,도봉로45길,156,98,58
2015,2,A,골목상권,1000321,도봉로18길,537,253,284
2015,2,A,골목상권,1000320,도봉로13길,25,10,15
2015,2,A,골목상권,1000319,덕릉로41길,688,577,111
2015,2,A,골목상권,1000318,덕릉로40길,906,693,213
2015,2,A,골목상권,1000317,노해로33길,31,12,19
2015,2,A,골목상권,1000315,노해로17길,241,131,110
2015,2,A,골목상권,1000314,화랑로40길,139,73,66
2015,2,A,골목상권,1000313,화랑로32길,408,295,113
2015,2,A,골목상권,1000312,화랑로1길,191,100,91
2015,2,A,골목상권,1000311,화랑로19길,437,231,206
2015,2,A,골목상권,1000310,화랑로14길,40,19,21
2015,2,A,골목상권,1000309,화랑로13길,101,50,51
2015,2,A,골목상권,1000308,한천로76길,115,68,47
2015,2,A,골목상권,1000307,한천로101가길,66,44,22
2015,2,A,골목상권,1000306,창경궁로43길,30,15,15
2015,2,A,골목상권,1000305,지봉로20길,112,67,45
2015,2,A,골목상권,1000304,종암로5길,107,77,30
2015,2,A,골목상권,1000303,종암로24가길,270,145,125
2015,2,A,골목상권,1000302,종암로21길,122,44,78
2015,2,A,골목상권,1000301,종암로19길,369,108,261
2015,2,A,골목상권,1000300,종암로16길,68,31,37
2015,2,A,골목상권,1000299,정릉로8길,209,124,85
2015,2,A,골목상권,1000298,정릉로27길,211,96,115
2015,2,A,골목상권,1000296,장위로50길,987,540,447
2015,2,A,골목상권,1000295,장월로1길,397,156,241
2015,2,A,골목상권,1000294,인촌로6길,2186,1150,1036
2015,2,A,골목상권,1000293,인촌로5길,26,6,20
2015,2,A,골목상권,1000292,인촌로24길,347,160,187
2015,2,A,골목상권,1000291,개운사길,2756,1817,939
2015,2,A,골목상권,1000290,인촌로1길,143,98,45
2015,2,A,골목상권,1000289,인촌로17가길,2997,1157,1840
2015,2,A,골목상권,1000288,오패산로4길,530,180,350
2015,2,A,골목상권,1000287,오패산로3길,1278,739,539
2015,2,A,골목상권,1000286,오패산로19길,44,19,25
2015,2,A,골목상권,1000285,안암로5길,550,346,204
2015,2,A,골목상권,1000284,아리랑로4길,697,252,445
2015,2,A,골목상권,1000283,솔샘로6길,138,66,72
2015,2,A,골목상권,1000282,성북로8길,61,29,32
2015,2,A,골목상권,1000281,삼양로8길,81,45,36
2015,2,A,골목상권,1000280,삼선교로16가길,668,379,289
2015,2,A,골목상권,1000279,삼선교로10다길,103,34,69
2015,2,A,골목상권,1000278,삼선교로10길,242,101,141
2015,2,A,골목상권,1000277,보문로32길,966,408,558
2015,2,A,골목상권,1000276,보문로31길,820,337,483
2015,2,A,골목상권,1000274,보문로13길,740,425,315
2015,2,A,골목상권,1000273,보국문로16길,279,192,87
2015,2,A,골목상권,1000270,동소문로26가길,244,127,117
2015,2,A,골목상권,1000269,동소문로15길,68,31,37
2015,2,A,골목상권,1000268,동소문로13길,663,322,341
2015,2,A,골목상권,1000267,돌곶이로8길,202,116,86
2015,2,A,골목상권,1000266,돌곶이로41길,27,11,16
2015,2,A,골목상권,1000265,돌곶이로28길,129,74,55
2015,2,A,골목상권,1000264,돌곶이로27길,49,31,18
2015,2,A,골목상권,1000263,돌곶이로22길,103,54,49
2015,2,A,골목상권,1000261,길음로7길,10,6,4
2015,2,A,골목상권,1000260,중랑천로10길,645,349,296
2015,2,A,골목상권,1000259,용마산로94길,431,273,158
2015,2,A,골목상권,1000258,용마산로118길,457,221,236
2015,2,A,골목상권,1000257,용마산로112길,265,130,135
2015,2,A,골목상권,1000256,용마산로100길,481,348,133
2015,2,A,골목상권,1000255,신내로7가길,286,72,214
2015,2,A,골목상권,1000254,사가정로54길,96,30,66
2015,2,A,골목상권,1000253,사가정로42길,66,26,40
2015,2,A,골목상권,1000252,봉화산로56길,564,147,417
2015,2,A,골목상권,1000251,봉화산로4길,316,122,194
2015,2,A,골목상권,1000250,봉화산로30길,381,255,126
2015,2,A,골목상권,1000249,봉우재로33길,59,23,36
2015,2,A,골목상권,1000248,면목로78길,274,158,116
2015,2,A,골목상권,1000247,면목로56길,229,178,51
2015,2,A,골목상권,1000246,면목로55길,419,120,299
2015,2,A,골목상권,1000245,면목로49길,524,171,353
2015,2,A,골목상권,1000244,면목로48길,96,54,42
2015,2,A,골목상권,1000243,면목로45길,83,38,45
2015,2,A,골목상권,1000242,면목로33길,435,160,275
2015,2,A,골목상권,1000241,면목로21길,38,28,10
2015,2,A,골목상권,1000240,망우로73길,10,5,5
2015,2,A,골목상권,1000239,망우로68길,85,37,48
2015,2,A,골목상권,1000238,동일로163길,120,82,38
2015,2,A,골목상권,1000237,동일로157길,186,94,92
2015,2,A,골목상권,1000236,동일로149길,1102,815,287
2015,2,A,골목상권,1000235,동일로140길,222,89,133
2015,2,A,골목상권,1000234,동일로139길,71,45,26
2015,2,A,골목상권,1000233,동일로139가길,1053,627,426
2015,2,A,골목상권,1000232,동일로130길,91,21,70
2015,2,A,골목상권,1000231,동일로123길,191,103,88
2015,2,A,골목상권,1000230,동일로112길,186,72,114
2015,2,A,골목상권,1000229,동일로101길,327,135,192
2015,2,A,골목상권,1000228,동일로100길,35,17,18
2015,2,A,골목상권,1000227,답십리로75길,83,44,39
2015,2,A,골목상권,1000226,공릉로2길,568,278,290
2015,2,A,골목상권,1000225,공릉로12가길,45,29,16
2015,2,A,골목상권,1000224,겸재로54길,95,51,44
2015,2,A,골목상권,1000223,겸재로36길,302,241,61
2015,2,A,골목상권,1000222,겸재로29길,437,190,247
2015,2,A,골목상권,1000221,휘경로3길,196,97,99
2015,2,A,골목상권,1000220,휘경로2길,7,2,5
2015,2,A,골목상권,1000219,휘경로23길,15,0,15
2015,2,A,골목상권,1000218,휘경로14길,102,48,54
2015,2,A,골목상권,1000217,한천로46길,381,123,258
2015,2,A,골목상권,1000216,한천로40길,287,161,126
2015,2,A,골목상권,1000215,한천로33길,78,34,44
2015,2,A,골목상권,1000214,한천로14길,601,372,229
2015,2,A,골목상권,1000213,천호대로97길,338,221,117
2015,2,A,골목상권,1000212,천호대로77길,1926,959,967
2015,2,A,골목상권,1000211,천호대로45길,167,108,59
2015,2,A,골목상권,1000210,천호대로17길,2024,1273,751
2015,2,A,골목상권,1000209,천호대로12길,810,543,267
2015,2,A,골목상권,1000208,천장산로7길,1389,872,517
2015,2,A,골목상권,1000207,제기로5길,198,109,89
2015,2,A,골목상권,1000206,제기로21길,217,142,75
2015,2,A,골목상권,1000205,전농로4길,650,427,223
2015,2,A,골목상권,1000204,전농로3길,96,41,55
2015,2,A,골목상권,1000203,전농로29길,313,152,161
2015,2,A,골목상권,1000202,장한로8길,725,411,314
2015,2,A,골목상권,1000201,장한로5길,2975,2073,902
2015,2,A,골목상권,1000200,장한로27길,176,51,125
2015,2,A,골목상권,1000199,장한로27가길,379,175,204
2015,2,A,골목상권,1000198,장한로26길,564,280,284
2015,2,A,골목상권,1000197,장한로26가길,359,173,186
2015,2,A,골목상권,1000196,장한로25길,1000,464,536
2015,2,A,골목상권,1000195,장한로14길,195,170,25
2015,2,A,골목상권,1000194,이문로42길,237,96,141
2015,2,A,골목상권,1000193,왕산로43길,967,467,500
2015,2,A,골목상권,1000192,왕산로33길,170,115,55
2015,2,A,골목상권,1000191,왕산로32길,13,8,5
2015,2,A,골목상권,1000190,약령시로17길,252,134,118
2015,2,A,골목상권,1000189,서울시립대로4길,795,502,293
2015,2,A,골목상권,1000188,서울시립대로29길,201,118,83
2015,2,A,골목상권,1000187,서울시립대로16길,116,33,83
2015,2,A,골목상권,1000186,사가정로2길,131,97,34
2015,2,A,골목상권,1000185,사가정로23가길,102,67,35
2015,2,A,골목상권,1000184,사가정로13길,307,114,193
2015,2,A,골목상권,1000183,무학로45길,384,213,171
2015,2,A,골목상권,1000182,무학로16길,1084,954,130
2015,2,A,골목상권,1000181,망우로21길,188,104,84
2015,2,A,골목상권,1000180,망우로18길,521,229,292
2015,2,A,골목상권,1000179,망우로18가길,65,21,44
2015,2,A,골목상권,1000178,답십리로72길,11,9,2
2015,2,A,골목상권,1000177,답십리로69길,814,369,445
2015,2,A,골목상권,1000176,답십리로68길,171,110,61
2015,2,A,골목상권,1000175,답십리로64길,324,184,140
2015,2,A,골목상권,1000174,답십리로63길,110,73,37
2015,2,A,골목상권,1000173,답십리로60길,16,9,7
2015,2,A,골목상권,1000172,답십리로56길,8,6,2
2015,2,A,골목상권,1000171,답십리로23길,5,4,1
2015,2,A,골목상권,1000170,난계로30길,144,107,37
2015,2,A,골목상권,1000168,경희대로3길,243,151,92
2015,2,A,골목상권,1000167,천호대로129길,187,63,124
2015,2,A,골목상권,1000166,천호대로123길,353,154,199
2015,2,A,골목상권,1000165,천호대로109길,1318,779,539
2015,2,A,골목상권,1000164,자양번영로3길,79,37,42
2015,2,A,골목상권,1000162,자양로50길,18,5,13
2015,2,A,골목상권,1000161,자양로45길,563,306,257
2015,2,A,골목상권,1000160,자양로26길,312,107,205
2015,2,A,골목상권,1000159,자양로15길,320,215,105
2015,2,A,골목상권,1000158,자양로11길,1296,645,651
2015,2,A,골목상권,1000157,용마산로3길,856,481,375
2015,2,A,골목상권,1000156,용마산로21길,135,57,78
2015,2,A,골목상권,1000155,아차산로78길,1703,1049,654
2015,2,A,골목상권,1000154,아차산로65길,653,420,233
2015,2,A,골목상권,1000153,아차산로55길,515,252,263
2015,2,A,골목상권,1000152,아차산로51길,259,147,112
2015,2,A,골목상권,1000151,아차산로40길,434,248,186
2015,2,A,골목상권,1000150,면목로17길,214,139,75
2015,2,A,골목상권,1000149,뚝섬로64길,421,253,168
2015,2,A,골목상권,1000148,뚝섬로58길,180,59,121
2015,2,A,골목상권,1000147,뚝섬로54길,129,71,58
2015,2,A,골목상권,1000146,뚝섬로48길,829,379,450
2015,2,A,골목상권,1000145,뚝섬로24길,105,38,67
2015,2,A,골목상권,1000144,뚝섬로23길,95,59,36
2015,2,A,골목상권,1000143,동일로24길,8,3,5
2015,2,A,골목상권,1000142,동일로18길,152,65,87
2015,2,A,골목상권,1000141,능동로4길,224,94,130
2015,2,A,골목상권,1000140,능동로3길,205,93,112
2015,2,A,골목상권,1000139,능동로34길,892,497,395
2015,2,A,골목상권,1000138,능동로19길,345,219,126
2015,2,A,골목상권,1000137,능동로13길,297,97,200
2015,2,A,골목상권,1000136,긴고랑로9길,69,32,37
2015,2,A,골목상권,1000135,긴고랑로8길,230,204,26
2015,2,A,골목상권,1000134,긴고랑로7길,470,235,235
2015,2,A,골목상권,1000133,긴고랑로20길,516,235,281
2015,2,A,골목상권,1000132,광나루로52길,1723,844,879
2015,2,A,골목상권,1000131,광나루로40길,88,39,49
2015,2,A,골목상권,1000130,광나루로37길,313,197,116
2015,2,A,골목상권,1000129,광나루로36길,34,21,13
2015,2,A,골목상권,1000128,광나루로24길,67,33,34
2015,2,A,골목상권,1000127,광나루로12길,910,556,354
2015,2,A,골목상권,1000126,한림말길,73,46,27
2015,2,A,골목상권,1000124,청계천로10나길,1840,1074,766
2015,2,A,골목상권,1000123,장터길,42,19,23
2015,2,A,골목상권,1000122,용답중앙길,107,56,51
2015,2,A,골목상권,1000121,용답29길,1776,896,880
2015,2,A,골목상권,1000120,왕십리로6길,1314,753,561
2015,2,A,골목상권,1000119,왕십리로31길,125,60,65
2015,2,A,골목상권,1000118,왕십리로26길,3999,2182,1817
2015,2,A,골목상권,1000117,왕십리로21길,152,47,105
2015,2,A,골목상권,1000116,왕십리로14길,2213,1705,508
2015,2,A,골목상권,1000115,아차산로5길,2044,1412,632
2015,2,A,골목상권,1000114,아차산로15길,3779,2707,1072
2015,2,A,골목상권,1000113,아차산로11길,3350,2163,1187
2015,2,A,골목상권,1000112,송정4가길,966,457,509
2015,2,A,골목상권,1000111,송정12라길,232,169,63
2015,2,A,골목상권,1000110,성수일로6길,3171,1812,1359
2015,2,A,골목상권,1000109,성수이로7길,425,236,189
2015,2,A,골목상권,1000108,성수이로18길,2149,1539,610
2015,2,A,골목상권,1000107,성덕정길,603,389,214
2015,2,A,골목상권,1000106,성덕정17길,216,117,99
2015,2,A,골목상권,1000105,서울숲2길,1716,932,784
2015,2,A,골목상권,1000104,상원길,1574,1060,514
2015,2,A,골목상권,1000103,상원12길,164,96,68
2015,2,A,골목상권,1000102,사근동길,32,18,14
2015,2,A,골목상권,1000101,무학봉길,8,7,1
2015,2,A,골목상권,1000100,무학봉28길,160,72,88
2015,2,A,골목상권,1000099,무학로6길,352,207,145
2015,2,A,골목상권,1000098,무수막길,103,52,51
2015,2,A,골목상권,1000097,매봉길,30,19,11
2015,2,A,골목상권,1000096,마조로1길,166,64,102
2015,2,A,골목상권,1000095,마조로16길,774,546,228
2015,2,A,골목상권,1000094,마장로39길,55,38,17
2015,2,A,골목상권,1000093,마장로27길,105,43,62
2015,2,A,골목상권,1000091,둘레9길,413,254,159
2015,2,A,골목상권,1000090,금호산길,383,147,236
2015,2,A,골목상권,1000089,금호산2길,33,15,18
2015,2,A,골목상권,1000088,고산자로6길,15565,6418,9147
2015,2,A,골목상권,1000087,후암로28길,174,72,102
2015,2,A,골목상권,1000086,효창원로39길,50,33,17
2015,2,A,골목상권,1000085,회나무로13길,47,34,13
2015,2,A,골목상권,1000084,한남대로20길,731,436,295
2015,2,A,골목상권,1000082,한강대로7길,440,310,130
2015,2,A,골목상권,1000081,한강대로62길,690,485,205
2015,2,A,골목상권,1000080,한강대로52길,6484,2067,4417
2015,2,A,골목상권,1000079,한강대로43길,4691,3055,1636
2015,2,A,골목상권,1000078,한강대로15길,1969,419,1550
2015,2,A,골목상권,1000077,한강대로104길,4228,3115,1113
2015,2,A,골목상권,1000076,청파로73길,1377,778,599
2015,2,A,골목상권,1000075,청파로71길,245,131,114
2015,2,A,골목상권,1000074,청파로47나길,112,78,34
2015,2,A,골목상권,1000073,청파로47길,790,357,433
2015,2,A,골목상권,1000072,장문로45길,85,12,73
2015,2,A,골목상권,1000071,이태원로54길,1348,755,593
2015,2,A,골목상권,1000070,이태원로27길,510,309,201
2015,2,A,골목상권,1000069,이촌로22길,208,125,83
2015,2,A,골목상권,1000068,원효로89길,894,723,171
2015,2,A,골목상권,1000067,원효로53길,745,471,274
2015,2,A,골목상권,1000066,원효로41길,2843,2051,792
2015,2,A,골목상권,1000065,원효로19길,923,668,255
2015,2,A,골목상권,1000064,우사단로4길,156,117,39
2015,2,A,골목상권,1000063,우사단로14길,1698,945,753
2015,2,A,골목상권,1000062,우사단로10길,50,29,21
2015,2,A,골목상권,1000061,신흥로20길,183,85,98
2015,2,A,골목상권,1000060,소월로20길,138,49,89
2015,2,A,골목상권,1000059,서빙고로71길,445,266,179
2015,2,A,골목상권,1000058,백범로90길,262,155,107
2015,2,A,골목상권,1000057,백범로79길,948,575,373
2015,2,A,골목상권,1000056,두텁바위로1길,2624,1511,1113
2015,2,A,골목상권,1000055,대사관로34길,303,183,120
2015,2,A,골목상권,1000054,녹사평대로46길,14,10,4
2015,2,A,골목상권,1000053,녹사평대로40나길,29,15,14
2015,2,A,골목상권,1000052,녹사평대로32길,306,152,154
2015,2,A,골목상권,1000051,녹사평대로26길,2321,1376,945
2015,2,A,골목상권,1000050,녹사평대로11길,282,187,95
2015,2,A,골목상권,1000049,퇴계로90길,471,195,276
2015,2,A,골목상권,1000048,퇴계로8길,2475,1340,1135
2015,2,A,골목상권,1000047,퇴계로56길,914,704,210
2015,2,A,골목상권,1000046,퇴계로46길,1829,678,1151
2015,2,A,골목상권,1000045,퇴계로18길,2878,1368,1510
2015,2,A,골목상권,1000044,퇴계로12길,1097,467,630
2015,2,A,골목상권,1000043,청구로1길,198,97,101
2015,2,A,골목상권,1000042,청구로17길,1753,793,960
2015,2,A,골목상권,1000041,장충단로8길,3914,1196,2718
2015,2,A,골목상권,1000040,삼일대로4길,1377,965,412
2015,2,A,골목상권,1000039,명동길,35999,18292,17707
2015,2,A,골목상권,1000037,동호로20길,972,430,542
2015,2,A,골목상권,1000036,동호로15길,4444,2425,2019
2015,2,A,골목상권,1000035,동호로11길,12,9,3
2015,2,A,골목상권,1000034,동호로10길,4276,2298,1978
2015,2,A,골목상권,1000033,다산로39길,888,548,340
2015,2,A,골목상권,1000032,다산로38길,1303,718,585
2015,2,A,골목상권,1000031,다산로36길,49,26,23
2015,2,A,골목상권,1000030,다산로33길,378,193,185
2015,2,A,골목상권,1000029,난계로21길,195,127,68
2015,2,A,골목상권,1000028,난계로11길,1868,999,869
2015,2,A,골목상권,1000026,평창길,168,72,96
2015,2,A,골목상권,1000025,통일로12길,128,37,91
2015,2,A,골목상권,1000024,창신길,265,76,189
2015,2,A,골목상권,1000023,창신5길,7,4,3
2015,2,A,골목상권,1000022,창신2길,59,31,28
2015,2,A,골목상권,1000021,창경궁로35길,1405,392,1013
2015,2,A,골목상권,1000020,지봉로8길,146,68,78
2015,2,A,골목상권,1000019,종로65길,609,283,326
2015,2,A,골목상권,1000016,자하문로7길,493,288,205
2015,2,A,골목상권,1000015,이화장길,2046,1026,1020
2015,2,A,골목상권,1000014,율곡로16길,60,21,39
2015,2,A,골목상권,1000013,율곡로10길,2287,1687,600
2015,2,A,골목상권,1000012,옥인길,481,219,262
2015,2,A,골목상권,1000011,숭인동길,14,5,9
2015,2,A,골목상권,1000010,성균관로5길,114,69,45
2015,2,A,골목상권,1000009,삼청로5길,448,170,278
2015,2,A,골목상권,1000008,북촌로5나길,1541,1067,474
2015,2,A,골목상권,1000007,북촌로5길,49,21,28
2015,2,A,골목상권,1000006,북촌로11길,25,12,13
2015,2,A,골목상권,1000005,백석동길,88,43,45
2015,2,A,골목상권,1000004,명륜길,10,8,2
2015,2,A,골목상권,1000003,돈화문로11가길,1020,539,481
2015,2,A,골목상권,1000001,계동길,781,357,424
2015,1,U,관광특구,1001496,강남 마이스 관광특구,20221,11888,8333
2015,1,U,관광특구,1001495,잠실 관광특구,26104,15792,10312
2015,1,U,관광특구,1001494,종로?청계 관광특구,30067,19008,11059
2015,1,U,관광특구,1001493,동대문패션타운 관광특구,14192,9546,4646
2015,1,U,관광특구,1001492,명동 남대문 북창동 다동 무교동 관광특구,174074,89361,84713
2015,1,U,관광특구,1001491,이태원 관광특구,5805,3408,2397
2015,1,R,전통시장,1001490,길동복조리시장,563,341,222
2015,1,R,전통시장,1001489,둔촌역전통시장,157,79,78
2015,1,R,전통시장,1001488,성내골목시장,7,2,5
2015,1,R,전통시장,1001487,천호시장,16,9,7
2015,1,R,전통시장,1001483,암사종합시장,603,303,300
2015,1,R,전통시장,1001482,고덕전통시장,410,397,13
2015,1,R,전통시장,1001481,명일골목시장,123,68,55
2015,1,R,전통시장,1001480,새마을시장,289,154,135
2015,1,R,전통시장,1001479,석촌시장,185,127,58
2015,1,R,전통시장,1001478,방이시장,623,411,212
2015,1,R,전통시장,1001477,마천시장,249,63,186
2015,1,R,전통시장,1001476,풍납시장,11,2,9
2015,1,R,전통시장,1001475,강남개포시장,42,35,7
2015,1,R,전통시장,1001474,도곡시장,499,248,251
2015,1,R,전통시장,1001471,영동전통시장,3105,2313,792
2015,1,R,전통시장,1001466,미성동도깨비시장,393,167,226
2015,1,R,전통시장,1001464,삼성동시장,90,37,53
2015,1,R,전통시장,1001463,신림중앙시장,15,10,5
2015,1,R,전통시장,1001462,강남골목시장,367,178,189
2015,1,R,전통시장,1001460,관악신사시장,317,247,70
2015,1,R,전통시장,1001459,신원시장,338,144,194
2015,1,R,전통시장,1001458,인헌시장,215,71,144
2015,1,R,전통시장,1001456,봉천현대시장,11,6,5
2015,1,R,전통시장,1001454,봉천제일종합시장,41,21,20
2015,1,R,전통시장,1001453,낙성대시장,18,11,7
2015,1,R,전통시장,1001452,중부시장,154,47,107
2015,1,R,전통시장,1001450,남성역골목시장,456,217,239
2015,1,R,전통시장,1001449,남성사계시장,1977,883,1094
2015,1,R,전통시장,1001448,흑석시장,154,50,104
2015,1,R,전통시장,1001447,상도4동도깨비골목시장,327,90,237
2015,1,R,전통시장,1001445,영도시장,101,43,58
2015,1,R,전통시장,1001441,본동인정시장,124,65,59
2015,1,R,전통시장,1001439,대림중앙시장,22,16,6
2015,1,R,전통시장,1001438,우리시장,16,5,11
2015,1,R,전통시장,1001437,영진시장A동,40,32,8
2015,1,R,전통시장,1001433,영일시장,7,5,2
2015,1,R,전통시장,1001431,영등포청과시장,166,102,64
2015,1,R,전통시장,1001430,영등포전통시장,4014,2014,2000
2015,1,R,전통시장,1001429,은행나무시장,40,10,30
2015,1,R,전통시장,1001427,현대시장,57,14,43
2015,1,R,전통시장,1001424,남문시장,273,118,155
2015,1,R,전통시장,1001423,독산동 우시장,131,55,76
2015,1,R,전통시장,1001421,개봉중앙시장,7,4,3
2015,1,R,전통시장,1001419,가리봉시장,15,9,6
2015,1,R,전통시장,1001418,남구로시장,6,4,2
2015,1,R,전통시장,1001417,구로시장,55,28,27
2015,1,R,전통시장,1001415,방신전통시장,157,129,28
2015,1,R,전통시장,1001414,송화골목시장,486,169,317
2015,1,R,전통시장,1001413,까치산시장,26,16,10
2015,1,R,전통시장,1001411,남부골목시장,167,71,96
2015,1,R,전통시장,1001409,화곡중앙골목시장,2,2,0
2015,1,R,전통시장,1001407,등마루시장,804,522,282
2015,1,R,전통시장,1001406,신정3동골목시장,242,102,140
2015,1,R,전통시장,1001405,신정2동골목시장,8,5,3
2015,1,R,전통시장,1001402,신월6동골목시장,251,110,141
2015,1,R,전통시장,1001401,신곡종합시장,18,9,9
2015,1,R,전통시장,1001400,신월3동골목시장,44,12,32
2015,1,R,전통시장,1001399,경창시장,201,105,96
2015,1,R,전통시장,1001398,월정로시장,96,54,42
2015,1,R,전통시장,1001397,신영시장,41,18,23
2015,1,R,전통시장,1001396,목4동시장,237,72,165
2015,1,R,전통시장,1001395,목3동시장,591,258,333
2015,1,R,전통시장,1001394,목2동시장,173,84,89
2015,1,R,전통시장,1001393,마포농수산물시장,492,315,177
2015,1,R,전통시장,1001391,망원월드컵시장,15,9,6
2015,1,R,전통시장,1001390,망원시장,38,20,18
2015,1,R,전통시장,1001386,신수시장,214,135,79
2015,1,R,전통시장,1001385,아현시장,46,27,19
2015,1,R,전통시장,1001374,대림골목시장,278,85,193
2015,1,R,전통시장,1001367,상계중앙시장,32,19,13
2015,1,R,전통시장,1001364,방학동도깨비시장,125,57,68
2015,1,R,전통시장,1001363,쌍문역골목시장,49,23,26
2015,1,R,전통시장,1001361,신도봉시장,14,6,8
2015,1,R,전통시장,1001359,창동신창시장,112,38,74
2015,1,R,전통시장,1001357,장미원골목시장,55,35,20
2015,1,R,전통시장,1001356,수유중앙시장,145,85,60
2015,1,R,전통시장,1001355,강북종합시장,52,20,32
2015,1,R,전통시장,1001354,우이시장,145,68,77
2015,1,R,전통시장,1001353,수유전통시장,460,155,305
2015,1,R,전통시장,1001352,번동북부골목시장,86,53,33
2015,1,R,전통시장,1001351,솔샘시장,92,35,57
2015,1,R,전통시장,1001349,방천골목시장,76,27,49
2015,1,R,전통시장,1001347,석관황금시장,44,21,23
2015,1,R,전통시장,1001343,장위전통시장,195,71,124
2015,1,R,전통시장,1001340,정릉시장,36,16,20
2015,1,R,전통시장,1001339,정릉아리랑시장,7,4,3
2015,1,R,전통시장,1001338,돈암제일시장,73,46,27
2015,1,R,전통시장,1001336,우림골목시장,233,113,120
2015,1,R,전통시장,1001335,묵1동도깨비시장,263,95,168
2015,1,R,전통시장,1001334,태능시장,3,1,2
2015,1,R,전통시장,1001333,중화제일시장,21,0,21
2015,1,R,전통시장,1001332,사가정시장,251,198,53
2015,1,R,전통시장,1001330,동원시장,41,15,26
2015,1,R,전통시장,1001329,동부골목시장,79,32,47
2015,1,R,전통시장,1001326,회기시장,135,45,90
2015,1,R,전통시장,1001323,답십리시장,21,11,10
2015,1,R,전통시장,1001321,답십리현대시장,97,72,25
2015,1,R,전통시장,1001319,청량리종합시장,8,6,2
2015,1,R,전통시장,1001317,청량리농수산물시장,13,11,2
2015,1,R,전통시장,1001316,서울약령시장,1328,865,463
2015,1,R,전통시장,1001313,청량리수산시장,157,81,76
2015,1,R,전통시장,1001310,구의시장,87,50,37
2015,1,R,전통시장,1001309,조양시장,70,43,27
2015,1,R,전통시장,1001308,영동교골목시장,24,15,9
2015,1,R,전통시장,1001307,능동로골목시장,272,253,19
2015,1,R,전통시장,1001304,자양골목시장,83,40,43
2015,1,R,전통시장,1001301,중곡제일시장,126,65,61
2015,1,R,전통시장,1001299,한아름시장,86,47,39
2015,1,R,전통시장,1001298,성동용답상가시장,234,119,115
2015,1,R,전통시장,1001297,뚝도시장,28,8,20
2015,1,R,전통시장,1001296,금남시장,15,12,3
2015,1,R,전통시장,1001295,행당시장,211,107,104
2015,1,R,전통시장,1001294,마장축산물시장,1491,1028,463
2015,1,R,전통시장,1001289,용문전통시장,26,17,9
2015,1,R,전통시장,1001286,후암시장,28,11,17
2015,1,R,전통시장,1001285,합동(새벽)시장,2372,1217,1155
2015,1,R,전통시장,1001284,서울중앙시장,248,175,73
2015,1,R,전통시장,1001283,백학시장,474,257,217
2015,1,R,전통시장,1001282,약수시장,1462,560,902
2015,1,R,전통시장,1001281,청평화시장,2428,1662,766
2015,1,R,전통시장,1001280,제일평화시장,451,284,167
2015,1,R,전통시장,1001278,남평화시장,152,101,51
2015,1,R,전통시장,1001277,방산종합시장,1695,1130,565
2015,1,R,전통시장,1001275,인현시장,1172,766,406
2015,1,R,전통시장,1001274,신중부시장,2487,1681,806
2015,1,R,전통시장,1001273,남대문시장,7015,3772,3243
2015,1,R,전통시장,1001271,동묘시장,913,559,354
2015,1,R,전통시장,1001270,창신골목시장,216,124,92
2015,1,R,전통시장,1001268,충신시장,319,170,149
2015,1,R,전통시장,1001267,종로신진시장,21,10,11
2015,1,R,전통시장,1001266,동대문종합시장,245,155,90
2015,1,R,전통시장,1001265,광장시장,209,142,67
2015,1,D,발달상권,1001263,서울 노원구 노원역_3,669,268,401
2015,1,D,발달상권,1001261,서울 노원구 노원역_1,945,276,669
2015,1,D,발달상권,1001260,창동역,2238,1450,788
2015,1,D,발달상권,1001259,서울 강북구 수유역_3,51,28,23
2015,1,D,발달상권,1001257,서울 강북구 수유역_2,3961,2065,1896
2015,1,D,발달상권,1001256,서울 강북구 수유역_1,71,54,17
2015,1,D,발달상권,1001255,서울 은평구 연신내역_3,550,174,376
2015,1,D,발달상권,1001254,서울 은평구 연신내역_2,310,135,175
2015,1,D,발달상권,1001253,서울 은평구 연신내역_1,47,23,24
2015,1,D,발달상권,1001252,서울 성북구 미아삼거리역_2,521,254,267
2015,1,D,발달상권,1001251,서울 강북구 미아삼거리역_1,441,158,283
2015,1,D,발달상권,1001250,서울 은평구 불광역_3,51,19,32
2015,1,D,발달상권,1001249,서울 은평구 불광역_2,69,28,41
2015,1,D,발달상권,1001248,서울 은평구 불광역_1,234,96,138
2015,1,D,발달상권,1001247,미아사거리_2,129,78,51
2015,1,D,발달상권,1001246,미아사거리_1,512,209,303
2015,1,D,발달상권,1001245,서울 성북구 성신여대입구역,4819,3026,1793
2015,1,D,발달상권,1001244,경희대학교,310,144,166
2015,1,D,발달상권,1001243,서울 성북구 안암역,78,43,35
2015,1,D,발달상권,1001242,혜화역 대학로_3,10249,3185,7064
2015,1,D,발달상권,1001241,혜화역 대학로_2,1386,817,569
2015,1,D,발달상권,1001240,혜화역 대학로_1,1082,582,500
2015,1,D,발달상권,1001239,디지털미디어시티,15592,10551,5041
2015,1,D,발달상권,1001238,서울 동대문구 청량리역,3263,2127,1136
2015,1,D,발달상권,1001236,서울 종로구 안국역_2,752,303,449
2015,1,D,발달상권,1001235,서울 종로구 안국역_1,11962,9905,2057
2015,1,D,발달상권,1001234,서울 종로구 경복궁역_1,214,90,124
2015,1,D,발달상권,1001233,서울 종로구 종로3가역_3,2958,1684,1274
2015,1,D,발달상권,1001232,서울 종로구 종로3가역_2,1916,1042,874
2015,1,D,발달상권,1001231,서울 동대문구 신설동역_2,4043,2102,1941
2015,1,D,발달상권,1001230,인사동,22204,14049,8155
2015,1,D,발달상권,1001229,서울 종로구 종로5가역_4,644,348,296
2015,1,D,발달상권,1001228,서울 종로구 종로5가역_3,5223,3557,1666
2015,1,D,발달상권,1001227,종로구청,15214,9123,6091
2015,1,D,발달상권,1001226,서울 종로구 종로5가역_2,14629,9310,5319
2015,1,D,발달상권,1001225,신설동역,685,426,259
2015,1,D,발달상권,1001224,서울 동대문구 신설동역_1,2,2,0
2015,1,D,발달상권,1001223,서울 종로구 광화문역_2,51504,32594,18910
2015,1,D,발달상권,1001222,동묘앞역,59,40,19
2015,1,D,발달상권,1001221,장안동사거리,502,259,243
2015,1,D,발달상권,1001220,서울 종로구 동대문역_2,820,499,321
2015,1,D,발달상권,1001218,동대문시장_2,486,313,173
2015,1,D,발달상권,1001217,서울 종로구 종로5가역_1,50,34,16
2015,1,D,발달상권,1001216,서울 종로구 종로3가역_1,3399,1515,1884
2015,1,D,발달상권,1001215,서울 종로구 광화문역_1,2592,1821,771
2015,1,D,발달상권,1001214,종각역,20899,13920,6979
2015,1,D,발달상권,1001213,종각역 젊음의 거리,1784,905,879
2015,1,D,발달상권,1001212,서대문구 서대문역_1,2610,858,1752
2015,1,D,발달상권,1001211,동대문시장_1,464,241,223
2015,1,D,발달상권,1001210,시청역_2,24728,15662,9066
2015,1,D,발달상권,1001209,서울시청,27317,12857,14460
2015,1,D,발달상권,1001208,서울 중구 을지로3가역_2,8607,5557,3050
2015,1,D,발달상권,1001207,서울 중구 신당역_2,1141,609,532
2015,1,D,발달상권,1001206,서대문구 서대문역_2,2129,1463,666
2015,1,D,발달상권,1001205,동대문역사문화공원역,4423,2822,1601
2015,1,D,발달상권,1001204,서울 중구 을지로3가역_1,14987,10348,4639
2015,1,D,발달상권,1001203,명동거리,17364,8956,8408
2015,1,D,발달상권,1001202,롯데백화점,56472,30865,25607
2015,1,D,발달상권,1001201,서울 중구 신당역_1,1092,713,379
2015,1,D,발달상권,1001200,북창동,7491,4768,2723
2015,1,D,발달상권,1001199,서울 중구 충무로역_2,16622,7546,9076
2015,1,D,발달상권,1001198,서울 강서구 송정역,641,452,189
2015,1,D,발달상권,1001197,장한평역_2,12566,10118,2448
2015,1,D,발달상권,1001196,시청역_1,60507,36373,24134
2015,1,D,발달상권,1001195,왕십리역_2,807,411,396
2015,1,D,발달상권,1001194,서울 강서구 발산역,693,463,230
2015,1,D,발달상권,1001193,장한평역_1,2557,1712,845
2015,1,D,발달상권,1001192,서울 중구 충무로역_1,3077,2068,1009
2015,1,D,발달상권,1001190,장한평역,2166,1471,695
2015,1,D,발달상권,1001189,서울 중구 명동역,2870,1326,1544
2015,1,D,발달상권,1001188,장충동 족발거리,203,94,109
2015,1,D,발달상권,1001187,한양시장,218,114,104
2015,1,D,발달상권,1001186,서울 서대문구 이대역,1261,502,759
2015,1,D,발달상권,1001185,서울 서대문구 신촌역,2544,1056,1488
2015,1,D,발달상권,1001184,서울 마포구 홍대입구역_3,956,728,228
2015,1,D,발달상권,1001183,서울 마포구 홍대입구역_2,2859,1333,1526
2015,1,D,발달상권,1001182,홍익대학교 주변,16634,8220,8414
2015,1,D,발달상권,1001181,서울 광진구 군자역,163,101,62
2015,1,D,발달상권,1001180,신촌역,249,133,116
2015,1,D,발달상권,1001179,강서구청,3549,2461,1088
2015,1,D,발달상권,1001178,서울 마포구 홍대입구역_1,755,445,310
2015,1,D,발달상권,1001175,서울 강동구 고덕역,471,273,198
2015,1,D,발달상권,1001173,서울 강동구 명일역,911,368,543
2015,1,D,발달상권,1001172,어린이대공원역,99,63,36
2015,1,D,발달상권,1001171,서울 마포구 공덕역_2,4024,2429,1595
2015,1,D,발달상권,1001170,공덕역,6018,3923,2095
2015,1,D,발달상권,1001169,서울 용산구 숙대입구역,4037,2855,1182
2015,1,D,발달상권,1001168,남영역,14742,6874,7868
2015,1,D,발달상권,1001167,서울 마포구 공덕역_1,4110,2028,2082
2015,1,D,발달상권,1001166,서울 마포구 마포역_2,1027,598,429
2015,1,D,발달상권,1001165,서울 광진구 건대입구역_2,2593,911,1682
2015,1,D,발달상권,1001164,서울 마포구 마포역_1,9995,6304,3691
2015,1,D,발달상권,1001163,서울 강동구 천호역_2,3592,1765,1827
2015,1,D,발달상권,1001162,서울 광진구 건대입구역_1,929,476,453
2015,1,D,발달상권,1001161,건대입구역,761,426,335
2015,1,D,발달상권,1001160,서울 광진구 구의역,1239,796,443
2015,1,D,발달상권,1001159,서울 강동구 천호역,915,422,493
2015,1,D,발달상권,1001158,당산역_2,5156,3143,2013
2015,1,D,발달상권,1001156,서울 강동구 길동역,1753,1089,664
2015,1,D,발달상권,1001155,용산 전자상가_5,2148,1643,505
2015,1,D,발달상권,1001153,당산역_1,1185,764,421
2015,1,D,발달상권,1001152,서울 광진구 강변역,2105,1732,373
2015,1,D,발달상권,1001151,용산 전자상가_3,2545,1898,647
2015,1,D,발달상권,1001150,서울 용산구 이태원역,815,485,330
2015,1,D,발달상권,1001149,한남오거리,622,345,277
2015,1,D,발달상권,1001147,용산 전자상가_2,434,351,83
2015,1,D,발달상권,1001146,용산구청,66,37,29
2015,1,D,발달상권,1001145,용산 전자상가_1,8579,6561,2018
2015,1,D,발달상권,1001144,국회의사당역_2,38680,21694,16986
2015,1,D,발달상권,1001143,서울 용산구 신용산역,301,120,181
2015,1,D,발달상권,1001142,국회의사당역_1,5636,4401,1235
2015,1,D,발달상권,1001141,압구정 로데오거리_2,13442,5633,7809
2015,1,D,발달상권,1001140,서울 강남구 압구정역,9601,4532,5069
2015,1,D,발달상권,1001139,서울 영등포구 영등포구청역,4439,1339,3100
2015,1,D,발달상권,1001138,압구정 로데오거리_1,7547,2409,5138
2015,1,D,발달상권,1001137,서울 강동구 둔촌동역,70,31,39
2015,1,D,발달상권,1001136,오목교역,246,127,119
2015,1,D,발달상권,1001135,신사동 가로수길,20872,9829,11043
2015,1,D,발달상권,1001134,서울 영등포구 여의도역_2,44703,29872,14831
2015,1,D,발달상권,1001133,청담사거리_3,1298,428,870
2015,1,D,발달상권,1001132,영등포유통상가,1762,1213,549
2015,1,D,발달상권,1001131,청담역_2,1739,1351,388
2015,1,D,발달상권,1001130,청담역_1,190,152,38
2015,1,D,발달상권,1001129,청담사거리_2,1035,827,208
2015,1,D,발달상권,1001127,서울 영등포구 여의도역_1,53647,32572,21075
2015,1,D,발달상권,1001125,학동사거리_2,2787,1631,1156
2015,1,D,발달상권,1001124,서울 영등포구 영등포시장역,350,288,62
2015,1,D,발달상권,1001123,학동사거리_1,3989,2068,1921
2015,1,D,발달상권,1001122,여의도 시범아파트앞,2382,1586,796
2015,1,D,발달상권,1001121,영등포역_3,819,500,319
2015,1,D,발달상권,1001120,도산공원사거리_1,10547,6716,3831
2015,1,D,발달상권,1001119,영등포역_2,1092,630,462
2015,1,D,발달상권,1001118,문래동 주민센터,65,54,11
2015,1,D,발달상권,1001117,강남구 신사역_2,7392,5035,2357
2015,1,D,발달상권,1001115,서울 강남구 강남구청역_2,3847,2363,1484
2015,1,D,발달상권,1001114,강남구 신사역_1,2577,1169,1408
2015,1,D,발달상권,1001113,서울 동작구 노량진1동_1,96,42,54
2015,1,D,발달상권,1001112,서울 강남구 학동역_3,7941,4662,3279
2015,1,D,발달상권,1001111,서울 강남구 강남구청역_1,2799,1689,1110
2015,1,D,발달상권,1001110,잠실역,5399,4272,1127
2015,1,D,발달상권,1001109,강남구 논현역_4,8259,3792,4467
2015,1,D,발달상권,1001108,학동역,863,428,435
2015,1,D,발달상권,1001107,방이동 먹자골목,5740,3905,1835
2015,1,D,발달상권,1001106,서울 강남구 학동역_2,5745,2787,2958
2015,1,D,발달상권,1001105,서울 동작구 노량진역,3479,2056,1423
2015,1,D,발달상권,1001104,삼성역_3,8612,4738,3874
2015,1,D,발달상권,1001103,코엑스,20221,11888,8333
2015,1,D,발달상권,1001102,서울 강남구 학동역_1,5812,3565,2247
2015,1,D,발달상권,1001101,선정릉역_2,6176,3798,2378
2015,1,D,발달상권,1001100,강남구 논현역_3,1563,846,717
2015,1,D,발달상권,1001099,포스코사거리_2,7764,4758,3006
2015,1,D,발달상권,1001098,포스코사거리_1,49635,33021,16614
2015,1,D,발달상권,1001097,잠실역 롯데월드,3123,1518,1605
2015,1,D,발달상권,1001096,신도림역,3750,2007,1743
2015,1,D,발달상권,1001095,강남구 논현역_2,7683,3579,4104
2015,1,D,발달상권,1001094,선정릉역_1,1391,949,442
2015,1,D,발달상권,1001093,신천역,5826,3236,2590
2015,1,D,발달상권,1001092,강남구 논현역_1,3020,1941,1079
2015,1,D,발달상권,1001091,삼성역_2,18025,10706,7319
2015,1,D,발달상권,1001090,삼정역_2,2549,1137,1412
2015,1,D,발달상권,1001089,삼정역_1,3053,1666,1387
2015,1,D,발달상권,1001088,삼성역_1,27273,17706,9567
2015,1,D,발달상권,1001087,서울 강남구 선릉역_2,6715,4258,2457
2015,1,D,발달상권,1001086,고속터미널역,14888,4711,10177
2015,1,D,발달상권,1001085,서울 서초구 강남역,31691,17992,13699
2015,1,D,발달상권,1001084,서울 강남구 선릉역_1,19913,9118,10795
2015,1,D,발달상권,1001082,선릉역_2,20075,10943,9132
2015,1,D,발달상권,1001081,서울 강남구 역삼역_2,26587,21017,5570
2015,1,D,발달상권,1001080,서울 송파구 석촌역_1,39,26,13
2015,1,D,발달상권,1001078,서울 강남구 강남역_2,6501,4134,2367
2015,1,D,발달상권,1001077,선릉역_1,55794,29104,26690
2015,1,D,발달상권,1001076,구로역,159,90,69
2015,1,D,발달상권,1001075,역삼역_2,4222,2356,1866
2015,1,D,발달상권,1001074,대림역_2,6710,5211,1499
2015,1,D,발달상권,1001073,서울 강남구 역삼역_1,25306,15913,9393
2015,1,D,발달상권,1001072,신대방삼거리역,281,158,123
2015,1,D,발달상권,1001071,서울 강남구 한티역,1228,472,756
2015,1,D,발달상권,1001070,은마아파트입구사거리_4,64,36,28
2015,1,D,발달상권,1001067,오류동역,1287,695,592
2015,1,D,발달상권,1001066,서울 강남구 강남역,39828,18763,21065
2015,1,D,발달상권,1001063,교대역_4,4449,2599,1850
2015,1,D,발달상권,1001062,서울 강남구 강남역_1,137569,100157,37412
2015,1,D,발달상권,1001061,방배동카페골목,94,37,57
2015,1,D,발달상권,1001060,가락시장,15202,9877,5325
2015,1,D,발달상권,1001059,교대역_3,4476,2802,1674
2015,1,D,발달상권,1001058,역삼역_1,1643,923,720
2015,1,D,발달상권,1001057,교대역_2,3170,2031,1139
2015,1,D,발달상권,1001056,서울 송파구 가락시장역,5173,3309,1864
2015,1,D,발달상권,1001055,서울 서초구 서초역,11116,4771,6345
2015,1,D,발달상권,1001054,서울 강남구 대치역_2,1317,835,482
2015,1,D,발달상권,1001052,뱅뱅사거리_2,24958,15499,9459
2015,1,D,발달상권,1001051,보라매공원,14400,8379,6021
2015,1,D,발달상권,1001050,교대역_1,13457,7785,5672
2015,1,D,발달상권,1001049,개봉동 현대아파트 인근,166,86,80
2015,1,D,발달상권,1001048,뱅뱅사거리,10173,7139,3034
2015,1,D,발달상권,1001047,뱅뱅사거리_1,9338,6677,2661
2015,1,D,발달상권,1001046,서울 관악구 신림역_4,855,429,426
2015,1,D,발달상권,1001045,동작구 총신대입구역_1,245,128,117
2015,1,D,발달상권,1001044,양재역_3,3267,2264,1003
2015,1,D,발달상권,1001043,동작구 총신대입구역_2,1129,580,549
2015,1,D,발달상권,1001042,서울 서초구 남부터미널역_3,1667,1003,664
2015,1,D,발달상권,1001041,서울 강남구 수서역,18539,10863,7676
2015,1,D,발달상권,1001039,서울 서초구 남부터미널역_2,9872,5113,4759
2015,1,D,발달상권,1001038,구로디지탈1단지,64034,42207,21827
2015,1,D,발달상권,1001037,양재역,138,74,64
2015,1,D,발달상권,1001035,매봉역,298,153,145
2015,1,D,발달상권,1001034,서울 서초구 방배역,4018,2386,1632
2015,1,D,발달상권,1001033,서울 서초구 남부터미널역_1,692,488,204
2015,1,D,발달상권,1001032,서울 관악구 신림역_2,27,13,14
2015,1,D,발달상권,1001031,서울 관악구 신림역_1,1715,822,893
2015,1,D,발달상권,1001030,양재역_2,8352,4652,3700
2015,1,D,발달상권,1001029,양재역_1,859,580,279
2015,1,D,발달상권,1001028,서울 관악구 서울대입구역_2,40,3,37
2015,1,D,발달상권,1001027,가산디지털단지역_3,28758,17451,11307
2015,1,D,발달상권,1001026,구로디지털단지역,2625,1781,844
2015,1,D,발달상권,1001025,서울 관악구 서울대입구역_1,1854,820,1034
2015,1,D,발달상권,1001024,관악구 사당역_1,3768,1635,2133
2015,1,D,발달상권,1001023,가산디지털단지역_2,56775,34252,22523
2015,1,D,발달상권,1001022,관악구 사당역_2,413,201,212
2015,1,D,발달상권,1001021,가산디지털단지역_1,24703,16670,8033
2015,1,D,발달상권,1001020,장지역,3724,2353,1371
2015,1,D,발달상권,1001019,포이사거리_1,5713,3053,2660
2015,1,D,발달상권,1001018,포이사거리_2,7681,5038,2643
2015,1,D,발달상권,1001016,서울 관악구 대학동_1,72,45,27
2015,1,D,발달상권,1001015,서울 금천구 독산1동_1,2638,1920,718
2015,1,D,발달상권,1001013,양재 화물트럭터미널앞_2,204,93,111
2015,1,D,발달상권,1001012,양재 화물트럭터미널앞_1,4406,3418,988
2015,1,D,발달상권,1001011,서울 금천구 시흥1동_4,914,459,455
2015,1,A,골목상권,1001010,풍성로37가길,38,18,20
2015,1,A,골목상권,1001009,천호옛길,559,390,169
2015,1,A,골목상권,1001008,천호옛14길,597,290,307
2015,1,A,골목상권,1001007,천호대로219길,872,513,359
2015,1,A,골목상권,1001006,천호대로197길,22,8,14
2015,1,A,골목상권,1001005,천호대로187길,781,480,301
2015,1,A,골목상권,1001004,천호대로170길,385,151,234
2015,1,A,골목상권,1001003,천호대로162길,913,660,253
2015,1,A,골목상권,1001002,천중로51길,393,213,180
2015,1,A,골목상권,1001001,천중로39길,642,238,404
2015,1,A,골목상권,1001000,진황도로47길,1090,585,505
2015,1,A,골목상권,1000999,진황도로27길,400,237,163
2015,1,A,골목상권,1000998,올림픽로98길,34,17,17
2015,1,A,골목상권,1000995,올림픽로77길,8,4,4
2015,1,A,골목상권,1000994,올림픽로71길,235,164,71
2015,1,A,골목상권,1000993,올림픽로48길,5558,3416,2142
2015,1,A,골목상권,1000992,양재대로96길,1325,794,531
2015,1,A,골목상권,1000991,양재대로95길,593,327,266
2015,1,A,골목상권,1000990,양재대로91길,1017,554,463
2015,1,A,골목상권,1000989,양재대로133길,257,100,157
2015,1,A,골목상권,1000988,양재대로124길,554,342,212
2015,1,A,골목상권,1000987,양재대로116길,196,84,112
2015,1,A,골목상권,1000986,양재대로101길,1294,750,544
2015,1,A,골목상권,1000985,암사길,361,153,208
2015,1,A,골목상권,1000984,성안로3길,1308,768,540
2015,1,A,골목상권,1000983,성내로5길,952,526,426
2015,1,A,골목상권,1000982,상일로5길,40,24,16
2015,1,A,골목상권,1000981,상암로5길,451,215,236
2015,1,A,골목상권,1000980,상암로51길,704,310,394
2015,1,A,골목상권,1000979,상암로4길,207,163,44
2015,1,A,골목상권,1000978,상암로14길,397,233,164
2015,1,A,골목상권,1000977,명일로13길,120,54,66
2015,1,A,골목상권,1000976,동남로85길,131,72,59
2015,1,A,골목상권,1000975,동남로82길,9,4,5
2015,1,A,골목상권,1000974,동남로65길,85,30,55
2015,1,A,골목상권,1000973,구천면로42길,359,176,183
2015,1,A,골목상권,1000972,구천면로41길,577,252,325
2015,1,A,골목상권,1000971,구천면로36길,36,19,17
2015,1,A,골목상권,1000969,고덕로25길,4,2,2
2015,1,A,골목상권,1000968,고덕로10길,152,73,79
2015,1,A,골목상권,1000967,강동대로53길,805,455,350
2015,1,A,골목상권,1000966,풍성로25길,1034,390,644
2015,1,A,골목상권,1000965,오금로46길,1372,708,664
2015,1,A,골목상권,1000964,오금로36길,1626,1297,329
2015,1,A,골목상권,1000963,오금로11길,2355,1556,799
2015,1,A,골목상권,1000962,양재대로72길,626,343,283
2015,1,A,골목상권,1000961,양재대로71길,1049,657,392
2015,1,A,골목상권,1000960,양재대로64길,1543,651,892
2015,1,A,골목상권,1000959,양재대로62길,5347,3258,2089
2015,1,A,골목상권,1000958,송파대로30길,1618,1041,577
2015,1,A,골목상권,1000957,송이로36길,1928,1398,530
2015,1,A,골목상권,1000956,송이로32길,747,412,335
2015,1,A,골목상권,1000955,송이로23길,1756,991,765
2015,1,A,골목상권,1000954,삼전로13길,1693,1007,686
2015,1,A,골목상권,1000953,백제고분로50길,3318,1625,1693
2015,1,A,골목상권,1000952,백제고분로46길,1576,1014,562
2015,1,A,골목상권,1000951,백제고분로45길,467,316,151
2015,1,A,골목상권,1000950,백제고분로42길,214,163,51
2015,1,A,골목상권,1000949,백제고분로39길,1211,918,293
2015,1,A,골목상권,1000948,백제고분로34길,1572,1031,541
2015,1,A,골목상권,1000947,백제고분로33길,807,500,307
2015,1,A,골목상권,1000946,백제고분로32길,1061,473,588
2015,1,A,골목상권,1000945,백제고분로31길,298,192,106
2015,1,A,골목상권,1000944,백제고분로22길,1071,628,443
2015,1,A,골목상권,1000943,백제고분로21길,200,137,63
2015,1,A,골목상권,1000942,마천로51길,119,46,73
2015,1,A,골목상권,1000941,동남로20길,173,95,78
2015,1,A,골목상권,1000940,거마로20길,361,162,199
2015,1,A,골목상권,1000939,학동로77길,2908,1547,1361
2015,1,A,골목상권,1000938,학동로6길,1950,1056,894
2015,1,A,골목상권,1000937,학동로56길,979,599,380
2015,1,A,골목상권,1000936,학동로38길,6847,4556,2291
2015,1,A,골목상권,1000935,테헤란로81길,556,131,425
2015,1,A,골목상권,1000934,일원로9길,491,265,226
2015,1,A,골목상권,1000933,일원로3길,228,103,125
2015,1,A,골목상권,1000932,영동대로65길,2938,1785,1153
2015,1,A,골목상권,1000931,영동대로112길,648,464,184
2015,1,A,골목상권,1000930,언주로81길,8337,3850,4487
2015,1,A,골목상권,1000929,압구정로2길,2863,1599,1264
2015,1,A,골목상권,1000928,선릉로18길,512,311,201
2015,1,A,골목상권,1000927,선릉로146길,1771,962,809
2015,1,A,골목상권,1000926,선릉로133길,150,80,70
2015,1,A,골목상권,1000925,선릉로132길,964,506,458
2015,1,A,골목상권,1000924,선릉로121길,2002,1048,954
2015,1,A,골목상권,1000923,삼성로75길,2581,1382,1199
2015,1,A,골목상권,1000922,삼성로69길,261,139,122
2015,1,A,골목상권,1000921,삼성로64길,563,300,263
2015,1,A,골목상권,1000920,삼성로63길,157,80,77
2015,1,A,골목상권,1000919,삼성로57길,892,286,606
2015,1,A,골목상권,1000918,삼성로147길,973,413,560
2015,1,A,골목상권,1000917,삼성로115길,323,200,123
2015,1,A,골목상권,1000916,봉은사로68길,205,98,107
2015,1,A,골목상권,1000915,봉은사로57길,570,399,171
2015,1,A,골목상권,1000914,봉은사로43길,980,607,373
2015,1,A,골목상권,1000913,봉은사로29길,152,106,46
2015,1,A,골목상권,1000912,봉은사로109길,296,173,123
2015,1,A,골목상권,1000911,도산대로89길,2362,959,1403
2015,1,A,골목상권,1000910,도산대로81길,4366,1461,2905
2015,1,A,골목상권,1000909,도산대로50길,2784,2120,664
2015,1,A,골목상권,1000908,도산대로38길,183,104,79
2015,1,A,골목상권,1000907,도산대로30길,2890,1395,1495
2015,1,A,골목상권,1000906,도산대로23길,1211,743,468
2015,1,A,골목상권,1000905,도산대로15길,1941,931,1010
2015,1,A,골목상권,1000904,도곡로37길,3222,2145,1077
2015,1,A,골목상권,1000903,논현로8길,766,411,355
2015,1,A,골목상권,1000902,논현로63길,9193,2592,6601
2015,1,A,골목상권,1000901,논현로28길,12605,9231,3374
2015,1,A,골목상권,1000900,논현로26길,6233,3911,2322
2015,1,A,골목상권,1000898,논현로139길,1814,1058,756
2015,1,A,골목상권,1000897,논현로123길,104,62,42
2015,1,A,골목상권,1000896,논현로115길,3447,2020,1427
2015,1,A,골목상권,1000895,논현로10길,2254,1448,806
2015,1,A,골목상권,1000894,논현로106길,2940,1582,1358
2015,1,A,골목상권,1000893,남부순환로365길,198,151,47
2015,1,A,골목상권,1000891,개포로28길,315,234,81
2015,1,A,골목상권,1000890,개포로20길,4241,2386,1855
2015,1,A,골목상권,1000889,개포로17길,3350,2000,1350
2015,1,A,골목상권,1000888,강남대로140길,4115,2275,1840
2015,1,A,골목상권,1000887,강남대로136길,1242,729,513
2015,1,A,골목상권,1000886,강남대로118길,591,332,259
2015,1,A,골목상권,1000885,서초중앙로8길,5997,4563,1434
2015,1,A,골목상권,1000884,방배중앙로21길,2083,800,1283
2015,1,A,골목상권,1000883,효령로72길,188,108,80
2015,1,A,골목상권,1000882,효령로34길,73,26,47
2015,1,A,골목상권,1000881,효령로31길,1345,842,503
2015,1,A,골목상권,1000880,효령로23길,678,426,252
2015,1,A,골목상권,1000879,청두곶길,2049,1471,578
2015,1,A,골목상권,1000878,주흥길,348,227,121
2015,1,A,골목상권,1000877,주흥15길,1484,960,524
2015,1,A,골목상권,1000876,언남길,1943,1442,501
2015,1,A,골목상권,1000875,신반포로45길,427,276,151
2015,1,A,골목상권,1000874,서초대로8길,253,168,85
2015,1,A,골목상권,1000873,서초대로64길,508,348,160
2015,1,A,골목상권,1000872,서초대로4길,809,582,227
2015,1,A,골목상권,1000871,서초대로25길,3646,2252,1394
2015,1,A,골목상권,1000870,서초대로23길,989,499,490
2015,1,A,골목상권,1000869,서초대로15길,1085,499,586
2015,1,A,골목상권,1000868,사평대로57길,201,87,114
2015,1,A,골목상권,1000867,사평대로26길,15,10,5
2015,1,A,골목상권,1000866,사평대로22길,1239,691,548
2015,1,A,골목상권,1000865,사임당로17길,1513,983,530
2015,1,A,골목상권,1000864,방배로42길,206,105,101
2015,1,A,골목상권,1000863,방배로35길,2186,1410,776
2015,1,A,골목상권,1000862,방배로18길,76,39,37
2015,1,A,골목상권,1000861,반포대로9길,700,494,206
2015,1,A,골목상권,1000860,바우뫼로39길,3210,2005,1205
2015,1,A,골목상권,1000859,마방로2길,3571,2329,1242
2015,1,A,골목상권,1000858,방배천로4안길,1687,1015,672
2015,1,A,골목상권,1000857,동산로19길,1414,968,446
2015,1,A,골목상권,1000856,동산로10길,2104,1232,872
2015,1,A,골목상권,1000855,동광로39길,45,27,18
2015,1,A,골목상권,1000854,동광로1길,1370,791,579
2015,1,A,골목상권,1000853,동광로12길,704,476,228
2015,1,A,골목상권,1000852,논현로27길,3580,2596,984
2015,1,A,골목상권,1000851,논현로1길,569,342,227
2015,1,A,골목상권,1000850,남부순환로339길,11844,5467,6377
2015,1,A,골목상권,1000849,남부순환로325길,7798,4195,3603
2015,1,A,골목상권,1000848,남부순환로317길,1656,1259,397
2015,1,A,골목상권,1000847,고무래로8길,6372,3495,2877
2015,1,A,골목상권,1000846,강남대로8길,3076,2063,1013
2015,1,A,골목상권,1000845,강남대로34길,929,643,286
2015,1,A,골목상권,1000844,강남대로23길,6442,4856,1586
2015,1,A,골목상권,1000843,소담길,28,8,20
2015,1,A,골목상권,1000842,원신길,276,116,160
2015,1,A,골목상권,1000840,양산길,460,333,127
2015,1,A,골목상권,1000839,호암로24길,560,216,344
2015,1,A,골목상권,1000838,호암로20길,41,26,15
2015,1,A,골목상권,1000837,행운길,87,54,33
2015,1,A,골목상권,1000836,행운1길,60,40,20
2015,1,A,골목상권,1000835,청림3길,30,18,12
2015,1,A,골목상권,1000834,청룡길,141,63,78
2015,1,A,골목상권,1000833,청룡8길,11,7,4
2015,1,A,골목상권,1000832,중앙길,303,102,201
2015,1,A,골목상권,1000831,조원중앙로2길,1108,767,341
2015,1,A,골목상권,1000830,조원로18길,964,484,480
2015,1,A,골목상권,1000829,조원로10길,252,116,136
2015,1,A,골목상권,1000828,장군봉2길,335,136,199
2015,1,A,골목상권,1000827,장군봉1길,96,15,81
2015,1,A,골목상권,1000826,인헌길,86,42,44
2015,1,A,골목상권,1000825,은천로25길,295,104,191
2015,1,A,골목상권,1000824,양녕로6길,814,515,299
2015,1,A,골목상권,1000823,신원로3길,15,12,3
2015,1,A,골목상권,1000822,신사로20길,52,27,25
2015,1,A,골목상권,1000820,신림로64길,205,113,92
2015,1,A,골목상권,1000819,신림로48길,82,48,34
2015,1,A,골목상권,1000818,신림로38길,50,23,27
2015,1,A,골목상권,1000817,신림로28길,302,211,91
2015,1,A,골목상권,1000816,신림로11길,458,424,34
2015,1,A,골목상권,1000815,신림동길,443,271,172
2015,1,A,골목상권,1000814,승방길,497,317,180
2015,1,A,골목상권,1000813,서림7길,239,90,149
2015,1,A,골목상권,1000812,봉천로33길,423,279,144
2015,1,A,골목상권,1000811,봉천로13길,201,62,139
2015,1,A,골목상권,1000810,복은길,178,61,117
2015,1,A,골목상권,1000808,법원단지9길,70,29,41
2015,1,A,골목상권,1000807,미성5길,51,26,25
2015,1,A,골목상권,1000806,대학길,59,30,29
2015,1,A,골목상권,1000805,대학14길,11,2,9
2015,1,A,골목상권,1000804,당곡길,329,154,175
2015,1,A,골목상권,1000803,남현길,233,80,153
2015,1,A,골목상권,1000802,남현3길,600,353,247
2015,1,A,골목상권,1000800,남부순환로248길,248,125,123
2015,1,A,골목상권,1000799,남부순환로234길,136,90,46
2015,1,A,골목상권,1000798,남부순환로172길,1631,911,720
2015,1,A,골목상권,1000797,남부순환로161길,16,4,12
2015,1,A,골목상권,1000796,남부순환로151길,169,96,73
2015,1,A,골목상권,1000795,남부순환로142길,77,28,49
2015,1,A,골목상권,1000794,난향길,165,43,122
2015,1,A,골목상권,1000793,난우길,460,204,256
2015,1,A,골목상권,1000792,난곡로74길,165,65,100
2015,1,A,골목상권,1000791,난곡로34길,31,11,20
2015,1,A,골목상권,1000790,난곡로26길,103,55,48
2015,1,A,골목상권,1000789,난곡로24길,31,15,16
2015,1,A,골목상권,1000788,낙성대역길,765,490,275
2015,1,A,골목상권,1000787,국회단지길,499,230,269
2015,1,A,골목상권,1000786,구암길,71,26,45
2015,1,A,골목상권,1000785,관천로22길,15,5,10
2015,1,A,골목상권,1000784,관천로15길,132,73,59
2015,1,A,골목상권,1000783,관악로30길,186,62,124
2015,1,A,골목상권,1000782,관악로28길,146,69,77
2015,1,A,골목상권,1000781,관악로14길,493,280,213
2015,1,A,골목상권,1000780,관악로10길,256,186,70
2015,1,A,골목상권,1000779,흑석로9길,169,72,97
2015,1,A,골목상권,1000778,흑석로13길,165,23,142
2015,1,A,골목상권,1000777,장승배기로27길,31,17,14
2015,1,A,골목상권,1000776,장승배기로19길,3,3,0
2015,1,A,골목상권,1000774,여의대방로46길,356,93,263
2015,1,A,골목상권,1000773,여의대방로24길,13869,6183,7686
2015,1,A,골목상권,1000772,여의대방로22카길,261,107,154
2015,1,A,골목상권,1000771,여의대방로22나길,149,56,93
2015,1,A,골목상권,1000770,여의대방로22길,235,115,120
2015,1,A,골목상권,1000769,양녕로26길,127,68,59
2015,1,A,골목상권,1000768,신대방길,112,70,42
2015,1,A,골목상권,1000766,성대로1길,365,151,214
2015,1,A,골목상권,1000765,서달로8가길,194,83,111
2015,1,A,골목상권,1000763,서달로14길,54,21,33
2015,1,A,골목상권,1000762,서달로10길,76,33,43
2015,1,A,골목상권,1000761,상도로62길,182,72,110
2015,1,A,골목상권,1000760,상도로61길,90,39,51
2015,1,A,골목상권,1000759,상도로47길,68,47,21
2015,1,A,골목상권,1000758,상도로37길,1897,980,917
2015,1,A,골목상권,1000757,상도로15길,301,130,171
2015,1,A,골목상권,1000756,사당로8길,126,63,63
2015,1,A,골목상권,1000755,사당로30길,327,221,106
2015,1,A,골목상권,1000754,사당로2차길,89,55,34
2015,1,A,골목상권,1000753,사당로29길,17,14,3
2015,1,A,골목상권,1000752,사당로26길,251,141,110
2015,1,A,골목상권,1000751,사당로23나길,137,45,92
2015,1,A,골목상권,1000750,사당로23길,15,10,5
2015,1,A,골목상권,1000749,사당로20길,160,112,48
2015,1,A,골목상권,1000748,사당로16길,127,41,86
2015,1,A,골목상권,1000747,사당로16가길,766,504,262
2015,1,A,골목상권,1000746,만양로8길,60,24,36
2015,1,A,골목상권,1000745,만양로14길,438,198,240
2015,1,A,골목상권,1000744,등용로14길,574,441,133
2015,1,A,골목상권,1000743,동작대로7길,1613,705,908
2015,1,A,골목상권,1000742,동작대로35길,265,96,169
2015,1,A,골목상권,1000741,동작대로33길,102,53,49
2015,1,A,골목상권,1000740,동작대로29길,39,21,18
2015,1,A,골목상권,1000739,동작대로17길,1329,741,588
2015,1,A,골목상권,1000738,대방동2길,461,223,238
2015,1,A,골목상권,1000737,대방동27길,109,59,50
2015,1,A,골목상권,1000736,노량진로6길,114,30,84
2015,1,A,골목상권,1000735,국사봉길,30,1,29
2015,1,A,골목상권,1000734,국사봉2길,104,70,34
2015,1,A,골목상권,1000733,국사봉1길,6,1,5
2015,1,A,골목상권,1000732,영신로9길,236,125,111
2015,1,A,골목상권,1000731,영등포로84길,313,86,227
2015,1,A,골목상권,1000730,영등포로80길,69,48,21
2015,1,A,골목상권,1000729,영등포로62길,2,1,1
2015,1,A,골목상권,1000728,영등포로35길,63,46,17
2015,1,A,골목상권,1000727,영등포로27길,348,211,137
2015,1,A,골목상권,1000724,여의대방로43나길,2367,1826,541
2015,1,A,골목상권,1000723,여의대방로39길,14,10,4
2015,1,A,골목상권,1000722,여의대방로35길,739,397,342
2015,1,A,골목상권,1000721,양평로28길,667,536,131
2015,1,A,골목상권,1000720,양평로22라길,43,31,12
2015,1,A,골목상권,1000719,양평로19길,875,596,279
2015,1,A,골목상권,1000718,신길로60길,433,184,249
2015,1,A,골목상권,1000717,신길로42길,398,214,184
2015,1,A,골목상권,1000716,신길로42가길,93,27,66
2015,1,A,골목상권,1000715,신길로39길,91,49,42
2015,1,A,골목상권,1000714,신길로17길,44,30,14
2015,1,A,골목상권,1000713,선유서로28길,413,215,198
2015,1,A,골목상권,1000712,선유서로25길,2143,1552,591
2015,1,A,골목상권,1000711,선유서로24길,176,99,77
2015,1,A,골목상권,1000710,선유로55길,2190,1390,800
2015,1,A,골목상권,1000709,디지털로74길,54,34,20
2015,1,A,골목상권,1000708,디지털로57길,7,1,6
2015,1,A,골목상권,1000707,디지털로37길,183,82,101
2015,1,A,골목상권,1000706,도신로62길,198,47,151
2015,1,A,골목상권,1000705,도신로60길,87,14,73
2015,1,A,골목상권,1000704,도신로29길,84,44,40
2015,1,A,골목상권,1000703,도신로15길,94,54,40
2015,1,A,골목상권,1000702,도림천로21길,112,55,57
2015,1,A,골목상권,1000701,도림로63길,31,21,10
2015,1,A,골목상권,1000700,도림로147길,1628,1201,427
2015,1,A,골목상권,1000699,도림로112길,8,7,1
2015,1,A,골목상권,1000698,대림로8길,1862,653,1209
2015,1,A,골목상권,1000697,대림로7길,14,5,9
2015,1,A,골목상권,1000696,대림로44길,36,21,15
2015,1,A,골목상권,1000695,대림로34길,190,71,119
2015,1,A,골목상권,1000694,대림로31길,841,442,399
2015,1,A,골목상권,1000693,대림로29길,1571,772,799
2015,1,A,골목상권,1000692,대림로22길,299,164,135
2015,1,A,골목상권,1000691,당산로46길,3789,2213,1576
2015,1,A,골목상권,1000690,당산로38길,330,268,62
2015,1,A,골목상권,1000689,당산로37길,3452,2170,1282
2015,1,A,골목상권,1000688,당산로31길,3959,2257,1702
2015,1,A,골목상권,1000687,국회대로56길,1633,1056,577
2015,1,A,골목상권,1000686,경인로90길,312,191,121
2015,1,A,골목상권,1000685,경인로80길,1632,1195,437
2015,1,A,골목상권,1000684,경인로77길,572,433,139
2015,1,A,골목상권,1000683,가마산로61길,199,84,115
2015,1,A,골목상권,1000682,시흥대로94길,749,410,339
2015,1,A,골목상권,1000681,시흥대로84길,173,68,105
2015,1,A,골목상권,1000680,시흥대로68길,396,134,262
2015,1,A,골목상권,1000679,시흥대로63길,2529,1348,1181
2015,1,A,골목상권,1000678,시흥대로62가길,427,110,317
2015,1,A,골목상권,1000677,시흥대로36길,342,227,115
2015,1,A,골목상권,1000676,시흥대로22길,459,331,128
2015,1,A,골목상권,1000675,시흥대로153길,655,360,295
2015,1,A,골목상권,1000674,시흥대로150길,564,274,290
2015,1,A,골목상권,1000673,시흥대로141길,667,410,257
2015,1,A,골목상권,1000672,시흥대로138길,14,7,7
2015,1,A,골목상권,1000671,시흥대로120길,587,398,189
2015,1,A,골목상권,1000670,벚꽃로56길,1595,1147,448
2015,1,A,골목상권,1000669,범안로17길,212,113,99
2015,1,A,골목상권,1000668,범안로11길,1026,838,188
2015,1,A,골목상권,1000667,문성로5길,162,50,112
2015,1,A,골목상권,1000666,독산로85길,59,21,38
2015,1,A,골목상권,1000665,독산로78다길,222,94,128
2015,1,A,골목상권,1000664,독산로70길,4,3,1
2015,1,A,골목상권,1000663,독산로64길,149,35,114
2015,1,A,골목상권,1000662,독산로50길,111,33,78
2015,1,A,골목상권,1000661,독산로40길,52,19,33
2015,1,A,골목상권,1000660,독산로108길,784,331,453
2015,1,A,골목상권,1000659,남부순환로112길,9,4,5
2015,1,A,골목상권,1000658,금하로24길,167,50,117
2015,1,A,골목상권,1000657,금하로1길,54,35,19
2015,1,A,골목상권,1000656,금하로14길,8,4,4
2015,1,A,골목상권,1000655,가산로5길,520,412,108
2015,1,A,골목상권,1000654,가산로3길,2491,1940,551
2015,1,A,골목상권,1000653,중앙로1길,1356,983,373
2015,1,A,골목상권,1000652,중앙로15길,185,59,126
2015,1,A,골목상권,1000651,우마길,22,14,8
2015,1,A,골목상권,1000650,오류로8길,238,110,128
2015,1,A,골목상권,1000649,신도림로13길,644,499,145
2015,1,A,골목상권,1000648,새말로18길,1144,441,703
2015,1,A,골목상권,1000647,부일로1길,735,597,138
2015,1,A,골목상권,1000646,부일로15길,187,168,19
2015,1,A,골목상권,1000645,부일로11길,24,8,16
2015,1,A,골목상권,1000644,디지털로32길,1243,689,554
2015,1,A,골목상권,1000643,디지털로32가길,7048,5058,1990
2015,1,A,골목상권,1000642,디지털로27길,410,261,149
2015,1,A,골목상권,1000641,도림로6길,117,52,65
2015,1,A,골목상권,1000640,도림로12길,93,39,54
2015,1,A,골목상권,1000639,남부순환로97길,247,73,174
2015,1,A,골목상권,1000638,구로중앙로8길,242,100,142
2015,1,A,골목상권,1000637,구로중앙로7길,180,70,110
2015,1,A,골목상권,1000636,구로중앙로42길,730,580,150
2015,1,A,골목상권,1000635,구로중앙로34길,566,316,250
2015,1,A,골목상권,1000634,구로중앙로28길,2864,1366,1498
2015,1,A,골목상권,1000633,구로중앙로19길,19,9,10
2015,1,A,골목상권,1000632,구로동로8길,152,52,100
2015,1,A,골목상권,1000631,구로동로7길,162,63,99
2015,1,A,골목상권,1000630,구로동로42길,24,17,7
2015,1,A,골목상권,1000629,구로동로41길,454,275,179
2015,1,A,골목상권,1000628,구로동로38길,56,27,29
2015,1,A,골목상권,1000627,구로동로28길,185,77,108
2015,1,A,골목상권,1000626,구로동로15길,22,2,20
2015,1,A,골목상권,1000625,공원로6가길,261,200,61
2015,1,A,골목상권,1000624,고척로52길,250,64,186
2015,1,A,골목상권,1000623,고척로27다길,213,87,126
2015,1,A,골목상권,1000622,고척로27길,247,107,140
2015,1,A,골목상권,1000621,고척로21나길,250,57,193
2015,1,A,골목상권,1000620,경인로47길,788,437,351
2015,1,A,골목상권,1000619,경인로35길,277,119,158
2015,1,A,골목상권,1000618,경인로31길,48,11,37
2015,1,A,골목상권,1000617,경인로15길,96,47,49
2015,1,A,골목상권,1000616,개봉로3길,292,170,122
2015,1,A,골목상권,1000615,개봉로2길,484,130,354
2015,1,A,골목상권,1000614,개봉로23가길,852,503,349
2015,1,A,골목상권,1000613,개봉로20길,115,67,48
2015,1,A,골목상권,1000612,개봉로1길,37,20,17
2015,1,A,골목상권,1000611,개봉로17다길,126,59,67
2015,1,A,골목상권,1000610,개봉로17길,838,395,443
2015,1,A,골목상권,1000609,개봉로11길,56,14,42
2015,1,A,골목상권,1000608,화곡로64길,2470,1254,1216
2015,1,A,골목상권,1000607,화곡로59길,499,197,302
2015,1,A,골목상권,1000606,화곡로44나길,883,748,135
2015,1,A,골목상권,1000605,화곡로31길,1306,545,761
2015,1,A,골목상권,1000604,화곡로20길,488,316,172
2015,1,A,골목상권,1000603,화곡로13길,260,85,175
2015,1,A,골목상권,1000602,초원로16길,409,210,199
2015,1,A,골목상권,1000601,초록마을로8길,187,25,162
2015,1,A,골목상권,1000600,초록마을로3길,41,21,20
2015,1,A,골목상권,1000599,월정로20길,7,4,3
2015,1,A,골목상권,1000598,우장산로6길,339,203,136
2015,1,A,골목상권,1000597,양천로73가길,1399,918,481
2015,1,A,골목상권,1000596,양천로71길,216,124,92
2015,1,A,골목상권,1000595,양천로49길,804,634,170
2015,1,A,골목상권,1000594,양천로26길,107,48,59
2015,1,A,골목상권,1000593,양천로24길,220,112,108
2015,1,A,골목상권,1000592,양천로24가길,671,290,381
2015,1,A,골목상권,1000591,양천로14길,415,288,127
2015,1,A,골목상권,1000590,방화대로6라길,748,513,235
2015,1,A,골목상권,1000589,방화대로21길,726,425,301
2015,1,A,골목상권,1000588,등촌로5길,10,2,8
2015,1,A,골목상권,1000587,등촌로55길,455,334,121
2015,1,A,골목상권,1000586,등촌로51길,10,10,0
2015,1,A,골목상권,1000585,등촌로39길,46,17,29
2015,1,A,골목상권,1000584,등촌로13길,225,112,113
2015,1,A,골목상권,1000583,남부순환로11길,414,304,110
2015,1,A,골목상권,1000582,까치산로4길,127,49,78
2015,1,A,골목상권,1000581,국회대로7길,352,220,132
2015,1,A,골목상권,1000580,공항대로8길,230,128,102
2015,1,A,골목상권,1000579,공항대로61길,225,146,79
2015,1,A,골목상권,1000578,공항대로59다길,826,603,223
2015,1,A,골목상권,1000577,공항대로59길,1169,791,378
2015,1,A,골목상권,1000576,공항대로55길,731,536,195
2015,1,A,골목상권,1000575,공항대로42길,11,7,4
2015,1,A,골목상권,1000574,공항대로38길,235,119,116
2015,1,A,골목상권,1000573,곰달래로60길,546,281,265
2015,1,A,골목상권,1000572,곰달래로53길,61,14,47
2015,1,A,골목상권,1000571,곰달래로47길,39,14,25
2015,1,A,골목상권,1000570,곰달래로31길,13,11,2
2015,1,A,골목상권,1000569,곰달래로25길,512,205,307
2015,1,A,골목상권,1000568,개화동로25길,632,436,196
2015,1,A,골목상권,1000567,개화동로23길,101,60,41
2015,1,A,골목상권,1000566,강서로8길,118,73,45
2015,1,A,골목상권,1000565,강서로5라길,252,146,106
2015,1,A,골목상권,1000564,강서로5나길,105,64,41
2015,1,A,골목상권,1000563,강서로5가길,39,23,16
2015,1,A,골목상권,1000562,강서로47라길,64,39,25
2015,1,A,골목상권,1000561,강서로47길,394,194,200
2015,1,A,골목상권,1000560,강서로45다길,576,187,389
2015,1,A,골목상권,1000559,강서로45길,99,50,49
2015,1,A,골목상권,1000558,강서로35길,146,90,56
2015,1,A,골목상권,1000557,강서로29길,283,160,123
2015,1,A,골목상권,1000556,강서로18길,28,9,19
2015,1,A,골목상권,1000555,강서로17가길,103,42,61
2015,1,A,골목상권,1000554,강서로15길,290,159,131
2015,1,A,골목상권,1000553,가로공원로80길,125,69,56
2015,1,A,골목상권,1000552,가로공원로76가길,16,8,8
2015,1,A,골목상권,1000551,화곡로4길,295,120,175
2015,1,A,골목상권,1000550,화곡로3길,164,54,110
2015,1,A,골목상권,1000549,지양로7길,223,71,152
2015,1,A,골목상권,1000548,중앙로55길,368,194,174
2015,1,A,골목상권,1000547,중앙로51길,125,65,60
2015,1,A,골목상권,1000546,중앙로47길,90,18,72
2015,1,A,골목상권,1000545,중앙로45길,158,59,99
2015,1,A,골목상권,1000544,중앙로36길,2,2,0
2015,1,A,골목상권,1000543,중앙로32길,470,231,239
2015,1,A,골목상권,1000542,중앙로25길,264,76,188
2015,1,A,골목상권,1000541,은행정로7길,453,153,300
2015,1,A,골목상권,1000539,오목로5길,278,151,127
2015,1,A,골목상권,1000538,오목로3길,468,435,33
2015,1,A,골목상권,1000537,오목로30길,150,78,72
2015,1,A,골목상권,1000536,오목로23길,686,353,333
2015,1,A,골목상권,1000535,신월로20길,210,87,123
2015,1,A,골목상권,1000534,신월로15길,760,361,399
2015,1,A,골목상권,1000533,신목로6길,253,132,121
2015,1,A,골목상권,1000532,신목로5길,910,344,566
2015,1,A,골목상권,1000531,신목로2길,106,45,61
2015,1,A,골목상권,1000530,목동중앙서로8가길,202,109,93
2015,1,A,골목상권,1000529,목동중앙서로7길,207,76,131
2015,1,A,골목상권,1000528,목동중앙북로8길,450,197,253
2015,1,A,골목상권,1000527,목동중앙북로16길,246,73,173
2015,1,A,골목상권,1000526,목동중앙본로7길,90,34,56
2015,1,A,골목상권,1000525,목동중앙로3길,103,54,49
2015,1,A,골목상권,1000524,목동중앙로13나길,246,165,81
2015,1,A,골목상권,1000523,목동중앙남로3가길,575,399,176
2015,1,A,골목상권,1000522,목동로9길,2250,1516,734
2015,1,A,골목상권,1000521,목동로19길,959,397,562
2015,1,A,골목상권,1000519,목동동로12길,409,169,240
2015,1,A,골목상권,1000518,목동남로4길,10,5,5
2015,1,A,골목상권,1000517,남부순환로88길,303,118,185
2015,1,A,골목상권,1000516,남부순환로79길,538,385,153
2015,1,A,골목상권,1000515,남부순환로70길,631,445,186
2015,1,A,골목상권,1000514,남부순환로58길,145,73,72
2015,1,A,골목상권,1000513,남부순환로40길,23,13,10
2015,1,A,골목상권,1000512,남부순환로33길,1244,1015,229
2015,1,A,골목상권,1000511,곰달래로5길,43,22,21
2015,1,A,골목상권,1000510,곰달래로3길,398,214,184
2015,1,A,골목상권,1000509,곰달래로2길,302,184,118
2015,1,A,골목상권,1000508,곰달래로10길,393,308,85
2015,1,A,골목상권,1000507,가로공원로58길,94,19,75
2015,1,A,골목상권,1000506,효창원로93길,99,53,46
2015,1,A,골목상권,1000505,토정로37길,144,60,84
2015,1,A,골목상권,1000504,월드컵로8길,1641,935,706
2015,1,A,골목상권,1000503,월드컵로7길,4,2,2
2015,1,A,골목상권,1000502,월드컵로36길,113,32,81
2015,1,A,골목상권,1000501,월드컵로25길,271,148,123
2015,1,A,골목상권,1000500,월드컵로19길,376,149,227
2015,1,A,골목상권,1000499,월드컵로16길,2191,1338,853
2015,1,A,골목상권,1000498,월드컵로11길,217,81,136
2015,1,A,골목상권,1000497,월드컵로10길,1672,906,766
2015,1,A,골목상권,1000496,와우산로3길,177,105,72
2015,1,A,골목상권,1000495,와우산로29길,133,61,72
2015,1,A,골목상권,1000494,와우산로29가길,10,4,6
2015,1,A,골목상권,1000493,양화진길,481,338,143
2015,1,A,골목상권,1000492,양화로1길,4373,2281,2092
2015,1,A,골목상권,1000491,양화로11길,452,298,154
2015,1,A,골목상권,1000490,신촌로30길,25,12,13
2015,1,A,골목상권,1000489,신촌로28가길,121,49,72
2015,1,A,골목상권,1000488,신촌로12길,1185,569,616
2015,1,A,골목상권,1000487,숭문길,714,403,311
2015,1,A,골목상권,1000486,숭문8길,118,71,47
2015,1,A,골목상권,1000485,성지3길,474,250,224
2015,1,A,골목상권,1000484,성산로4길,2524,1667,857
2015,1,A,골목상권,1000483,성미산로32길,322,192,130
2015,1,A,골목상권,1000482,성미산로1길,565,443,122
2015,1,A,골목상권,1000481,성미산로11길,904,600,304
2015,1,A,골목상권,1000480,백범로16길,526,294,232
2015,1,A,골목상권,1000479,방울내로9안길,334,205,129
2015,1,A,골목상권,1000478,모래내로7길,245,124,121
2015,1,A,골목상권,1000477,매봉산로2길,2265,1514,751
2015,1,A,골목상권,1000476,망원로2길,195,122,73
2015,1,A,골목상권,1000475,망원로11길,810,437,373
2015,1,A,골목상권,1000474,만리재옛길,1166,488,678
2015,1,A,골목상권,1000473,마포대로4길,346,143,203
2015,1,A,골목상권,1000472,마포대로20길,1239,652,587
2015,1,A,골목상권,1000471,마포대로12길,69,37,32
2015,1,A,골목상권,1000470,동교로38길,172,76,96
2015,1,A,골목상권,1000469,동교로27길,3135,1498,1637
2015,1,A,골목상권,1000468,동교로25길,827,411,416
2015,1,A,골목상권,1000467,동교로19길,4276,2553,1723
2015,1,A,골목상권,1000466,동교로17길,799,416,383
2015,1,A,골목상권,1000465,독막로8길,386,187,199
2015,1,A,골목상권,1000464,독막로32길,488,207,281
2015,1,A,골목상권,1000463,독막로22길,70,39,31
2015,1,A,골목상권,1000462,도화길,1107,580,527
2015,1,A,골목상권,1000461,도화4길,363,128,235
2015,1,A,골목상권,1000460,대흥로28길,71,57,14
2015,1,A,골목상권,1000459,대흥로21길,581,120,461
2015,1,A,골목상권,1000458,광성로6길,110,79,31
2015,1,A,골목상권,1000457,홍제내길,96,60,36
2015,1,A,골목상권,1000456,홍연길,77,46,31
2015,1,A,골목상권,1000455,통일로39길,9,8,1
2015,1,A,골목상권,1000454,통일로37길,370,139,231
2015,1,A,골목상권,1000453,통일로11길,13,9,4
2015,1,A,골목상권,1000452,충정로6길,12112,6687,5425
2015,1,A,골목상권,1000451,충정로4길,2798,1879,919
2015,1,A,골목상권,1000450,증가로6길,254,93,161
2015,1,A,골목상권,1000449,증가로23나길,395,187,208
2015,1,A,골목상권,1000448,증가로20가길,281,97,184
2015,1,A,골목상권,1000447,증가로10길,173,90,83
2015,1,A,골목상권,1000446,응암로1길,335,244,91
2015,1,A,골목상권,1000445,연희로10길,96,65,31
2015,1,A,골목상권,1000444,신촌로37길,156,67,89
2015,1,A,골목상권,1000443,수색로8길,1584,1456,128
2015,1,A,골목상권,1000442,세무서길,341,129,212
2015,1,A,골목상권,1000440,세검정로1길,243,142,101
2015,1,A,골목상권,1000439,북아현로4길,373,98,275
2015,1,A,골목상권,1000438,모래내로15길,89,31,58
2015,1,A,골목상권,1000437,명지대길,340,248,92
2015,1,A,골목상권,1000436,독립문로8길,716,277,439
2015,1,A,골목상권,1000435,가재울로6길,16,9,7
2015,1,A,골목상권,1000434,통일로92길,65,31,34
2015,1,A,골목상권,1000433,통일로87길,198,84,114
2015,1,A,골목상권,1000432,통일로78길,194,68,126
2015,1,A,골목상권,1000430,진흥로1길,516,170,346
2015,1,A,골목상권,1000429,진흥로12길,371,157,214
2015,1,A,골목상권,1000428,증산서길,359,275,84
2015,1,A,골목상권,1000427,증산로9길,84,31,53
2015,1,A,골목상권,1000426,증산로5길,707,362,345
2015,1,A,골목상권,1000425,증산로21길,239,159,80
2015,1,A,골목상권,1000424,증산로17길,568,340,228
2015,1,A,골목상권,1000423,증산로15길,178,65,113
2015,1,A,골목상권,1000422,증산로13길,55,31,24
2015,1,A,골목상권,1000421,응암로34길,80,45,35
2015,1,A,골목상권,1000420,응암로22길,165,58,107
2015,1,A,골목상권,1000419,응암로14길,307,83,224
2015,1,A,골목상권,1000418,응암로13길,234,90,144
2015,1,A,골목상권,1000417,응암로12길,198,87,111
2015,1,A,골목상권,1000416,은평로8길,258,144,114
2015,1,A,골목상권,1000415,은평로3길,298,94,204
2015,1,A,골목상권,1000414,은평로20길,26,10,16
2015,1,A,골목상권,1000413,은평로13길,574,378,196
2015,1,A,골목상권,1000412,은평로10길,303,190,113
2015,1,A,골목상권,1000411,연서로5길,48,14,34
2015,1,A,골목상권,1000410,연서로41길,209,63,146
2015,1,A,골목상권,1000409,연서로3길,106,47,59
2015,1,A,골목상권,1000408,연서로34길,117,36,81
2015,1,A,골목상권,1000407,연서로33길,20,6,14
2015,1,A,골목상권,1000406,연서로29길,297,104,193
2015,1,A,골목상권,1000405,연서로28길,750,375,375
2015,1,A,골목상권,1000404,연서로27길,64,31,33
2015,1,A,골목상권,1000403,연서로21길,283,152,131
2015,1,A,골목상권,1000402,연서로17길,1010,382,628
2015,1,A,골목상권,1000401,연서로16길,310,114,196
2015,1,A,골목상권,1000400,연서로13길,705,227,478
2015,1,A,골목상권,1000399,연서로11길,170,88,82
2015,1,A,골목상권,1000398,역말로9길,19,15,4
2015,1,A,골목상권,1000397,수색로18길,675,558,117
2015,1,A,골목상권,1000396,서오릉로8길,19,11,8
2015,1,A,골목상권,1000395,서오릉로21길,437,140,297
2015,1,A,골목상권,1000394,불광천길,159,82,77
2015,1,A,골목상권,1000393,갈현로7길,951,263,688
2015,1,A,골목상권,1000392,갈현로41길,88,30,58
2015,1,A,골목상권,1000391,갈현로33길,30,8,22
2015,1,A,골목상권,1000390,갈현로1길,100,40,60
2015,1,A,골목상권,1000389,가좌로7길,52,24,28
2015,1,A,골목상권,1000388,한글비석로44길,485,260,225
2015,1,A,골목상권,1000387,한글비석로24길,345,136,209
2015,1,A,골목상권,1000386,한글비석로22길,595,259,336
2015,1,A,골목상권,1000385,석계로1길,109,68,41
2015,1,A,골목상권,1000384,상계로9가길,255,100,155
2015,1,A,골목상권,1000382,상계로12길,15,10,5
2015,1,A,골목상권,1000381,동일로242길,569,433,136
2015,1,A,골목상권,1000380,동일로192길,437,231,206
2015,1,A,골목상권,1000379,동일로173가길,2265,1271,994
2015,1,A,골목상권,1000378,공릉로58길,93,32,61
2015,1,A,골목상권,1000377,해등로16길,64,51,13
2015,1,A,골목상권,1000376,우이천로4다길,181,106,75
2015,1,A,골목상권,1000375,우이천로32길,105,49,56
2015,1,A,골목상권,1000374,시루봉로23길,37,15,22
2015,1,A,골목상권,1000373,삼양로144길,60,46,14
2015,1,A,골목상권,1000372,방학로6가길,158,84,74
2015,1,A,골목상권,1000371,방학로5길,154,82,72
2015,1,A,골목상권,1000370,방학로15길,331,229,102
2015,1,A,골목상권,1000369,방학로10길,109,65,44
2015,1,A,골목상권,1000367,도봉산4길,303,271,32
2015,1,A,골목상권,1000366,도봉로181길,250,119,131
2015,1,A,골목상권,1000365,도봉로169나길,232,115,117
2015,1,A,골목상권,1000364,도봉로156길,358,159,199
2015,1,A,골목상권,1000363,도봉로152가길,438,389,49
2015,1,A,골목상권,1000362,도봉로147길,604,348,256
2015,1,A,골목상권,1000360,도봉로114길,442,143,299
2015,1,A,골목상권,1000359,도봉로109길,16,6,10
2015,1,A,골목상권,1000358,도당로29길,891,539,352
2015,1,A,골목상권,1000357,도당로19길,157,72,85
2015,1,A,골목상권,1000356,도당로13바길,206,72,134
2015,1,A,골목상권,1000355,도당로13가길,136,59,77
2015,1,A,골목상권,1000354,덕릉로60길,60,32,28
2015,1,A,골목상권,1000353,노해로63다길,466,219,247
2015,1,A,골목상권,1000352,노해로60길,282,131,151
2015,1,A,골목상권,1000351,한천로140길,118,70,48
2015,1,A,골목상권,1000350,한천로139가길,55,33,22
2015,1,A,골목상권,1000349,한천로132길,306,112,194
2015,1,A,골목상권,1000348,한천로130길,271,108,163
2015,1,A,골목상권,1000347,한천로124나길,94,44,50
2015,1,A,골목상권,1000346,한천로109길,601,282,319
2015,1,A,골목상권,1000345,인수봉로79길,175,44,131
2015,1,A,골목상권,1000344,인수봉로72길,81,36,45
2015,1,A,골목상권,1000343,인수봉로56길,11,1,10
2015,1,A,골목상권,1000342,오패산로67길,455,245,210
2015,1,A,골목상권,1000341,오패산로52길,82,28,54
2015,1,A,골목상권,1000339,수유로12길,237,155,82
2015,1,A,골목상권,1000338,솔샘로65길,523,232,291
2015,1,A,골목상권,1000337,솔매로50길,694,286,408
2015,1,A,골목상권,1000336,솔매로45길,245,92,153
2015,1,A,골목상권,1000335,솔매로41길,80,21,59
2015,1,A,골목상권,1000334,삼양로93길,16,4,12
2015,1,A,골목상권,1000333,삼양로77길,377,134,243
2015,1,A,골목상권,1000332,삼양로54길,4,2,2
2015,1,A,골목상권,1000331,삼양로41길,338,160,178
2015,1,A,골목상권,1000329,삼양로24길,88,37,51
2015,1,A,골목상권,1000328,삼양로20길,125,42,83
2015,1,A,골목상권,1000327,삼각산로28길,669,388,281
2015,1,A,골목상권,1000326,도봉로99길,171,94,77
2015,1,A,골목상권,1000325,도봉로8길,271,192,79
2015,1,A,골목상권,1000324,도봉로76길,322,164,158
2015,1,A,골목상권,1000323,도봉로67길,8,4,4
2015,1,A,골목상권,1000322,도봉로45길,154,88,66
2015,1,A,골목상권,1000321,도봉로18길,537,253,284
2015,1,A,골목상권,1000320,도봉로13길,36,18,18
2015,1,A,골목상권,1000319,덕릉로41길,681,584,97
2015,1,A,골목상권,1000318,덕릉로40길,871,696,175
2015,1,A,골목상권,1000317,노해로33길,27,10,17
2015,1,A,골목상권,1000315,노해로17길,189,89,100
2015,1,A,골목상권,1000314,화랑로40길,117,63,54
2015,1,A,골목상권,1000313,화랑로32길,395,292,103
2015,1,A,골목상권,1000312,화랑로1길,185,100,85
2015,1,A,골목상권,1000311,화랑로19길,425,220,205
2015,1,A,골목상권,1000310,화랑로14길,36,19,17
2015,1,A,골목상권,1000309,화랑로13길,89,40,49
2015,1,A,골목상권,1000308,한천로76길,111,68,43
2015,1,A,골목상권,1000307,한천로101가길,61,35,26
2015,1,A,골목상권,1000306,창경궁로43길,22,16,6
2015,1,A,골목상권,1000305,지봉로20길,172,115,57
2015,1,A,골목상권,1000304,종암로5길,106,76,30
2015,1,A,골목상권,1000303,종암로24가길,270,135,135
2015,1,A,골목상권,1000302,종암로21길,113,42,71
2015,1,A,골목상권,1000301,종암로19길,390,112,278
2015,1,A,골목상권,1000300,종암로16길,58,23,35
2015,1,A,골목상권,1000299,정릉로8길,198,118,80
2015,1,A,골목상권,1000298,정릉로27길,229,110,119
2015,1,A,골목상권,1000296,장위로50길,1011,558,453
2015,1,A,골목상권,1000295,장월로1길,384,152,232
2015,1,A,골목상권,1000294,인촌로6길,1921,1003,918
2015,1,A,골목상권,1000293,인촌로5길,28,4,24
2015,1,A,골목상권,1000292,인촌로24길,293,138,155
2015,1,A,골목상권,1000291,개운사길,2710,1782,928
2015,1,A,골목상권,1000290,인촌로1길,147,98,49
2015,1,A,골목상권,1000289,인촌로17가길,2911,1191,1720
2015,1,A,골목상권,1000288,오패산로4길,470,173,297
2015,1,A,골목상권,1000287,오패산로3길,1264,706,558
2015,1,A,골목상권,1000286,오패산로19길,33,19,14
2015,1,A,골목상권,1000285,안암로5길,608,388,220
2015,1,A,골목상권,1000284,아리랑로4길,721,249,472
2015,1,A,골목상권,1000283,솔샘로6길,118,61,57
2015,1,A,골목상권,1000282,성북로8길,53,26,27
2015,1,A,골목상권,1000281,삼양로8길,72,49,23
2015,1,A,골목상권,1000280,삼선교로16가길,653,365,288
2015,1,A,골목상권,1000279,삼선교로10다길,101,36,65
2015,1,A,골목상권,1000278,삼선교로10길,230,101,129
2015,1,A,골목상권,1000277,보문로32길,938,408,530
2015,1,A,골목상권,1000276,보문로31길,892,359,533
2015,1,A,골목상권,1000274,보문로13길,605,369,236
2015,1,A,골목상권,1000273,보국문로16길,261,178,83
2015,1,A,골목상권,1000270,동소문로26가길,234,136,98
2015,1,A,골목상권,1000269,동소문로15길,61,24,37
2015,1,A,골목상권,1000268,동소문로13길,881,492,389
2015,1,A,골목상권,1000267,돌곶이로8길,197,111,86
2015,1,A,골목상권,1000266,돌곶이로41길,32,14,18
2015,1,A,골목상권,1000265,돌곶이로28길,153,81,72
2015,1,A,골목상권,1000264,돌곶이로27길,50,31,19
2015,1,A,골목상권,1000263,돌곶이로22길,97,52,45
2015,1,A,골목상권,1000261,길음로7길,12,8,4
2015,1,A,골목상권,1000260,중랑천로10길,633,344,289
2015,1,A,골목상권,1000259,용마산로94길,428,269,159
2015,1,A,골목상권,1000258,용마산로118길,517,219,298
2015,1,A,골목상권,1000257,용마산로112길,249,116,133
2015,1,A,골목상권,1000256,용마산로100길,495,351,144
2015,1,A,골목상권,1000255,신내로7가길,300,76,224
2015,1,A,골목상권,1000254,사가정로54길,92,33,59
2015,1,A,골목상권,1000253,사가정로42길,66,21,45
2015,1,A,골목상권,1000252,봉화산로56길,558,150,408
2015,1,A,골목상권,1000251,봉화산로4길,303,122,181
2015,1,A,골목상권,1000250,봉화산로30길,365,247,118
2015,1,A,골목상권,1000249,봉우재로33길,58,24,34
2015,1,A,골목상권,1000248,면목로78길,247,139,108
2015,1,A,골목상권,1000247,면목로56길,234,188,46
2015,1,A,골목상권,1000246,면목로55길,421,124,297
2015,1,A,골목상권,1000245,면목로49길,509,169,340
2015,1,A,골목상권,1000244,면목로48길,97,53,44
2015,1,A,골목상권,1000243,면목로45길,83,39,44
2015,1,A,골목상권,1000242,면목로33길,431,165,266
2015,1,A,골목상권,1000241,면목로21길,28,18,10
2015,1,A,골목상권,1000240,망우로73길,7,3,4
2015,1,A,골목상권,1000239,망우로68길,76,31,45
2015,1,A,골목상권,1000238,동일로163길,104,71,33
2015,1,A,골목상권,1000237,동일로157길,175,90,85
2015,1,A,골목상권,1000236,동일로149길,1098,813,285
2015,1,A,골목상권,1000235,동일로140길,223,84,139
2015,1,A,골목상권,1000234,동일로139길,75,48,27
2015,1,A,골목상권,1000233,동일로139가길,994,600,394
2015,1,A,골목상권,1000232,동일로130길,96,26,70
2015,1,A,골목상권,1000231,동일로123길,178,98,80
2015,1,A,골목상권,1000230,동일로112길,199,78,121
2015,1,A,골목상권,1000229,동일로101길,315,127,188
2015,1,A,골목상권,1000228,동일로100길,34,14,20
2015,1,A,골목상권,1000227,답십리로75길,82,44,38
2015,1,A,골목상권,1000226,공릉로2길,548,272,276
2015,1,A,골목상권,1000225,공릉로12가길,45,31,14
2015,1,A,골목상권,1000224,겸재로54길,98,54,44
2015,1,A,골목상권,1000223,겸재로36길,305,246,59
2015,1,A,골목상권,1000222,겸재로29길,443,202,241
2015,1,A,골목상권,1000221,휘경로3길,176,92,84
2015,1,A,골목상권,1000220,휘경로2길,7,2,5
2015,1,A,골목상권,1000219,휘경로23길,16,0,16
2015,1,A,골목상권,1000218,휘경로14길,81,37,44
2015,1,A,골목상권,1000217,한천로46길,376,127,249
2015,1,A,골목상권,1000216,한천로40길,308,166,142
2015,1,A,골목상권,1000215,한천로33길,85,35,50
2015,1,A,골목상권,1000214,한천로14길,565,345,220
2015,1,A,골목상권,1000213,천호대로97길,323,208,115
2015,1,A,골목상권,1000212,천호대로77길,2079,1162,917
2015,1,A,골목상권,1000211,천호대로45길,177,113,64
2015,1,A,골목상권,1000210,천호대로17길,1948,1233,715
2015,1,A,골목상권,1000209,천호대로12길,804,556,248
2015,1,A,골목상권,1000208,천장산로7길,1329,845,484
2015,1,A,골목상권,1000207,제기로5길,197,108,89
2015,1,A,골목상권,1000206,제기로21길,217,139,78
2015,1,A,골목상권,1000205,전농로4길,658,429,229
2015,1,A,골목상권,1000204,전농로3길,108,44,64
2015,1,A,골목상권,1000203,전농로29길,278,117,161
2015,1,A,골목상권,1000202,장한로8길,726,416,310
2015,1,A,골목상권,1000201,장한로5길,3252,2173,1079
2015,1,A,골목상권,1000200,장한로27길,158,49,109
2015,1,A,골목상권,1000199,장한로27가길,372,185,187
2015,1,A,골목상권,1000198,장한로26길,533,265,268
2015,1,A,골목상권,1000197,장한로26가길,327,170,157
2015,1,A,골목상권,1000196,장한로25길,993,463,530
2015,1,A,골목상권,1000195,장한로14길,193,165,28
2015,1,A,골목상권,1000194,이문로42길,223,83,140
2015,1,A,골목상권,1000193,왕산로43길,972,484,488
2015,1,A,골목상권,1000192,왕산로33길,178,118,60
2015,1,A,골목상권,1000191,왕산로32길,10,6,4
2015,1,A,골목상권,1000190,약령시로17길,249,139,110
2015,1,A,골목상권,1000189,서울시립대로4길,774,508,266
2015,1,A,골목상권,1000188,서울시립대로29길,190,111,79
2015,1,A,골목상권,1000187,서울시립대로16길,110,31,79
2015,1,A,골목상권,1000186,사가정로2길,130,93,37
2015,1,A,골목상권,1000185,사가정로23가길,91,61,30
2015,1,A,골목상권,1000184,사가정로13길,294,113,181
2015,1,A,골목상권,1000183,무학로45길,364,196,168
2015,1,A,골목상권,1000182,무학로16길,1050,920,130
2015,1,A,골목상권,1000181,망우로21길,178,101,77
2015,1,A,골목상권,1000180,망우로18길,551,250,301
2015,1,A,골목상권,1000179,망우로18가길,73,27,46
2015,1,A,골목상권,1000178,답십리로72길,8,7,1
2015,1,A,골목상권,1000177,답십리로69길,758,337,421
2015,1,A,골목상권,1000176,답십리로68길,165,108,57
2015,1,A,골목상권,1000175,답십리로64길,358,198,160
2015,1,A,골목상권,1000174,답십리로63길,87,56,31
2015,1,A,골목상권,1000173,답십리로60길,12,6,6
2015,1,A,골목상권,1000172,답십리로56길,8,6,2
2015,1,A,골목상권,1000171,답십리로23길,2,2,0
2015,1,A,골목상권,1000170,난계로30길,216,170,46
2015,1,A,골목상권,1000168,경희대로3길,255,158,97
2015,1,A,골목상권,1000167,천호대로129길,185,62,123
2015,1,A,골목상권,1000166,천호대로123길,363,154,209
2015,1,A,골목상권,1000165,천호대로109길,1371,820,551
2015,1,A,골목상권,1000164,자양번영로3길,92,41,51
2015,1,A,골목상권,1000162,자양로50길,22,7,15
2015,1,A,골목상권,1000161,자양로45길,517,282,235
2015,1,A,골목상권,1000160,자양로26길,324,114,210
2015,1,A,골목상권,1000159,자양로15길,372,222,150
2015,1,A,골목상권,1000158,자양로11길,1261,630,631
2015,1,A,골목상권,1000157,용마산로3길,871,487,384
2015,1,A,골목상권,1000156,용마산로21길,150,69,81
2015,1,A,골목상권,1000155,아차산로78길,1723,1079,644
2015,1,A,골목상권,1000154,아차산로65길,649,446,203
2015,1,A,골목상권,1000153,아차산로55길,536,260,276
2015,1,A,골목상권,1000152,아차산로51길,229,131,98
2015,1,A,골목상권,1000151,아차산로40길,516,304,212
2015,1,A,골목상권,1000150,면목로17길,223,139,84
2015,1,A,골목상권,1000149,뚝섬로64길,359,198,161
2015,1,A,골목상권,1000148,뚝섬로58길,203,89,114
2015,1,A,골목상권,1000147,뚝섬로54길,139,80,59
2015,1,A,골목상권,1000146,뚝섬로48길,744,355,389
2015,1,A,골목상권,1000145,뚝섬로24길,111,40,71
2015,1,A,골목상권,1000144,뚝섬로23길,90,61,29
2015,1,A,골목상권,1000143,동일로24길,9,4,5
2015,1,A,골목상권,1000142,동일로18길,135,64,71
2015,1,A,골목상권,1000141,능동로4길,206,81,125
2015,1,A,골목상권,1000140,능동로3길,184,80,104
2015,1,A,골목상권,1000139,능동로34길,707,425,282
2015,1,A,골목상권,1000138,능동로19길,351,230,121
2015,1,A,골목상권,1000137,능동로13길,300,96,204
2015,1,A,골목상권,1000136,긴고랑로9길,70,31,39
2015,1,A,골목상권,1000135,긴고랑로8길,238,210,28
2015,1,A,골목상권,1000134,긴고랑로7길,454,225,229
2015,1,A,골목상권,1000133,긴고랑로20길,524,237,287
2015,1,A,골목상권,1000132,광나루로52길,1585,802,783
2015,1,A,골목상권,1000131,광나루로40길,78,34,44
2015,1,A,골목상권,1000130,광나루로37길,275,168,107
2015,1,A,골목상권,1000129,광나루로36길,30,18,12
2015,1,A,골목상권,1000128,광나루로24길,105,59,46
2015,1,A,골목상권,1000127,광나루로12길,876,549,327
2015,1,A,골목상권,1000126,한림말길,93,61,32
2015,1,A,골목상권,1000124,청계천로10나길,1770,1009,761
2015,1,A,골목상권,1000123,장터길,34,11,23
2015,1,A,골목상권,1000122,용답중앙길,92,49,43
2015,1,A,골목상권,1000121,용답29길,1814,901,913
2015,1,A,골목상권,1000120,왕십리로6길,1324,762,562
2015,1,A,골목상권,1000119,왕십리로31길,135,62,73
2015,1,A,골목상권,1000118,왕십리로26길,3975,2177,1798
2015,1,A,골목상권,1000117,왕십리로21길,138,39,99
2015,1,A,골목상권,1000116,왕십리로14길,1896,1523,373
2015,1,A,골목상권,1000115,아차산로5길,2105,1449,656
2015,1,A,골목상권,1000114,아차산로15길,3620,2630,990
2015,1,A,골목상권,1000113,아차산로11길,3282,2095,1187
2015,1,A,골목상권,1000112,송정4가길,1143,585,558
2015,1,A,골목상권,1000111,송정12라길,223,162,61
2015,1,A,골목상권,1000110,성수일로6길,3109,1744,1365
2015,1,A,골목상권,1000109,성수이로7길,578,320,258
2015,1,A,골목상권,1000108,성수이로18길,2126,1519,607
2015,1,A,골목상권,1000107,성덕정길,595,369,226
2015,1,A,골목상권,1000106,성덕정17길,205,113,92
2015,1,A,골목상권,1000105,서울숲2길,1676,899,777
2015,1,A,골목상권,1000104,상원길,1519,1004,515
2015,1,A,골목상권,1000103,상원12길,140,86,54
2015,1,A,골목상권,1000102,사근동길,26,16,10
2015,1,A,골목상권,1000101,무학봉길,8,7,1
2015,1,A,골목상권,1000100,무학봉28길,169,74,95
2015,1,A,골목상권,1000099,무학로6길,350,204,146
2015,1,A,골목상권,1000098,무수막길,102,51,51
2015,1,A,골목상권,1000097,매봉길,27,16,11
2015,1,A,골목상권,1000096,마조로1길,169,68,101
2015,1,A,골목상권,1000095,마조로16길,806,550,256
2015,1,A,골목상권,1000094,마장로39길,15,11,4
2015,1,A,골목상권,1000093,마장로27길,104,38,66
2015,1,A,골목상권,1000091,둘레9길,396,237,159
2015,1,A,골목상권,1000090,금호산길,373,134,239
2015,1,A,골목상권,1000089,금호산2길,32,13,19
2015,1,A,골목상권,1000088,고산자로6길,15962,6588,9374
2015,1,A,골목상권,1000087,후암로28길,176,69,107
2015,1,A,골목상권,1000086,효창원로39길,53,33,20
2015,1,A,골목상권,1000085,회나무로13길,41,23,18
2015,1,A,골목상권,1000084,한남대로20길,832,504,328
2015,1,A,골목상권,1000082,한강대로7길,382,271,111
2015,1,A,골목상권,1000081,한강대로62길,663,455,208
2015,1,A,골목상권,1000080,한강대로52길,6319,2010,4309
2015,1,A,골목상권,1000079,한강대로43길,4686,3077,1609
2015,1,A,골목상권,1000078,한강대로15길,1905,429,1476
2015,1,A,골목상권,1000077,한강대로104길,4794,3508,1286
2015,1,A,골목상권,1000076,청파로73길,1414,815,599
2015,1,A,골목상권,1000075,청파로71길,257,136,121
2015,1,A,골목상권,1000074,청파로47나길,116,83,33
2015,1,A,골목상권,1000073,청파로47길,809,375,434
2015,1,A,골목상권,1000072,장문로45길,86,8,78
2015,1,A,골목상권,1000071,이태원로54길,2263,1575,688
2015,1,A,골목상권,1000070,이태원로27길,476,289,187
2015,1,A,골목상권,1000069,이촌로22길,195,111,84
2015,1,A,골목상권,1000068,원효로89길,909,739,170
2015,1,A,골목상권,1000067,원효로53길,696,434,262
2015,1,A,골목상권,1000066,원효로41길,2831,2036,795
2015,1,A,골목상권,1000065,원효로19길,913,669,244
2015,1,A,골목상권,1000064,우사단로4길,156,116,40
2015,1,A,골목상권,1000063,우사단로14길,1735,970,765
2015,1,A,골목상권,1000062,우사단로10길,58,29,29
2015,1,A,골목상권,1000061,신흥로20길,214,107,107
2015,1,A,골목상권,1000060,소월로20길,126,43,83
2015,1,A,골목상권,1000059,서빙고로71길,466,277,189
2015,1,A,골목상권,1000058,백범로90길,262,158,104
2015,1,A,골목상권,1000057,백범로79길,929,585,344
2015,1,A,골목상권,1000056,두텁바위로1길,2520,1458,1062
2015,1,A,골목상권,1000055,대사관로34길,295,167,128
2015,1,A,골목상권,1000054,녹사평대로46길,25,17,8
2015,1,A,골목상권,1000053,녹사평대로40나길,21,9,12
2015,1,A,골목상권,1000052,녹사평대로32길,334,176,158
2015,1,A,골목상권,1000051,녹사평대로26길,2210,1334,876
2015,1,A,골목상권,1000050,녹사평대로11길,271,175,96
2015,1,A,골목상권,1000049,퇴계로90길,460,193,267
2015,1,A,골목상권,1000048,퇴계로8길,2235,1321,914
2015,1,A,골목상권,1000047,퇴계로56길,864,659,205
2015,1,A,골목상권,1000046,퇴계로46길,1866,721,1145
2015,1,A,골목상권,1000045,퇴계로18길,2828,1335,1493
2015,1,A,골목상권,1000044,퇴계로12길,1007,455,552
2015,1,A,골목상권,1000043,청구로1길,213,106,107
2015,1,A,골목상권,1000042,청구로17길,1657,765,892
2015,1,A,골목상권,1000041,장충단로8길,3994,1255,2739
2015,1,A,골목상권,1000040,삼일대로4길,1356,977,379
2015,1,A,골목상권,1000039,명동길,34339,17638,16701
2015,1,A,골목상권,1000037,동호로20길,940,423,517
2015,1,A,골목상권,1000036,동호로15길,4452,2435,2017
2015,1,A,골목상권,1000035,동호로11길,11,9,2
2015,1,A,골목상권,1000034,동호로10길,4334,2316,2018
2015,1,A,골목상권,1000033,다산로39길,924,570,354
2015,1,A,골목상권,1000032,다산로38길,1309,727,582
2015,1,A,골목상권,1000031,다산로36길,46,26,20
2015,1,A,골목상권,1000030,다산로33길,367,193,174
2015,1,A,골목상권,1000029,난계로21길,176,117,59
2015,1,A,골목상권,1000028,난계로11길,1453,861,592
2015,1,A,골목상권,1000026,평창길,172,72,100
2015,1,A,골목상권,1000025,통일로12길,130,42,88
2015,1,A,골목상권,1000024,창신길,251,72,179
2015,1,A,골목상권,1000023,창신5길,7,4,3
2015,1,A,골목상권,1000022,창신2길,41,24,17
2015,1,A,골목상권,1000021,창경궁로35길,1281,361,920
2015,1,A,골목상권,1000020,지봉로8길,145,71,74
2015,1,A,골목상권,1000019,종로65길,560,284,276
2015,1,A,골목상권,1000016,자하문로7길,472,278,194
2015,1,A,골목상권,1000015,이화장길,2075,1037,1038
2015,1,A,골목상권,1000014,율곡로16길,58,20,38
2015,1,A,골목상권,1000013,율곡로10길,2193,1624,569
2015,1,A,골목상권,1000012,옥인길,476,224,252
2015,1,A,골목상권,1000011,숭인동길,16,6,10
2015,1,A,골목상권,1000010,성균관로5길,107,61,46
2015,1,A,골목상권,1000009,삼청로5길,447,180,267
2015,1,A,골목상권,1000008,북촌로5나길,1502,1054,448
2015,1,A,골목상권,1000007,북촌로5길,43,20,23
2015,1,A,골목상권,1000006,북촌로11길,17,9,8
2015,1,A,골목상권,1000005,백석동길,83,42,41
2015,1,A,골목상권,1000004,명륜길,10,7,3
2015,1,A,골목상권,1000003,돈화문로11가길,1092,600,492
2015,1,A,골목상권,1000001,계동길,780,367,413
2014,4,U,관광특구,1001496,강남 마이스 관광특구,20221,11888,8333
2014,4,U,관광특구,1001495,잠실 관광특구,26104,15792,10312
2014,4,U,관광특구,1001494,종로?청계 관광특구,30067,19008,11059
2014,4,U,관광특구,1001493,동대문패션타운 관광특구,14192,9546,4646
2014,4,U,관광특구,1001492,명동 남대문 북창동 다동 무교동 관광특구,174074,89361,84713
2014,4,U,관광특구,1001491,이태원 관광특구,5805,3408,2397
2014,4,R,전통시장,1001490,길동복조리시장,563,341,222
2014,4,R,전통시장,1001489,둔촌역전통시장,157,79,78
2014,4,R,전통시장,1001488,성내골목시장,7,2,5
2014,4,R,전통시장,1001487,천호시장,16,9,7
2014,4,R,전통시장,1001483,암사종합시장,603,303,300
2014,4,R,전통시장,1001482,고덕전통시장,410,397,13
2014,4,R,전통시장,1001481,명일골목시장,123,68,55
2014,4,R,전통시장,1001480,새마을시장,289,154,135
2014,4,R,전통시장,1001479,석촌시장,185,127,58
2014,4,R,전통시장,1001478,방이시장,623,411,212
2014,4,R,전통시장,1001477,마천시장,249,63,186
2014,4,R,전통시장,1001476,풍납시장,11,2,9
2014,4,R,전통시장,1001475,강남개포시장,42,35,7
2014,4,R,전통시장,1001474,도곡시장,499,248,251
2014,4,R,전통시장,1001471,영동전통시장,3105,2313,792
2014,4,R,전통시장,1001466,미성동도깨비시장,393,167,226
2014,4,R,전통시장,1001464,삼성동시장,90,37,53
2014,4,R,전통시장,1001463,신림중앙시장,15,10,5
2014,4,R,전통시장,1001462,강남골목시장,367,178,189
2014,4,R,전통시장,1001460,관악신사시장,317,247,70
2014,4,R,전통시장,1001459,신원시장,338,144,194
2014,4,R,전통시장,1001458,인헌시장,215,71,144
2014,4,R,전통시장,1001456,봉천현대시장,11,6,5
2014,4,R,전통시장,1001454,봉천제일종합시장,41,21,20
2014,4,R,전통시장,1001453,낙성대시장,18,11,7
2014,4,R,전통시장,1001452,중부시장,154,47,107
2014,4,R,전통시장,1001450,남성역골목시장,456,217,239
2014,4,R,전통시장,1001449,남성사계시장,1977,883,1094
2014,4,R,전통시장,1001448,흑석시장,154,50,104
2014,4,R,전통시장,1001447,상도4동도깨비골목시장,327,90,237
2014,4,R,전통시장,1001445,영도시장,101,43,58
2014,4,R,전통시장,1001441,본동인정시장,124,65,59
2014,4,R,전통시장,1001439,대림중앙시장,22,16,6
2014,4,R,전통시장,1001438,우리시장,16,5,11
2014,4,R,전통시장,1001437,영진시장A동,40,32,8
2014,4,R,전통시장,1001433,영일시장,7,5,2
2014,4,R,전통시장,1001431,영등포청과시장,166,102,64
2014,4,R,전통시장,1001430,영등포전통시장,4014,2014,2000
2014,4,R,전통시장,1001429,은행나무시장,40,10,30
2014,4,R,전통시장,1001427,현대시장,57,14,43
2014,4,R,전통시장,1001424,남문시장,273,118,155
2014,4,R,전통시장,1001423,독산동 우시장,131,55,76
2014,4,R,전통시장,1001421,개봉중앙시장,7,4,3
2014,4,R,전통시장,1001419,가리봉시장,15,9,6
2014,4,R,전통시장,1001418,남구로시장,6,4,2
2014,4,R,전통시장,1001417,구로시장,55,28,27
2014,4,R,전통시장,1001415,방신전통시장,157,129,28
2014,4,R,전통시장,1001414,송화골목시장,486,169,317
2014,4,R,전통시장,1001413,까치산시장,26,16,10
2014,4,R,전통시장,1001411,남부골목시장,167,71,96
2014,4,R,전통시장,1001409,화곡중앙골목시장,2,2,0
2014,4,R,전통시장,1001407,등마루시장,804,522,282
2014,4,R,전통시장,1001406,신정3동골목시장,242,102,140
2014,4,R,전통시장,1001405,신정2동골목시장,8,5,3
2014,4,R,전통시장,1001402,신월6동골목시장,251,110,141
2014,4,R,전통시장,1001401,신곡종합시장,18,9,9
2014,4,R,전통시장,1001400,신월3동골목시장,44,12,32
2014,4,R,전통시장,1001399,경창시장,201,105,96
2014,4,R,전통시장,1001398,월정로시장,96,54,42
2014,4,R,전통시장,1001397,신영시장,41,18,23
2014,4,R,전통시장,1001396,목4동시장,237,72,165
2014,4,R,전통시장,1001395,목3동시장,591,258,333
2014,4,R,전통시장,1001394,목2동시장,173,84,89
2014,4,R,전통시장,1001393,마포농수산물시장,492,315,177
2014,4,R,전통시장,1001391,망원월드컵시장,15,9,6
2014,4,R,전통시장,1001390,망원시장,38,20,18
2014,4,R,전통시장,1001386,신수시장,214,135,79
2014,4,R,전통시장,1001385,아현시장,46,27,19
2014,4,R,전통시장,1001374,대림골목시장,278,85,193
2014,4,R,전통시장,1001367,상계중앙시장,32,19,13
2014,4,R,전통시장,1001364,방학동도깨비시장,125,57,68
2014,4,R,전통시장,1001363,쌍문역골목시장,49,23,26
2014,4,R,전통시장,1001361,신도봉시장,14,6,8
2014,4,R,전통시장,1001359,창동신창시장,112,38,74
2014,4,R,전통시장,1001357,장미원골목시장,55,35,20
2014,4,R,전통시장,1001356,수유중앙시장,145,85,60
2014,4,R,전통시장,1001355,강북종합시장,52,20,32
2014,4,R,전통시장,1001354,우이시장,145,68,77
2014,4,R,전통시장,1001353,수유전통시장,460,155,305
2014,4,R,전통시장,1001352,번동북부골목시장,86,53,33
2014,4,R,전통시장,1001351,솔샘시장,92,35,57
2014,4,R,전통시장,1001349,방천골목시장,76,27,49
2014,4,R,전통시장,1001347,석관황금시장,44,21,23
2014,4,R,전통시장,1001343,장위전통시장,195,71,124
2014,4,R,전통시장,1001340,정릉시장,36,16,20
2014,4,R,전통시장,1001339,정릉아리랑시장,7,4,3
2014,4,R,전통시장,1001338,돈암제일시장,73,46,27
2014,4,R,전통시장,1001336,우림골목시장,233,113,120
2014,4,R,전통시장,1001335,묵1동도깨비시장,263,95,168
2014,4,R,전통시장,1001334,태능시장,3,1,2
2014,4,R,전통시장,1001333,중화제일시장,21,0,21
2014,4,R,전통시장,1001332,사가정시장,251,198,53
2014,4,R,전통시장,1001330,동원시장,41,15,26
2014,4,R,전통시장,1001329,동부골목시장,79,32,47
2014,4,R,전통시장,1001326,회기시장,135,45,90
2014,4,R,전통시장,1001323,답십리시장,21,11,10
2014,4,R,전통시장,1001321,답십리현대시장,97,72,25
2014,4,R,전통시장,1001319,청량리종합시장,8,6,2
2014,4,R,전통시장,1001317,청량리농수산물시장,13,11,2
2014,4,R,전통시장,1001316,서울약령시장,1328,865,463
2014,4,R,전통시장,1001313,청량리수산시장,157,81,76
2014,4,R,전통시장,1001310,구의시장,87,50,37
2014,4,R,전통시장,1001309,조양시장,70,43,27
2014,4,R,전통시장,1001308,영동교골목시장,24,15,9
2014,4,R,전통시장,1001307,능동로골목시장,272,253,19
2014,4,R,전통시장,1001304,자양골목시장,83,40,43
2014,4,R,전통시장,1001301,중곡제일시장,126,65,61
2014,4,R,전통시장,1001299,한아름시장,86,47,39
2014,4,R,전통시장,1001298,성동용답상가시장,234,119,115
2014,4,R,전통시장,1001297,뚝도시장,28,8,20
2014,4,R,전통시장,1001296,금남시장,15,12,3
2014,4,R,전통시장,1001295,행당시장,211,107,104
2014,4,R,전통시장,1001294,마장축산물시장,1491,1028,463
2014,4,R,전통시장,1001289,용문전통시장,26,17,9
2014,4,R,전통시장,1001286,후암시장,28,11,17
2014,4,R,전통시장,1001285,합동(새벽)시장,2372,1217,1155
2014,4,R,전통시장,1001284,서울중앙시장,248,175,73
2014,4,R,전통시장,1001283,백학시장,474,257,217
2014,4,R,전통시장,1001282,약수시장,1462,560,902
2014,4,R,전통시장,1001281,청평화시장,2428,1662,766
2014,4,R,전통시장,1001280,제일평화시장,451,284,167
2014,4,R,전통시장,1001278,남평화시장,152,101,51
2014,4,R,전통시장,1001277,방산종합시장,1695,1130,565
2014,4,R,전통시장,1001275,인현시장,1172,766,406
2014,4,R,전통시장,1001274,신중부시장,2487,1681,806
2014,4,R,전통시장,1001273,남대문시장,7015,3772,3243
2014,4,R,전통시장,1001271,동묘시장,913,559,354
2014,4,R,전통시장,1001270,창신골목시장,216,124,92
2014,4,R,전통시장,1001268,충신시장,319,170,149
2014,4,R,전통시장,1001267,종로신진시장,21,10,11
2014,4,R,전통시장,1001266,동대문종합시장,245,155,90
2014,4,R,전통시장,1001265,광장시장,209,142,67
2014,4,D,발달상권,1001263,서울 노원구 노원역_3,669,268,401
2014,4,D,발달상권,1001261,서울 노원구 노원역_1,945,276,669
2014,4,D,발달상권,1001260,창동역,2238,1450,788
2014,4,D,발달상권,1001259,서울 강북구 수유역_3,51,28,23
2014,4,D,발달상권,1001257,서울 강북구 수유역_2,3961,2065,1896
2014,4,D,발달상권,1001256,서울 강북구 수유역_1,71,54,17
2014,4,D,발달상권,1001255,서울 은평구 연신내역_3,550,174,376
2014,4,D,발달상권,1001254,서울 은평구 연신내역_2,310,135,175
2014,4,D,발달상권,1001253,서울 은평구 연신내역_1,47,23,24
2014,4,D,발달상권,1001252,서울 성북구 미아삼거리역_2,521,254,267
2014,4,D,발달상권,1001251,서울 강북구 미아삼거리역_1,441,158,283
2014,4,D,발달상권,1001250,서울 은평구 불광역_3,51,19,32
2014,4,D,발달상권,1001249,서울 은평구 불광역_2,69,28,41
2014,4,D,발달상권,1001248,서울 은평구 불광역_1,234,96,138
2014,4,D,발달상권,1001247,미아사거리_2,129,78,51
2014,4,D,발달상권,1001246,미아사거리_1,512,209,303
2014,4,D,발달상권,1001245,서울 성북구 성신여대입구역,4819,3026,1793
2014,4,D,발달상권,1001244,경희대학교,310,144,166
2014,4,D,발달상권,1001243,서울 성북구 안암역,78,43,35
2014,4,D,발달상권,1001242,혜화역 대학로_3,10249,3185,7064
2014,4,D,발달상권,1001241,혜화역 대학로_2,1386,817,569
2014,4,D,발달상권,1001240,혜화역 대학로_1,1082,582,500
2014,4,D,발달상권,1001239,디지털미디어시티,15592,10551,5041
2014,4,D,발달상권,1001238,서울 동대문구 청량리역,3263,2127,1136
2014,4,D,발달상권,1001236,서울 종로구 안국역_2,752,303,449
2014,4,D,발달상권,1001235,서울 종로구 안국역_1,11962,9905,2057
2014,4,D,발달상권,1001234,서울 종로구 경복궁역_1,214,90,124
2014,4,D,발달상권,1001233,서울 종로구 종로3가역_3,2958,1684,1274
2014,4,D,발달상권,1001232,서울 종로구 종로3가역_2,1916,1042,874
2014,4,D,발달상권,1001231,서울 동대문구 신설동역_2,4043,2102,1941
2014,4,D,발달상권,1001230,인사동,22204,14049,8155
2014,4,D,발달상권,1001229,서울 종로구 종로5가역_4,644,348,296
2014,4,D,발달상권,1001228,서울 종로구 종로5가역_3,5223,3557,1666
2014,4,D,발달상권,1001227,종로구청,15214,9123,6091
2014,4,D,발달상권,1001226,서울 종로구 종로5가역_2,14629,9310,5319
2014,4,D,발달상권,1001225,신설동역,685,426,259
2014,4,D,발달상권,1001224,서울 동대문구 신설동역_1,2,2,0
2014,4,D,발달상권,1001223,서울 종로구 광화문역_2,51504,32594,18910
2014,4,D,발달상권,1001222,동묘앞역,59,40,19
2014,4,D,발달상권,1001221,장안동사거리,502,259,243
2014,4,D,발달상권,1001220,서울 종로구 동대문역_2,820,499,321
2014,4,D,발달상권,1001218,동대문시장_2,486,313,173
2014,4,D,발달상권,1001217,서울 종로구 종로5가역_1,50,34,16
2014,4,D,발달상권,1001216,서울 종로구 종로3가역_1,3399,1515,1884
2014,4,D,발달상권,1001215,서울 종로구 광화문역_1,2592,1821,771
2014,4,D,발달상권,1001214,종각역,20899,13920,6979
2014,4,D,발달상권,1001213,종각역 젊음의 거리,1784,905,879
2014,4,D,발달상권,1001212,서대문구 서대문역_1,2610,858,1752
2014,4,D,발달상권,1001211,동대문시장_1,464,241,223
2014,4,D,발달상권,1001210,시청역_2,24728,15662,9066
2014,4,D,발달상권,1001209,서울시청,27317,12857,14460
2014,4,D,발달상권,1001208,서울 중구 을지로3가역_2,8607,5557,3050
2014,4,D,발달상권,1001207,서울 중구 신당역_2,1141,609,532
2014,4,D,발달상권,1001206,서대문구 서대문역_2,2129,1463,666
2014,4,D,발달상권,1001205,동대문역사문화공원역,4423,2822,1601
2014,4,D,발달상권,1001204,서울 중구 을지로3가역_1,14987,10348,4639
2014,4,D,발달상권,1001203,명동거리,17364,8956,8408
2014,4,D,발달상권,1001202,롯데백화점,56472,30865,25607
2014,4,D,발달상권,1001201,서울 중구 신당역_1,1092,713,379
2014,4,D,발달상권,1001200,북창동,7491,4768,2723
2014,4,D,발달상권,1001199,서울 중구 충무로역_2,16622,7546,9076
2014,4,D,발달상권,1001198,서울 강서구 송정역,641,452,189
2014,4,D,발달상권,1001197,장한평역_2,12566,10118,2448
2014,4,D,발달상권,1001196,시청역_1,60507,36373,24134
2014,4,D,발달상권,1001195,왕십리역_2,807,411,396
2014,4,D,발달상권,1001194,서울 강서구 발산역,693,463,230
2014,4,D,발달상권,1001193,장한평역_1,2557,1712,845
2014,4,D,발달상권,1001192,서울 중구 충무로역_1,3077,2068,1009
2014,4,D,발달상권,1001190,장한평역,2166,1471,695
2014,4,D,발달상권,1001189,서울 중구 명동역,2870,1326,1544
2014,4,D,발달상권,1001188,장충동 족발거리,203,94,109
2014,4,D,발달상권,1001187,한양시장,218,114,104
2014,4,D,발달상권,1001186,서울 서대문구 이대역,1261,502,759
2014,4,D,발달상권,1001185,서울 서대문구 신촌역,2544,1056,1488
2014,4,D,발달상권,1001184,서울 마포구 홍대입구역_3,956,728,228
2014,4,D,발달상권,1001183,서울 마포구 홍대입구역_2,2859,1333,1526
2014,4,D,발달상권,1001182,홍익대학교 주변,16634,8220,8414
2014,4,D,발달상권,1001181,서울 광진구 군자역,163,101,62
2014,4,D,발달상권,1001180,신촌역,249,133,116
2014,4,D,발달상권,1001179,강서구청,3549,2461,1088
2014,4,D,발달상권,1001178,서울 마포구 홍대입구역_1,755,445,310
2014,4,D,발달상권,1001175,서울 강동구 고덕역,471,273,198
2014,4,D,발달상권,1001173,서울 강동구 명일역,911,368,543
2014,4,D,발달상권,1001172,어린이대공원역,99,63,36
2014,4,D,발달상권,1001171,서울 마포구 공덕역_2,4024,2429,1595
2014,4,D,발달상권,1001170,공덕역,6018,3923,2095
2014,4,D,발달상권,1001169,서울 용산구 숙대입구역,4037,2855,1182
2014,4,D,발달상권,1001168,남영역,14742,6874,7868
2014,4,D,발달상권,1001167,서울 마포구 공덕역_1,4110,2028,2082
2014,4,D,발달상권,1001166,서울 마포구 마포역_2,1027,598,429
2014,4,D,발달상권,1001165,서울 광진구 건대입구역_2,2593,911,1682
2014,4,D,발달상권,1001164,서울 마포구 마포역_1,9995,6304,3691
2014,4,D,발달상권,1001163,서울 강동구 천호역_2,3592,1765,1827
2014,4,D,발달상권,1001162,서울 광진구 건대입구역_1,929,476,453
2014,4,D,발달상권,1001161,건대입구역,761,426,335
2014,4,D,발달상권,1001160,서울 광진구 구의역,1239,796,443
2014,4,D,발달상권,1001159,서울 강동구 천호역,915,422,493
2014,4,D,발달상권,1001158,당산역_2,5156,3143,2013
2014,4,D,발달상권,1001156,서울 강동구 길동역,1753,1089,664
2014,4,D,발달상권,1001155,용산 전자상가_5,2148,1643,505
2014,4,D,발달상권,1001153,당산역_1,1185,764,421
2014,4,D,발달상권,1001152,서울 광진구 강변역,2105,1732,373
2014,4,D,발달상권,1001151,용산 전자상가_3,2545,1898,647
2014,4,D,발달상권,1001150,서울 용산구 이태원역,815,485,330
2014,4,D,발달상권,1001149,한남오거리,622,345,277
2014,4,D,발달상권,1001147,용산 전자상가_2,434,351,83
2014,4,D,발달상권,1001146,용산구청,66,37,29
2014,4,D,발달상권,1001145,용산 전자상가_1,8579,6561,2018
2014,4,D,발달상권,1001144,국회의사당역_2,38680,21694,16986
2014,4,D,발달상권,1001143,서울 용산구 신용산역,301,120,181
2014,4,D,발달상권,1001142,국회의사당역_1,5636,4401,1235
2014,4,D,발달상권,1001141,압구정 로데오거리_2,13442,5633,7809
2014,4,D,발달상권,1001140,서울 강남구 압구정역,9601,4532,5069
2014,4,D,발달상권,1001139,서울 영등포구 영등포구청역,4439,1339,3100
2014,4,D,발달상권,1001138,압구정 로데오거리_1,7547,2409,5138
2014,4,D,발달상권,1001137,서울 강동구 둔촌동역,70,31,39
2014,4,D,발달상권,1001136,오목교역,246,127,119
2014,4,D,발달상권,1001135,신사동 가로수길,20872,9829,11043
2014,4,D,발달상권,1001134,서울 영등포구 여의도역_2,44703,29872,14831
2014,4,D,발달상권,1001133,청담사거리_3,1298,428,870
2014,4,D,발달상권,1001132,영등포유통상가,1762,1213,549
2014,4,D,발달상권,1001131,청담역_2,1739,1351,388
2014,4,D,발달상권,1001130,청담역_1,190,152,38
2014,4,D,발달상권,1001129,청담사거리_2,1035,827,208
2014,4,D,발달상권,1001127,서울 영등포구 여의도역_1,53647,32572,21075
2014,4,D,발달상권,1001125,학동사거리_2,2787,1631,1156
2014,4,D,발달상권,1001124,서울 영등포구 영등포시장역,350,288,62
2014,4,D,발달상권,1001123,학동사거리_1,3989,2068,1921
2014,4,D,발달상권,1001122,여의도 시범아파트앞,2382,1586,796
2014,4,D,발달상권,1001121,영등포역_3,819,500,319
2014,4,D,발달상권,1001120,도산공원사거리_1,10547,6716,3831
2014,4,D,발달상권,1001119,영등포역_2,1092,630,462
2014,4,D,발달상권,1001118,문래동 주민센터,65,54,11
2014,4,D,발달상권,1001117,강남구 신사역_2,7392,5035,2357
2014,4,D,발달상권,1001115,서울 강남구 강남구청역_2,3847,2363,1484
2014,4,D,발달상권,1001114,강남구 신사역_1,2577,1169,1408
2014,4,D,발달상권,1001113,서울 동작구 노량진1동_1,96,42,54
2014,4,D,발달상권,1001112,서울 강남구 학동역_3,7941,4662,3279
2014,4,D,발달상권,1001111,서울 강남구 강남구청역_1,2799,1689,1110
2014,4,D,발달상권,1001110,잠실역,5399,4272,1127
2014,4,D,발달상권,1001109,강남구 논현역_4,8259,3792,4467
2014,4,D,발달상권,1001108,학동역,863,428,435
2014,4,D,발달상권,1001107,방이동 먹자골목,5740,3905,1835
2014,4,D,발달상권,1001106,서울 강남구 학동역_2,5745,2787,2958
2014,4,D,발달상권,1001105,서울 동작구 노량진역,3479,2056,1423
2014,4,D,발달상권,1001104,삼성역_3,8612,4738,3874
2014,4,D,발달상권,1001103,코엑스,20221,11888,8333
2014,4,D,발달상권,1001102,서울 강남구 학동역_1,5812,3565,2247
2014,4,D,발달상권,1001101,선정릉역_2,6176,3798,2378
2014,4,D,발달상권,1001100,강남구 논현역_3,1563,846,717
2014,4,D,발달상권,1001099,포스코사거리_2,7764,4758,3006
2014,4,D,발달상권,1001098,포스코사거리_1,49635,33021,16614
2014,4,D,발달상권,1001097,잠실역 롯데월드,3123,1518,1605
2014,4,D,발달상권,1001096,신도림역,3750,2007,1743
2014,4,D,발달상권,1001095,강남구 논현역_2,7683,3579,4104
2014,4,D,발달상권,1001094,선정릉역_1,1391,949,442
2014,4,D,발달상권,1001093,신천역,5826,3236,2590
2014,4,D,발달상권,1001092,강남구 논현역_1,3020,1941,1079
2014,4,D,발달상권,1001091,삼성역_2,18025,10706,7319
2014,4,D,발달상권,1001090,삼정역_2,2549,1137,1412
2014,4,D,발달상권,1001089,삼정역_1,3053,1666,1387
2014,4,D,발달상권,1001088,삼성역_1,27273,17706,9567
2014,4,D,발달상권,1001087,서울 강남구 선릉역_2,6715,4258,2457
2014,4,D,발달상권,1001086,고속터미널역,14888,4711,10177
2014,4,D,발달상권,1001085,서울 서초구 강남역,31691,17992,13699
2014,4,D,발달상권,1001084,서울 강남구 선릉역_1,19913,9118,10795
2014,4,D,발달상권,1001082,선릉역_2,20075,10943,9132
2014,4,D,발달상권,1001081,서울 강남구 역삼역_2,26587,21017,5570
2014,4,D,발달상권,1001080,서울 송파구 석촌역_1,39,26,13
2014,4,D,발달상권,1001078,서울 강남구 강남역_2,6501,4134,2367
2014,4,D,발달상권,1001077,선릉역_1,55794,29104,26690
2014,4,D,발달상권,1001076,구로역,159,90,69
2014,4,D,발달상권,1001075,역삼역_2,4222,2356,1866
2014,4,D,발달상권,1001074,대림역_2,6710,5211,1499
2014,4,D,발달상권,1001073,서울 강남구 역삼역_1,25306,15913,9393
2014,4,D,발달상권,1001072,신대방삼거리역,281,158,123
2014,4,D,발달상권,1001071,서울 강남구 한티역,1228,472,756
2014,4,D,발달상권,1001070,은마아파트입구사거리_4,64,36,28
2014,4,D,발달상권,1001067,오류동역,1287,695,592
2014,4,D,발달상권,1001066,서울 강남구 강남역,39828,18763,21065
2014,4,D,발달상권,1001063,교대역_4,4449,2599,1850
2014,4,D,발달상권,1001062,서울 강남구 강남역_1,137569,100157,37412
2014,4,D,발달상권,1001061,방배동카페골목,94,37,57
2014,4,D,발달상권,1001060,가락시장,15202,9877,5325
2014,4,D,발달상권,1001059,교대역_3,4476,2802,1674
2014,4,D,발달상권,1001058,역삼역_1,1643,923,720
2014,4,D,발달상권,1001057,교대역_2,3170,2031,1139
2014,4,D,발달상권,1001056,서울 송파구 가락시장역,5173,3309,1864
2014,4,D,발달상권,1001055,서울 서초구 서초역,11116,4771,6345
2014,4,D,발달상권,1001054,서울 강남구 대치역_2,1317,835,482
2014,4,D,발달상권,1001052,뱅뱅사거리_2,24958,15499,9459
2014,4,D,발달상권,1001051,보라매공원,14400,8379,6021
2014,4,D,발달상권,1001050,교대역_1,13457,7785,5672
2014,4,D,발달상권,1001049,개봉동 현대아파트 인근,166,86,80
2014,4,D,발달상권,1001048,뱅뱅사거리,10173,7139,3034
2014,4,D,발달상권,1001047,뱅뱅사거리_1,9338,6677,2661
2014,4,D,발달상권,1001046,서울 관악구 신림역_4,855,429,426
2014,4,D,발달상권,1001045,동작구 총신대입구역_1,245,128,117
2014,4,D,발달상권,1001044,양재역_3,3267,2264,1003
2014,4,D,발달상권,1001043,동작구 총신대입구역_2,1129,580,549
2014,4,D,발달상권,1001042,서울 서초구 남부터미널역_3,1667,1003,664
2014,4,D,발달상권,1001041,서울 강남구 수서역,18539,10863,7676
2014,4,D,발달상권,1001039,서울 서초구 남부터미널역_2,9872,5113,4759
2014,4,D,발달상권,1001038,구로디지탈1단지,64034,42207,21827
2014,4,D,발달상권,1001037,양재역,138,74,64
2014,4,D,발달상권,1001035,매봉역,298,153,145
2014,4,D,발달상권,1001034,서울 서초구 방배역,4018,2386,1632
2014,4,D,발달상권,1001033,서울 서초구 남부터미널역_1,692,488,204
2014,4,D,발달상권,1001032,서울 관악구 신림역_2,27,13,14
2014,4,D,발달상권,1001031,서울 관악구 신림역_1,1715,822,893
2014,4,D,발달상권,1001030,양재역_2,8352,4652,3700
2014,4,D,발달상권,1001029,양재역_1,859,580,279
2014,4,D,발달상권,1001028,서울 관악구 서울대입구역_2,40,3,37
2014,4,D,발달상권,1001027,가산디지털단지역_3,28758,17451,11307
2014,4,D,발달상권,1001026,구로디지털단지역,2625,1781,844
2014,4,D,발달상권,1001025,서울 관악구 서울대입구역_1,1854,820,1034
2014,4,D,발달상권,1001024,관악구 사당역_1,3768,1635,2133
2014,4,D,발달상권,1001023,가산디지털단지역_2,56775,34252,22523
2014,4,D,발달상권,1001022,관악구 사당역_2,413,201,212
2014,4,D,발달상권,1001021,가산디지털단지역_1,24703,16670,8033
2014,4,D,발달상권,1001020,장지역,3724,2353,1371
2014,4,D,발달상권,1001019,포이사거리_1,5713,3053,2660
2014,4,D,발달상권,1001018,포이사거리_2,7681,5038,2643
2014,4,D,발달상권,1001016,서울 관악구 대학동_1,72,45,27
2014,4,D,발달상권,1001015,서울 금천구 독산1동_1,2638,1920,718
2014,4,D,발달상권,1001013,양재 화물트럭터미널앞_2,204,93,111
2014,4,D,발달상권,1001012,양재 화물트럭터미널앞_1,4406,3418,988
2014,4,D,발달상권,1001011,서울 금천구 시흥1동_4,914,459,455
2014,4,A,골목상권,1001010,풍성로37가길,38,18,20
2014,4,A,골목상권,1001009,천호옛길,559,390,169
2014,4,A,골목상권,1001008,천호옛14길,597,290,307
2014,4,A,골목상권,1001007,천호대로219길,872,513,359
2014,4,A,골목상권,1001006,천호대로197길,22,8,14
2014,4,A,골목상권,1001005,천호대로187길,781,480,301
2014,4,A,골목상권,1001004,천호대로170길,385,151,234
2014,4,A,골목상권,1001003,천호대로162길,913,660,253
2014,4,A,골목상권,1001002,천중로51길,393,213,180
2014,4,A,골목상권,1001001,천중로39길,642,238,404
2014,4,A,골목상권,1001000,진황도로47길,1090,585,505
2014,4,A,골목상권,1000999,진황도로27길,400,237,163
2014,4,A,골목상권,1000998,올림픽로98길,34,17,17
2014,4,A,골목상권,1000995,올림픽로77길,8,4,4
2014,4,A,골목상권,1000994,올림픽로71길,235,164,71
2014,4,A,골목상권,1000993,올림픽로48길,5558,3416,2142
2014,4,A,골목상권,1000992,양재대로96길,1325,794,531
2014,4,A,골목상권,1000991,양재대로95길,593,327,266
2014,4,A,골목상권,1000990,양재대로91길,1017,554,463
2014,4,A,골목상권,1000989,양재대로133길,257,100,157
2014,4,A,골목상권,1000988,양재대로124길,554,342,212
2014,4,A,골목상권,1000987,양재대로116길,196,84,112
2014,4,A,골목상권,1000986,양재대로101길,1294,750,544
2014,4,A,골목상권,1000985,암사길,361,153,208
2014,4,A,골목상권,1000984,성안로3길,1308,768,540
2014,4,A,골목상권,1000983,성내로5길,952,526,426
2014,4,A,골목상권,1000982,상일로5길,40,24,16
2014,4,A,골목상권,1000981,상암로5길,451,215,236
2014,4,A,골목상권,1000980,상암로51길,704,310,394
2014,4,A,골목상권,1000979,상암로4길,207,163,44
2014,4,A,골목상권,1000978,상암로14길,397,233,164
2014,4,A,골목상권,1000977,명일로13길,120,54,66
2014,4,A,골목상권,1000976,동남로85길,131,72,59
2014,4,A,골목상권,1000975,동남로82길,9,4,5
2014,4,A,골목상권,1000974,동남로65길,85,30,55
2014,4,A,골목상권,1000973,구천면로42길,359,176,183
2014,4,A,골목상권,1000972,구천면로41길,577,252,325
2014,4,A,골목상권,1000971,구천면로36길,36,19,17
2014,4,A,골목상권,1000969,고덕로25길,4,2,2
2014,4,A,골목상권,1000968,고덕로10길,152,73,79
2014,4,A,골목상권,1000967,강동대로53길,805,455,350
2014,4,A,골목상권,1000966,풍성로25길,1034,390,644
2014,4,A,골목상권,1000965,오금로46길,1372,708,664
2014,4,A,골목상권,1000964,오금로36길,1626,1297,329
2014,4,A,골목상권,1000963,오금로11길,2355,1556,799
2014,4,A,골목상권,1000962,양재대로72길,626,343,283
2014,4,A,골목상권,1000961,양재대로71길,1049,657,392
2014,4,A,골목상권,1000960,양재대로64길,1543,651,892
2014,4,A,골목상권,1000959,양재대로62길,5347,3258,2089
2014,4,A,골목상권,1000958,송파대로30길,1618,1041,577
2014,4,A,골목상권,1000957,송이로36길,1928,1398,530
2014,4,A,골목상권,1000956,송이로32길,747,412,335
2014,4,A,골목상권,1000955,송이로23길,1756,991,765
2014,4,A,골목상권,1000954,삼전로13길,1693,1007,686
2014,4,A,골목상권,1000953,백제고분로50길,3318,1625,1693
2014,4,A,골목상권,1000952,백제고분로46길,1576,1014,562
2014,4,A,골목상권,1000951,백제고분로45길,467,316,151
2014,4,A,골목상권,1000950,백제고분로42길,214,163,51
2014,4,A,골목상권,1000949,백제고분로39길,1211,918,293
2014,4,A,골목상권,1000948,백제고분로34길,1572,1031,541
2014,4,A,골목상권,1000947,백제고분로33길,807,500,307
2014,4,A,골목상권,1000946,백제고분로32길,1061,473,588
2014,4,A,골목상권,1000945,백제고분로31길,298,192,106
2014,4,A,골목상권,1000944,백제고분로22길,1071,628,443
2014,4,A,골목상권,1000943,백제고분로21길,200,137,63
2014,4,A,골목상권,1000942,마천로51길,119,46,73
2014,4,A,골목상권,1000941,동남로20길,173,95,78
2014,4,A,골목상권,1000940,거마로20길,361,162,199
2014,4,A,골목상권,1000939,학동로77길,2908,1547,1361
2014,4,A,골목상권,1000938,학동로6길,1950,1056,894
2014,4,A,골목상권,1000937,학동로56길,979,599,380
2014,4,A,골목상권,1000936,학동로38길,6847,4556,2291
2014,4,A,골목상권,1000935,테헤란로81길,556,131,425
2014,4,A,골목상권,1000934,일원로9길,491,265,226
2014,4,A,골목상권,1000933,일원로3길,228,103,125
2014,4,A,골목상권,1000932,영동대로65길,2938,1785,1153
2014,4,A,골목상권,1000931,영동대로112길,648,464,184
2014,4,A,골목상권,1000930,언주로81길,8337,3850,4487
2014,4,A,골목상권,1000929,압구정로2길,2863,1599,1264
2014,4,A,골목상권,1000928,선릉로18길,512,311,201
2014,4,A,골목상권,1000927,선릉로146길,1771,962,809
2014,4,A,골목상권,1000926,선릉로133길,150,80,70
2014,4,A,골목상권,1000925,선릉로132길,964,506,458
2014,4,A,골목상권,1000924,선릉로121길,2002,1048,954
2014,4,A,골목상권,1000923,삼성로75길,2581,1382,1199
2014,4,A,골목상권,1000922,삼성로69길,261,139,122
2014,4,A,골목상권,1000921,삼성로64길,563,300,263
2014,4,A,골목상권,1000920,삼성로63길,157,80,77
2014,4,A,골목상권,1000919,삼성로57길,892,286,606
2014,4,A,골목상권,1000918,삼성로147길,973,413,560
2014,4,A,골목상권,1000917,삼성로115길,323,200,123
2014,4,A,골목상권,1000916,봉은사로68길,205,98,107
2014,4,A,골목상권,1000915,봉은사로57길,570,399,171
2014,4,A,골목상권,1000914,봉은사로43길,980,607,373
2014,4,A,골목상권,1000913,봉은사로29길,152,106,46
2014,4,A,골목상권,1000912,봉은사로109길,296,173,123
2014,4,A,골목상권,1000911,도산대로89길,2362,959,1403
2014,4,A,골목상권,1000910,도산대로81길,4366,1461,2905
2014,4,A,골목상권,1000909,도산대로50길,2784,2120,664
2014,4,A,골목상권,1000908,도산대로38길,183,104,79
2014,4,A,골목상권,1000907,도산대로30길,2890,1395,1495
2014,4,A,골목상권,1000906,도산대로23길,1211,743,468
2014,4,A,골목상권,1000905,도산대로15길,1941,931,1010
2014,4,A,골목상권,1000904,도곡로37길,3222,2145,1077
2014,4,A,골목상권,1000903,논현로8길,766,411,355
2014,4,A,골목상권,1000902,논현로63길,9193,2592,6601
2014,4,A,골목상권,1000901,논현로28길,12605,9231,3374
2014,4,A,골목상권,1000900,논현로26길,6233,3911,2322
2014,4,A,골목상권,1000898,논현로139길,1814,1058,756
2014,4,A,골목상권,1000897,논현로123길,104,62,42
2014,4,A,골목상권,1000896,논현로115길,3447,2020,1427
2014,4,A,골목상권,1000895,논현로10길,2254,1448,806
2014,4,A,골목상권,1000894,논현로106길,2940,1582,1358
2014,4,A,골목상권,1000893,남부순환로365길,198,151,47
2014,4,A,골목상권,1000891,개포로28길,315,234,81
2014,4,A,골목상권,1000890,개포로20길,4241,2386,1855
2014,4,A,골목상권,1000889,개포로17길,3350,2000,1350
2014,4,A,골목상권,1000888,강남대로140길,4115,2275,1840
2014,4,A,골목상권,1000887,강남대로136길,1242,729,513
2014,4,A,골목상권,1000886,강남대로118길,591,332,259
2014,4,A,골목상권,1000885,서초중앙로8길,5997,4563,1434
2014,4,A,골목상권,1000884,방배중앙로21길,2083,800,1283
2014,4,A,골목상권,1000883,효령로72길,188,108,80
2014,4,A,골목상권,1000882,효령로34길,73,26,47
2014,4,A,골목상권,1000881,효령로31길,1345,842,503
2014,4,A,골목상권,1000880,효령로23길,678,426,252
2014,4,A,골목상권,1000879,청두곶길,2049,1471,578
2014,4,A,골목상권,1000878,주흥길,348,227,121
2014,4,A,골목상권,1000877,주흥15길,1484,960,524
2014,4,A,골목상권,1000876,언남길,1943,1442,501
2014,4,A,골목상권,1000875,신반포로45길,427,276,151
2014,4,A,골목상권,1000874,서초대로8길,253,168,85
2014,4,A,골목상권,1000873,서초대로64길,508,348,160
2014,4,A,골목상권,1000872,서초대로4길,809,582,227
2014,4,A,골목상권,1000871,서초대로25길,3646,2252,1394
2014,4,A,골목상권,1000870,서초대로23길,989,499,490
2014,4,A,골목상권,1000869,서초대로15길,1085,499,586
2014,4,A,골목상권,1000868,사평대로57길,201,87,114
2014,4,A,골목상권,1000867,사평대로26길,15,10,5
2014,4,A,골목상권,1000866,사평대로22길,1239,691,548
2014,4,A,골목상권,1000865,사임당로17길,1513,983,530
2014,4,A,골목상권,1000864,방배로42길,206,105,101
2014,4,A,골목상권,1000863,방배로35길,2186,1410,776
2014,4,A,골목상권,1000862,방배로18길,76,39,37
2014,4,A,골목상권,1000861,반포대로9길,700,494,206
2014,4,A,골목상권,1000860,바우뫼로39길,3210,2005,1205
2014,4,A,골목상권,1000859,마방로2길,3571,2329,1242
2014,4,A,골목상권,1000858,방배천로4안길,1687,1015,672
2014,4,A,골목상권,1000857,동산로19길,1414,968,446
2014,4,A,골목상권,1000856,동산로10길,2104,1232,872
2014,4,A,골목상권,1000855,동광로39길,45,27,18
2014,4,A,골목상권,1000854,동광로1길,1370,791,579
2014,4,A,골목상권,1000853,동광로12길,704,476,228
2014,4,A,골목상권,1000852,논현로27길,3580,2596,984
2014,4,A,골목상권,1000851,논현로1길,569,342,227
2014,4,A,골목상권,1000850,남부순환로339길,11844,5467,6377
2014,4,A,골목상권,1000849,남부순환로325길,7798,4195,3603
2014,4,A,골목상권,1000848,남부순환로317길,1656,1259,397
2014,4,A,골목상권,1000847,고무래로8길,6372,3495,2877
2014,4,A,골목상권,1000846,강남대로8길,3076,2063,1013
2014,4,A,골목상권,1000845,강남대로34길,929,643,286
2014,4,A,골목상권,1000844,강남대로23길,6442,4856,1586
2014,4,A,골목상권,1000843,소담길,28,8,20
2014,4,A,골목상권,1000842,원신길,276,116,160
2014,4,A,골목상권,1000840,양산길,460,333,127
2014,4,A,골목상권,1000839,호암로24길,560,216,344
2014,4,A,골목상권,1000838,호암로20길,41,26,15
2014,4,A,골목상권,1000837,행운길,87,54,33
2014,4,A,골목상권,1000836,행운1길,60,40,20
2014,4,A,골목상권,1000835,청림3길,30,18,12
2014,4,A,골목상권,1000834,청룡길,141,63,78
2014,4,A,골목상권,1000833,청룡8길,11,7,4
2014,4,A,골목상권,1000832,중앙길,303,102,201
2014,4,A,골목상권,1000831,조원중앙로2길,1108,767,341
2014,4,A,골목상권,1000830,조원로18길,964,484,480
2014,4,A,골목상권,1000829,조원로10길,252,116,136
2014,4,A,골목상권,1000828,장군봉2길,335,136,199
2014,4,A,골목상권,1000827,장군봉1길,96,15,81
2014,4,A,골목상권,1000826,인헌길,86,42,44
2014,4,A,골목상권,1000825,은천로25길,295,104,191
2014,4,A,골목상권,1000824,양녕로6길,814,515,299
2014,4,A,골목상권,1000823,신원로3길,15,12,3
2014,4,A,골목상권,1000822,신사로20길,52,27,25
2014,4,A,골목상권,1000820,신림로64길,205,113,92
2014,4,A,골목상권,1000819,신림로48길,82,48,34
2014,4,A,골목상권,1000818,신림로38길,50,23,27
2014,4,A,골목상권,1000817,신림로28길,302,211,91
2014,4,A,골목상권,1000816,신림로11길,458,424,34
2014,4,A,골목상권,1000815,신림동길,443,271,172
2014,4,A,골목상권,1000814,승방길,497,317,180
2014,4,A,골목상권,1000813,서림7길,239,90,149
2014,4,A,골목상권,1000812,봉천로33길,423,279,144
2014,4,A,골목상권,1000811,봉천로13길,201,62,139
2014,4,A,골목상권,1000810,복은길,178,61,117
2014,4,A,골목상권,1000808,법원단지9길,70,29,41
2014,4,A,골목상권,1000807,미성5길,51,26,25
2014,4,A,골목상권,1000806,대학길,59,30,29
2014,4,A,골목상권,1000805,대학14길,11,2,9
2014,4,A,골목상권,1000804,당곡길,329,154,175
2014,4,A,골목상권,1000803,남현길,233,80,153
2014,4,A,골목상권,1000802,남현3길,600,353,247
2014,4,A,골목상권,1000800,남부순환로248길,248,125,123
2014,4,A,골목상권,1000799,남부순환로234길,136,90,46
2014,4,A,골목상권,1000798,남부순환로172길,1631,911,720
2014,4,A,골목상권,1000797,남부순환로161길,16,4,12
2014,4,A,골목상권,1000796,남부순환로151길,169,96,73
2014,4,A,골목상권,1000795,남부순환로142길,77,28,49
2014,4,A,골목상권,1000794,난향길,165,43,122
2014,4,A,골목상권,1000793,난우길,460,204,256
2014,4,A,골목상권,1000792,난곡로74길,165,65,100
2014,4,A,골목상권,1000791,난곡로34길,31,11,20
2014,4,A,골목상권,1000790,난곡로26길,103,55,48
2014,4,A,골목상권,1000789,난곡로24길,31,15,16
2014,4,A,골목상권,1000788,낙성대역길,765,490,275
2014,4,A,골목상권,1000787,국회단지길,499,230,269
2014,4,A,골목상권,1000786,구암길,71,26,45
2014,4,A,골목상권,1000785,관천로22길,15,5,10
2014,4,A,골목상권,1000784,관천로15길,132,73,59
2014,4,A,골목상권,1000783,관악로30길,186,62,124
2014,4,A,골목상권,1000782,관악로28길,146,69,77
2014,4,A,골목상권,1000781,관악로14길,493,280,213
2014,4,A,골목상권,1000780,관악로10길,256,186,70
2014,4,A,골목상권,1000779,흑석로9길,169,72,97
2014,4,A,골목상권,1000778,흑석로13길,165,23,142
2014,4,A,골목상권,1000777,장승배기로27길,31,17,14
2014,4,A,골목상권,1000776,장승배기로19길,3,3,0
2014,4,A,골목상권,1000774,여의대방로46길,356,93,263
2014,4,A,골목상권,1000773,여의대방로24길,13869,6183,7686
2014,4,A,골목상권,1000772,여의대방로22카길,261,107,154
2014,4,A,골목상권,1000771,여의대방로22나길,149,56,93
2014,4,A,골목상권,1000770,여의대방로22길,235,115,120
2014,4,A,골목상권,1000769,양녕로26길,127,68,59
2014,4,A,골목상권,1000768,신대방길,112,70,42
2014,4,A,골목상권,1000766,성대로1길,365,151,214
2014,4,A,골목상권,1000765,서달로8가길,194,83,111
2014,4,A,골목상권,1000763,서달로14길,54,21,33
2014,4,A,골목상권,1000762,서달로10길,76,33,43
2014,4,A,골목상권,1000761,상도로62길,182,72,110
2014,4,A,골목상권,1000760,상도로61길,90,39,51
2014,4,A,골목상권,1000759,상도로47길,68,47,21
2014,4,A,골목상권,1000758,상도로37길,1897,980,917
2014,4,A,골목상권,1000757,상도로15길,301,130,171
2014,4,A,골목상권,1000756,사당로8길,126,63,63
2014,4,A,골목상권,1000755,사당로30길,327,221,106
2014,4,A,골목상권,1000754,사당로2차길,89,55,34
2014,4,A,골목상권,1000753,사당로29길,17,14,3
2014,4,A,골목상권,1000752,사당로26길,251,141,110
2014,4,A,골목상권,1000751,사당로23나길,137,45,92
2014,4,A,골목상권,1000750,사당로23길,15,10,5
2014,4,A,골목상권,1000749,사당로20길,160,112,48
2014,4,A,골목상권,1000748,사당로16길,127,41,86
2014,4,A,골목상권,1000747,사당로16가길,766,504,262
2014,4,A,골목상권,1000746,만양로8길,60,24,36
2014,4,A,골목상권,1000745,만양로14길,438,198,240
2014,4,A,골목상권,1000744,등용로14길,574,441,133
2014,4,A,골목상권,1000743,동작대로7길,1613,705,908
2014,4,A,골목상권,1000742,동작대로35길,265,96,169
2014,4,A,골목상권,1000741,동작대로33길,102,53,49
2014,4,A,골목상권,1000740,동작대로29길,39,21,18
2014,4,A,골목상권,1000739,동작대로17길,1329,741,588
2014,4,A,골목상권,1000738,대방동2길,461,223,238
2014,4,A,골목상권,1000737,대방동27길,109,59,50
2014,4,A,골목상권,1000736,노량진로6길,114,30,84
2014,4,A,골목상권,1000735,국사봉길,30,1,29
2014,4,A,골목상권,1000734,국사봉2길,104,70,34
2014,4,A,골목상권,1000733,국사봉1길,6,1,5
2014,4,A,골목상권,1000732,영신로9길,236,125,111
2014,4,A,골목상권,1000731,영등포로84길,313,86,227
2014,4,A,골목상권,1000730,영등포로80길,69,48,21
2014,4,A,골목상권,1000729,영등포로62길,2,1,1
2014,4,A,골목상권,1000728,영등포로35길,63,46,17
2014,4,A,골목상권,1000727,영등포로27길,348,211,137
2014,4,A,골목상권,1000724,여의대방로43나길,2367,1826,541
2014,4,A,골목상권,1000723,여의대방로39길,14,10,4
2014,4,A,골목상권,1000722,여의대방로35길,739,397,342
2014,4,A,골목상권,1000721,양평로28길,667,536,131
2014,4,A,골목상권,1000720,양평로22라길,43,31,12
2014,4,A,골목상권,1000719,양평로19길,875,596,279
2014,4,A,골목상권,1000718,신길로60길,433,184,249
2014,4,A,골목상권,1000717,신길로42길,398,214,184
2014,4,A,골목상권,1000716,신길로42가길,93,27,66
2014,4,A,골목상권,1000715,신길로39길,91,49,42
2014,4,A,골목상권,1000714,신길로17길,44,30,14
2014,4,A,골목상권,1000713,선유서로28길,413,215,198
2014,4,A,골목상권,1000712,선유서로25길,2143,1552,591
2014,4,A,골목상권,1000711,선유서로24길,176,99,77
2014,4,A,골목상권,1000710,선유로55길,2190,1390,800
2014,4,A,골목상권,1000709,디지털로74길,54,34,20
2014,4,A,골목상권,1000708,디지털로57길,7,1,6
2014,4,A,골목상권,1000707,디지털로37길,183,82,101
2014,4,A,골목상권,1000706,도신로62길,198,47,151
2014,4,A,골목상권,1000705,도신로60길,87,14,73
2014,4,A,골목상권,1000704,도신로29길,84,44,40
2014,4,A,골목상권,1000703,도신로15길,94,54,40
2014,4,A,골목상권,1000702,도림천로21길,112,55,57
2014,4,A,골목상권,1000701,도림로63길,31,21,10
2014,4,A,골목상권,1000700,도림로147길,1628,1201,427
2014,4,A,골목상권,1000699,도림로112길,8,7,1
2014,4,A,골목상권,1000698,대림로8길,1862,653,1209
2014,4,A,골목상권,1000697,대림로7길,14,5,9
2014,4,A,골목상권,1000696,대림로44길,36,21,15
2014,4,A,골목상권,1000695,대림로34길,190,71,119
2014,4,A,골목상권,1000694,대림로31길,841,442,399
2014,4,A,골목상권,1000693,대림로29길,1571,772,799
2014,4,A,골목상권,1000692,대림로22길,299,164,135
2014,4,A,골목상권,1000691,당산로46길,3789,2213,1576
2014,4,A,골목상권,1000690,당산로38길,330,268,62
2014,4,A,골목상권,1000689,당산로37길,3452,2170,1282
2014,4,A,골목상권,1000688,당산로31길,3959,2257,1702
2014,4,A,골목상권,1000687,국회대로56길,1633,1056,577
2014,4,A,골목상권,1000686,경인로90길,312,191,121
2014,4,A,골목상권,1000685,경인로80길,1632,1195,437
2014,4,A,골목상권,1000684,경인로77길,572,433,139
2014,4,A,골목상권,1000683,가마산로61길,199,84,115
2014,4,A,골목상권,1000682,시흥대로94길,749,410,339
2014,4,A,골목상권,1000681,시흥대로84길,173,68,105
2014,4,A,골목상권,1000680,시흥대로68길,396,134,262
2014,4,A,골목상권,1000679,시흥대로63길,2529,1348,1181
2014,4,A,골목상권,1000678,시흥대로62가길,427,110,317
2014,4,A,골목상권,1000677,시흥대로36길,342,227,115
2014,4,A,골목상권,1000676,시흥대로22길,459,331,128
2014,4,A,골목상권,1000675,시흥대로153길,655,360,295
2014,4,A,골목상권,1000674,시흥대로150길,564,274,290
2014,4,A,골목상권,1000673,시흥대로141길,667,410,257
2014,4,A,골목상권,1000672,시흥대로138길,14,7,7
2014,4,A,골목상권,1000671,시흥대로120길,587,398,189
2014,4,A,골목상권,1000670,벚꽃로56길,1595,1147,448
2014,4,A,골목상권,1000669,범안로17길,212,113,99
2014,4,A,골목상권,1000668,범안로11길,1026,838,188
2014,4,A,골목상권,1000667,문성로5길,162,50,112
2014,4,A,골목상권,1000666,독산로85길,59,21,38
2014,4,A,골목상권,1000665,독산로78다길,222,94,128
2014,4,A,골목상권,1000664,독산로70길,4,3,1
2014,4,A,골목상권,1000663,독산로64길,149,35,114
2014,4,A,골목상권,1000662,독산로50길,111,33,78
2014,4,A,골목상권,1000661,독산로40길,52,19,33
2014,4,A,골목상권,1000660,독산로108길,784,331,453
2014,4,A,골목상권,1000659,남부순환로112길,9,4,5
2014,4,A,골목상권,1000658,금하로24길,167,50,117
2014,4,A,골목상권,1000657,금하로1길,54,35,19
2014,4,A,골목상권,1000656,금하로14길,8,4,4
2014,4,A,골목상권,1000655,가산로5길,520,412,108
2014,4,A,골목상권,1000654,가산로3길,2491,1940,551
2014,4,A,골목상권,1000653,중앙로1길,1356,983,373
2014,4,A,골목상권,1000652,중앙로15길,185,59,126
2014,4,A,골목상권,1000651,우마길,22,14,8
2014,4,A,골목상권,1000650,오류로8길,238,110,128
2014,4,A,골목상권,1000649,신도림로13길,644,499,145
2014,4,A,골목상권,1000648,새말로18길,1144,441,703
2014,4,A,골목상권,1000647,부일로1길,735,597,138
2014,4,A,골목상권,1000646,부일로15길,187,168,19
2014,4,A,골목상권,1000645,부일로11길,24,8,16
2014,4,A,골목상권,1000644,디지털로32길,1243,689,554
2014,4,A,골목상권,1000643,디지털로32가길,7048,5058,1990
2014,4,A,골목상권,1000642,디지털로27길,410,261,149
2014,4,A,골목상권,1000641,도림로6길,117,52,65
2014,4,A,골목상권,1000640,도림로12길,93,39,54
2014,4,A,골목상권,1000639,남부순환로97길,247,73,174
2014,4,A,골목상권,1000638,구로중앙로8길,242,100,142
2014,4,A,골목상권,1000637,구로중앙로7길,180,70,110
2014,4,A,골목상권,1000636,구로중앙로42길,730,580,150
2014,4,A,골목상권,1000635,구로중앙로34길,566,316,250
2014,4,A,골목상권,1000634,구로중앙로28길,2864,1366,1498
2014,4,A,골목상권,1000633,구로중앙로19길,19,9,10
2014,4,A,골목상권,1000632,구로동로8길,152,52,100
2014,4,A,골목상권,1000631,구로동로7길,162,63,99
2014,4,A,골목상권,1000630,구로동로42길,24,17,7
2014,4,A,골목상권,1000629,구로동로41길,454,275,179
2014,4,A,골목상권,1000628,구로동로38길,56,27,29
2014,4,A,골목상권,1000627,구로동로28길,185,77,108
2014,4,A,골목상권,1000626,구로동로15길,22,2,20
2014,4,A,골목상권,1000625,공원로6가길,261,200,61
2014,4,A,골목상권,1000624,고척로52길,250,64,186
2014,4,A,골목상권,1000623,고척로27다길,213,87,126
2014,4,A,골목상권,1000622,고척로27길,247,107,140
2014,4,A,골목상권,1000621,고척로21나길,250,57,193
2014,4,A,골목상권,1000620,경인로47길,788,437,351
2014,4,A,골목상권,1000619,경인로35길,277,119,158
2014,4,A,골목상권,1000618,경인로31길,48,11,37
2014,4,A,골목상권,1000617,경인로15길,96,47,49
2014,4,A,골목상권,1000616,개봉로3길,292,170,122
2014,4,A,골목상권,1000615,개봉로2길,484,130,354
2014,4,A,골목상권,1000614,개봉로23가길,852,503,349
2014,4,A,골목상권,1000613,개봉로20길,115,67,48
2014,4,A,골목상권,1000612,개봉로1길,37,20,17
2014,4,A,골목상권,1000611,개봉로17다길,126,59,67
2014,4,A,골목상권,1000610,개봉로17길,838,395,443
2014,4,A,골목상권,1000609,개봉로11길,56,14,42
2014,4,A,골목상권,1000608,화곡로64길,2470,1254,1216
2014,4,A,골목상권,1000607,화곡로59길,499,197,302
2014,4,A,골목상권,1000606,화곡로44나길,883,748,135
2014,4,A,골목상권,1000605,화곡로31길,1306,545,761
2014,4,A,골목상권,1000604,화곡로20길,488,316,172
2014,4,A,골목상권,1000603,화곡로13길,260,85,175
2014,4,A,골목상권,1000602,초원로16길,409,210,199
2014,4,A,골목상권,1000601,초록마을로8길,187,25,162
2014,4,A,골목상권,1000600,초록마을로3길,41,21,20
2014,4,A,골목상권,1000599,월정로20길,7,4,3
2014,4,A,골목상권,1000598,우장산로6길,339,203,136
2014,4,A,골목상권,1000597,양천로73가길,1399,918,481
2014,4,A,골목상권,1000596,양천로71길,216,124,92
2014,4,A,골목상권,1000595,양천로49길,804,634,170
2014,4,A,골목상권,1000594,양천로26길,107,48,59
2014,4,A,골목상권,1000593,양천로24길,220,112,108
2014,4,A,골목상권,1000592,양천로24가길,671,290,381
2014,4,A,골목상권,1000591,양천로14길,415,288,127
2014,4,A,골목상권,1000590,방화대로6라길,748,513,235
2014,4,A,골목상권,1000589,방화대로21길,726,425,301
2014,4,A,골목상권,1000588,등촌로5길,10,2,8
2014,4,A,골목상권,1000587,등촌로55길,455,334,121
2014,4,A,골목상권,1000586,등촌로51길,10,10,0
2014,4,A,골목상권,1000585,등촌로39길,46,17,29
2014,4,A,골목상권,1000584,등촌로13길,225,112,113
2014,4,A,골목상권,1000583,남부순환로11길,414,304,110
2014,4,A,골목상권,1000582,까치산로4길,127,49,78
2014,4,A,골목상권,1000581,국회대로7길,352,220,132
2014,4,A,골목상권,1000580,공항대로8길,230,128,102
2014,4,A,골목상권,1000579,공항대로61길,225,146,79
2014,4,A,골목상권,1000578,공항대로59다길,826,603,223
2014,4,A,골목상권,1000577,공항대로59길,1169,791,378
2014,4,A,골목상권,1000576,공항대로55길,731,536,195
2014,4,A,골목상권,1000575,공항대로42길,11,7,4
2014,4,A,골목상권,1000574,공항대로38길,235,119,116
2014,4,A,골목상권,1000573,곰달래로60길,546,281,265
2014,4,A,골목상권,1000572,곰달래로53길,61,14,47
2014,4,A,골목상권,1000571,곰달래로47길,39,14,25
2014,4,A,골목상권,1000570,곰달래로31길,13,11,2
2014,4,A,골목상권,1000569,곰달래로25길,512,205,307
2014,4,A,골목상권,1000568,개화동로25길,632,436,196
2014,4,A,골목상권,1000567,개화동로23길,101,60,41
2014,4,A,골목상권,1000566,강서로8길,118,73,45
2014,4,A,골목상권,1000565,강서로5라길,252,146,106
2014,4,A,골목상권,1000564,강서로5나길,105,64,41
2014,4,A,골목상권,1000563,강서로5가길,39,23,16
2014,4,A,골목상권,1000562,강서로47라길,64,39,25
2014,4,A,골목상권,1000561,강서로47길,394,194,200
2014,4,A,골목상권,1000560,강서로45다길,576,187,389
2014,4,A,골목상권,1000559,강서로45길,99,50,49
2014,4,A,골목상권,1000558,강서로35길,146,90,56
2014,4,A,골목상권,1000557,강서로29길,283,160,123
2014,4,A,골목상권,1000556,강서로18길,28,9,19
2014,4,A,골목상권,1000555,강서로17가길,103,42,61
2014,4,A,골목상권,1000554,강서로15길,290,159,131
2014,4,A,골목상권,1000553,가로공원로80길,125,69,56
2014,4,A,골목상권,1000552,가로공원로76가길,16,8,8
2014,4,A,골목상권,1000551,화곡로4길,295,120,175
2014,4,A,골목상권,1000550,화곡로3길,164,54,110
2014,4,A,골목상권,1000549,지양로7길,223,71,152
2014,4,A,골목상권,1000548,중앙로55길,368,194,174
2014,4,A,골목상권,1000547,중앙로51길,125,65,60
2014,4,A,골목상권,1000546,중앙로47길,90,18,72
2014,4,A,골목상권,1000545,중앙로45길,158,59,99
2014,4,A,골목상권,1000544,중앙로36길,2,2,0
2014,4,A,골목상권,1000543,중앙로32길,470,231,239
2014,4,A,골목상권,1000542,중앙로25길,264,76,188
2014,4,A,골목상권,1000541,은행정로7길,453,153,300
2014,4,A,골목상권,1000539,오목로5길,278,151,127
2014,4,A,골목상권,1000538,오목로3길,468,435,33
2014,4,A,골목상권,1000537,오목로30길,150,78,72
2014,4,A,골목상권,1000536,오목로23길,686,353,333
2014,4,A,골목상권,1000535,신월로20길,210,87,123
2014,4,A,골목상권,1000534,신월로15길,760,361,399
2014,4,A,골목상권,1000533,신목로6길,253,132,121
2014,4,A,골목상권,1000532,신목로5길,910,344,566
2014,4,A,골목상권,1000531,신목로2길,106,45,61
2014,4,A,골목상권,1000530,목동중앙서로8가길,202,109,93
2014,4,A,골목상권,1000529,목동중앙서로7길,207,76,131
2014,4,A,골목상권,1000528,목동중앙북로8길,450,197,253
2014,4,A,골목상권,1000527,목동중앙북로16길,246,73,173
2014,4,A,골목상권,1000526,목동중앙본로7길,90,34,56
2014,4,A,골목상권,1000525,목동중앙로3길,103,54,49
2014,4,A,골목상권,1000524,목동중앙로13나길,246,165,81
2014,4,A,골목상권,1000523,목동중앙남로3가길,575,399,176
2014,4,A,골목상권,1000522,목동로9길,2250,1516,734
2014,4,A,골목상권,1000521,목동로19길,959,397,562
2014,4,A,골목상권,1000519,목동동로12길,409,169,240
2014,4,A,골목상권,1000518,목동남로4길,10,5,5
2014,4,A,골목상권,1000517,남부순환로88길,303,118,185
2014,4,A,골목상권,1000516,남부순환로79길,538,385,153
2014,4,A,골목상권,1000515,남부순환로70길,631,445,186
2014,4,A,골목상권,1000514,남부순환로58길,145,73,72
2014,4,A,골목상권,1000513,남부순환로40길,23,13,10
2014,4,A,골목상권,1000512,남부순환로33길,1244,1015,229
2014,4,A,골목상권,1000511,곰달래로5길,43,22,21
2014,4,A,골목상권,1000510,곰달래로3길,398,214,184
2014,4,A,골목상권,1000509,곰달래로2길,302,184,118
2014,4,A,골목상권,1000508,곰달래로10길,393,308,85
2014,4,A,골목상권,1000507,가로공원로58길,94,19,75
2014,4,A,골목상권,1000506,효창원로93길,99,53,46
2014,4,A,골목상권,1000505,토정로37길,144,60,84
2014,4,A,골목상권,1000504,월드컵로8길,1641,935,706
2014,4,A,골목상권,1000503,월드컵로7길,4,2,2
2014,4,A,골목상권,1000502,월드컵로36길,113,32,81
2014,4,A,골목상권,1000501,월드컵로25길,271,148,123
2014,4,A,골목상권,1000500,월드컵로19길,376,149,227
2014,4,A,골목상권,1000499,월드컵로16길,2191,1338,853
2014,4,A,골목상권,1000498,월드컵로11길,217,81,136
2014,4,A,골목상권,1000497,월드컵로10길,1672,906,766
2014,4,A,골목상권,1000496,와우산로3길,177,105,72
2014,4,A,골목상권,1000495,와우산로29길,133,61,72
2014,4,A,골목상권,1000494,와우산로29가길,10,4,6
2014,4,A,골목상권,1000493,양화진길,481,338,143
2014,4,A,골목상권,1000492,양화로1길,4373,2281,2092
2014,4,A,골목상권,1000491,양화로11길,452,298,154
2014,4,A,골목상권,1000490,신촌로30길,25,12,13
2014,4,A,골목상권,1000489,신촌로28가길,121,49,72
2014,4,A,골목상권,1000488,신촌로12길,1185,569,616
2014,4,A,골목상권,1000487,숭문길,714,403,311
2014,4,A,골목상권,1000486,숭문8길,118,71,47
2014,4,A,골목상권,1000485,성지3길,474,250,224
2014,4,A,골목상권,1000484,성산로4길,2524,1667,857
2014,4,A,골목상권,1000483,성미산로32길,322,192,130
2014,4,A,골목상권,1000482,성미산로1길,565,443,122
2014,4,A,골목상권,1000481,성미산로11길,904,600,304
2014,4,A,골목상권,1000480,백범로16길,526,294,232
2014,4,A,골목상권,1000479,방울내로9안길,334,205,129
2014,4,A,골목상권,1000478,모래내로7길,245,124,121
2014,4,A,골목상권,1000477,매봉산로2길,2265,1514,751
2014,4,A,골목상권,1000476,망원로2길,195,122,73
2014,4,A,골목상권,1000475,망원로11길,810,437,373
2014,4,A,골목상권,1000474,만리재옛길,1166,488,678
2014,4,A,골목상권,1000473,마포대로4길,346,143,203
2014,4,A,골목상권,1000472,마포대로20길,1239,652,587
2014,4,A,골목상권,1000471,마포대로12길,69,37,32
2014,4,A,골목상권,1000470,동교로38길,172,76,96
2014,4,A,골목상권,1000469,동교로27길,3135,1498,1637
2014,4,A,골목상권,1000468,동교로25길,827,411,416
2014,4,A,골목상권,1000467,동교로19길,4276,2553,1723
2014,4,A,골목상권,1000466,동교로17길,799,416,383
2014,4,A,골목상권,1000465,독막로8길,386,187,199
2014,4,A,골목상권,1000464,독막로32길,488,207,281
2014,4,A,골목상권,1000463,독막로22길,70,39,31
2014,4,A,골목상권,1000462,도화길,1107,580,527
2014,4,A,골목상권,1000461,도화4길,363,128,235
2014,4,A,골목상권,1000460,대흥로28길,71,57,14
2014,4,A,골목상권,1000459,대흥로21길,581,120,461
2014,4,A,골목상권,1000458,광성로6길,110,79,31
2014,4,A,골목상권,1000457,홍제내길,96,60,36
2014,4,A,골목상권,1000456,홍연길,77,46,31
2014,4,A,골목상권,1000455,통일로39길,9,8,1
2014,4,A,골목상권,1000454,통일로37길,370,139,231
2014,4,A,골목상권,1000453,통일로11길,13,9,4
2014,4,A,골목상권,1000452,충정로6길,12112,6687,5425
2014,4,A,골목상권,1000451,충정로4길,2798,1879,919
2014,4,A,골목상권,1000450,증가로6길,254,93,161
2014,4,A,골목상권,1000449,증가로23나길,395,187,208
2014,4,A,골목상권,1000448,증가로20가길,281,97,184
2014,4,A,골목상권,1000447,증가로10길,173,90,83
2014,4,A,골목상권,1000446,응암로1길,335,244,91
2014,4,A,골목상권,1000445,연희로10길,96,65,31
2014,4,A,골목상권,1000444,신촌로37길,156,67,89
2014,4,A,골목상권,1000443,수색로8길,1584,1456,128
2014,4,A,골목상권,1000442,세무서길,341,129,212
2014,4,A,골목상권,1000440,세검정로1길,243,142,101
2014,4,A,골목상권,1000439,북아현로4길,373,98,275
2014,4,A,골목상권,1000438,모래내로15길,89,31,58
2014,4,A,골목상권,1000437,명지대길,340,248,92
2014,4,A,골목상권,1000436,독립문로8길,716,277,439
2014,4,A,골목상권,1000435,가재울로6길,16,9,7
2014,4,A,골목상권,1000434,통일로92길,65,31,34
2014,4,A,골목상권,1000433,통일로87길,198,84,114
2014,4,A,골목상권,1000432,통일로78길,194,68,126
2014,4,A,골목상권,1000430,진흥로1길,516,170,346
2014,4,A,골목상권,1000429,진흥로12길,371,157,214
2014,4,A,골목상권,1000428,증산서길,359,275,84
2014,4,A,골목상권,1000427,증산로9길,84,31,53
2014,4,A,골목상권,1000426,증산로5길,707,362,345
2014,4,A,골목상권,1000425,증산로21길,239,159,80
2014,4,A,골목상권,1000424,증산로17길,568,340,228
2014,4,A,골목상권,1000423,증산로15길,178,65,113
2014,4,A,골목상권,1000422,증산로13길,55,31,24
2014,4,A,골목상권,1000421,응암로34길,80,45,35
2014,4,A,골목상권,1000420,응암로22길,165,58,107
2014,4,A,골목상권,1000419,응암로14길,307,83,224
2014,4,A,골목상권,1000418,응암로13길,234,90,144
2014,4,A,골목상권,1000417,응암로12길,198,87,111
2014,4,A,골목상권,1000416,은평로8길,258,144,114
2014,4,A,골목상권,1000415,은평로3길,298,94,204
2014,4,A,골목상권,1000414,은평로20길,26,10,16
2014,4,A,골목상권,1000413,은평로13길,574,378,196
2014,4,A,골목상권,1000412,은평로10길,303,190,113
2014,4,A,골목상권,1000411,연서로5길,48,14,34
2014,4,A,골목상권,1000410,연서로41길,209,63,146
2014,4,A,골목상권,1000409,연서로3길,106,47,59
2014,4,A,골목상권,1000408,연서로34길,117,36,81
2014,4,A,골목상권,1000407,연서로33길,20,6,14
2014,4,A,골목상권,1000406,연서로29길,297,104,193
2014,4,A,골목상권,1000405,연서로28길,750,375,375
2014,4,A,골목상권,1000404,연서로27길,64,31,33
2014,4,A,골목상권,1000403,연서로21길,283,152,131
2014,4,A,골목상권,1000402,연서로17길,1010,382,628
2014,4,A,골목상권,1000401,연서로16길,310,114,196
2014,4,A,골목상권,1000400,연서로13길,705,227,478
2014,4,A,골목상권,1000399,연서로11길,170,88,82
2014,4,A,골목상권,1000398,역말로9길,19,15,4
2014,4,A,골목상권,1000397,수색로18길,675,558,117
2014,4,A,골목상권,1000396,서오릉로8길,19,11,8
2014,4,A,골목상권,1000395,서오릉로21길,437,140,297
2014,4,A,골목상권,1000394,불광천길,159,82,77
2014,4,A,골목상권,1000393,갈현로7길,951,263,688
2014,4,A,골목상권,1000392,갈현로41길,88,30,58
2014,4,A,골목상권,1000391,갈현로33길,30,8,22
2014,4,A,골목상권,1000390,갈현로1길,100,40,60
2014,4,A,골목상권,1000389,가좌로7길,52,24,28
2014,4,A,골목상권,1000388,한글비석로44길,485,260,225
2014,4,A,골목상권,1000387,한글비석로24길,345,136,209
2014,4,A,골목상권,1000386,한글비석로22길,595,259,336
2014,4,A,골목상권,1000385,석계로1길,109,68,41
2014,4,A,골목상권,1000384,상계로9가길,255,100,155
2014,4,A,골목상권,1000382,상계로12길,15,10,5
2014,4,A,골목상권,1000381,동일로242길,569,433,136
2014,4,A,골목상권,1000380,동일로192길,437,231,206
2014,4,A,골목상권,1000379,동일로173가길,2265,1271,994
2014,4,A,골목상권,1000378,공릉로58길,93,32,61
2014,4,A,골목상권,1000377,해등로16길,64,51,13
2014,4,A,골목상권,1000376,우이천로4다길,181,106,75
2014,4,A,골목상권,1000375,우이천로32길,105,49,56
2014,4,A,골목상권,1000374,시루봉로23길,37,15,22
2014,4,A,골목상권,1000373,삼양로144길,60,46,14
2014,4,A,골목상권,1000372,방학로6가길,158,84,74
2014,4,A,골목상권,1000371,방학로5길,154,82,72
2014,4,A,골목상권,1000370,방학로15길,331,229,102
2014,4,A,골목상권,1000369,방학로10길,109,65,44
2014,4,A,골목상권,1000367,도봉산4길,303,271,32
2014,4,A,골목상권,1000366,도봉로181길,250,119,131
2014,4,A,골목상권,1000365,도봉로169나길,232,115,117
2014,4,A,골목상권,1000364,도봉로156길,358,159,199
2014,4,A,골목상권,1000363,도봉로152가길,438,389,49
2014,4,A,골목상권,1000362,도봉로147길,604,348,256
2014,4,A,골목상권,1000360,도봉로114길,442,143,299
2014,4,A,골목상권,1000359,도봉로109길,16,6,10
2014,4,A,골목상권,1000358,도당로29길,891,539,352
2014,4,A,골목상권,1000357,도당로19길,157,72,85
2014,4,A,골목상권,1000356,도당로13바길,206,72,134
2014,4,A,골목상권,1000355,도당로13가길,136,59,77
2014,4,A,골목상권,1000354,덕릉로60길,60,32,28
2014,4,A,골목상권,1000353,노해로63다길,466,219,247
2014,4,A,골목상권,1000352,노해로60길,282,131,151
2014,4,A,골목상권,1000351,한천로140길,118,70,48
2014,4,A,골목상권,1000350,한천로139가길,55,33,22
2014,4,A,골목상권,1000349,한천로132길,306,112,194
2014,4,A,골목상권,1000348,한천로130길,271,108,163
2014,4,A,골목상권,1000347,한천로124나길,94,44,50
2014,4,A,골목상권,1000346,한천로109길,601,282,319
2014,4,A,골목상권,1000345,인수봉로79길,175,44,131
2014,4,A,골목상권,1000344,인수봉로72길,81,36,45
2014,4,A,골목상권,1000343,인수봉로56길,11,1,10
2014,4,A,골목상권,1000342,오패산로67길,455,245,210
2014,4,A,골목상권,1000341,오패산로52길,82,28,54
2014,4,A,골목상권,1000339,수유로12길,237,155,82
2014,4,A,골목상권,1000338,솔샘로65길,523,232,291
2014,4,A,골목상권,1000337,솔매로50길,694,286,408
2014,4,A,골목상권,1000336,솔매로45길,245,92,153
2014,4,A,골목상권,1000335,솔매로41길,80,21,59
2014,4,A,골목상권,1000334,삼양로93길,16,4,12
2014,4,A,골목상권,1000333,삼양로77길,377,134,243
2014,4,A,골목상권,1000332,삼양로54길,4,2,2
2014,4,A,골목상권,1000331,삼양로41길,338,160,178
2014,4,A,골목상권,1000329,삼양로24길,88,37,51
2014,4,A,골목상권,1000328,삼양로20길,125,42,83
2014,4,A,골목상권,1000327,삼각산로28길,669,388,281
2014,4,A,골목상권,1000326,도봉로99길,171,94,77
2014,4,A,골목상권,1000325,도봉로8길,271,192,79
2014,4,A,골목상권,1000324,도봉로76길,322,164,158
2014,4,A,골목상권,1000323,도봉로67길,8,4,4
2014,4,A,골목상권,1000322,도봉로45길,154,88,66
2014,4,A,골목상권,1000321,도봉로18길,537,253,284
2014,4,A,골목상권,1000320,도봉로13길,36,18,18
2014,4,A,골목상권,1000319,덕릉로41길,681,584,97
2014,4,A,골목상권,1000318,덕릉로40길,871,696,175
2014,4,A,골목상권,1000317,노해로33길,27,10,17
2014,4,A,골목상권,1000315,노해로17길,189,89,100
2014,4,A,골목상권,1000314,화랑로40길,117,63,54
2014,4,A,골목상권,1000313,화랑로32길,395,292,103
2014,4,A,골목상권,1000312,화랑로1길,185,100,85
2014,4,A,골목상권,1000311,화랑로19길,425,220,205
2014,4,A,골목상권,1000310,화랑로14길,36,19,17
2014,4,A,골목상권,1000309,화랑로13길,89,40,49
2014,4,A,골목상권,1000308,한천로76길,111,68,43
2014,4,A,골목상권,1000307,한천로101가길,61,35,26
2014,4,A,골목상권,1000306,창경궁로43길,22,16,6
2014,4,A,골목상권,1000305,지봉로20길,172,115,57
2014,4,A,골목상권,1000304,종암로5길,106,76,30
2014,4,A,골목상권,1000303,종암로24가길,270,135,135
2014,4,A,골목상권,1000302,종암로21길,113,42,71
2014,4,A,골목상권,1000301,종암로19길,390,112,278
2014,4,A,골목상권,1000300,종암로16길,58,23,35
2014,4,A,골목상권,1000299,정릉로8길,198,118,80
2014,4,A,골목상권,1000298,정릉로27길,229,110,119
2014,4,A,골목상권,1000296,장위로50길,1011,558,453
2014,4,A,골목상권,1000295,장월로1길,384,152,232
2014,4,A,골목상권,1000294,인촌로6길,1921,1003,918
2014,4,A,골목상권,1000293,인촌로5길,28,4,24
2014,4,A,골목상권,1000292,인촌로24길,293,138,155
2014,4,A,골목상권,1000291,개운사길,2710,1782,928
2014,4,A,골목상권,1000290,인촌로1길,147,98,49
2014,4,A,골목상권,1000289,인촌로17가길,2911,1191,1720
2014,4,A,골목상권,1000288,오패산로4길,470,173,297
2014,4,A,골목상권,1000287,오패산로3길,1264,706,558
2014,4,A,골목상권,1000286,오패산로19길,33,19,14
2014,4,A,골목상권,1000285,안암로5길,608,388,220
2014,4,A,골목상권,1000284,아리랑로4길,721,249,472
2014,4,A,골목상권,1000283,솔샘로6길,118,61,57
2014,4,A,골목상권,1000282,성북로8길,53,26,27
2014,4,A,골목상권,1000281,삼양로8길,72,49,23
2014,4,A,골목상권,1000280,삼선교로16가길,653,365,288
2014,4,A,골목상권,1000279,삼선교로10다길,101,36,65
2014,4,A,골목상권,1000278,삼선교로10길,230,101,129
2014,4,A,골목상권,1000277,보문로32길,938,408,530
2014,4,A,골목상권,1000276,보문로31길,892,359,533
2014,4,A,골목상권,1000274,보문로13길,605,369,236
2014,4,A,골목상권,1000273,보국문로16길,261,178,83
2014,4,A,골목상권,1000270,동소문로26가길,234,136,98
2014,4,A,골목상권,1000269,동소문로15길,61,24,37
2014,4,A,골목상권,1000268,동소문로13길,881,492,389
2014,4,A,골목상권,1000267,돌곶이로8길,197,111,86
2014,4,A,골목상권,1000266,돌곶이로41길,32,14,18
2014,4,A,골목상권,1000265,돌곶이로28길,153,81,72
2014,4,A,골목상권,1000264,돌곶이로27길,50,31,19
2014,4,A,골목상권,1000263,돌곶이로22길,97,52,45
2014,4,A,골목상권,1000261,길음로7길,12,8,4
2014,4,A,골목상권,1000260,중랑천로10길,633,344,289
2014,4,A,골목상권,1000259,용마산로94길,428,269,159
2014,4,A,골목상권,1000258,용마산로118길,517,219,298
2014,4,A,골목상권,1000257,용마산로112길,249,116,133
2014,4,A,골목상권,1000256,용마산로100길,495,351,144
2014,4,A,골목상권,1000255,신내로7가길,300,76,224
2014,4,A,골목상권,1000254,사가정로54길,92,33,59
2014,4,A,골목상권,1000253,사가정로42길,66,21,45
2014,4,A,골목상권,1000252,봉화산로56길,558,150,408
2014,4,A,골목상권,1000251,봉화산로4길,303,122,181
2014,4,A,골목상권,1000250,봉화산로30길,365,247,118
2014,4,A,골목상권,1000249,봉우재로33길,58,24,34
2014,4,A,골목상권,1000248,면목로78길,247,139,108
2014,4,A,골목상권,1000247,면목로56길,234,188,46
2014,4,A,골목상권,1000246,면목로55길,421,124,297
2014,4,A,골목상권,1000245,면목로49길,509,169,340
2014,4,A,골목상권,1000244,면목로48길,97,53,44
2014,4,A,골목상권,1000243,면목로45길,83,39,44
2014,4,A,골목상권,1000242,면목로33길,431,165,266
2014,4,A,골목상권,1000241,면목로21길,28,18,10
2014,4,A,골목상권,1000240,망우로73길,7,3,4
2014,4,A,골목상권,1000239,망우로68길,76,31,45
2014,4,A,골목상권,1000238,동일로163길,104,71,33
2014,4,A,골목상권,1000237,동일로157길,175,90,85
2014,4,A,골목상권,1000236,동일로149길,1098,813,285
2014,4,A,골목상권,1000235,동일로140길,223,84,139
2014,4,A,골목상권,1000234,동일로139길,75,48,27
2014,4,A,골목상권,1000233,동일로139가길,994,600,394
2014,4,A,골목상권,1000232,동일로130길,96,26,70
2014,4,A,골목상권,1000231,동일로123길,178,98,80
2014,4,A,골목상권,1000230,동일로112길,199,78,121
2014,4,A,골목상권,1000229,동일로101길,315,127,188
2014,4,A,골목상권,1000228,동일로100길,34,14,20
2014,4,A,골목상권,1000227,답십리로75길,82,44,38
2014,4,A,골목상권,1000226,공릉로2길,548,272,276
2014,4,A,골목상권,1000225,공릉로12가길,45,31,14
2014,4,A,골목상권,1000224,겸재로54길,98,54,44
2014,4,A,골목상권,1000223,겸재로36길,305,246,59
2014,4,A,골목상권,1000222,겸재로29길,443,202,241
2014,4,A,골목상권,1000221,휘경로3길,176,92,84
2014,4,A,골목상권,1000220,휘경로2길,7,2,5
2014,4,A,골목상권,1000219,휘경로23길,16,0,16
2014,4,A,골목상권,1000218,휘경로14길,81,37,44
2014,4,A,골목상권,1000217,한천로46길,376,127,249
2014,4,A,골목상권,1000216,한천로40길,308,166,142
2014,4,A,골목상권,1000215,한천로33길,85,35,50
2014,4,A,골목상권,1000214,한천로14길,565,345,220
2014,4,A,골목상권,1000213,천호대로97길,323,208,115
2014,4,A,골목상권,1000212,천호대로77길,2079,1162,917
2014,4,A,골목상권,1000211,천호대로45길,177,113,64
2014,4,A,골목상권,1000210,천호대로17길,1948,1233,715
2014,4,A,골목상권,1000209,천호대로12길,804,556,248
2014,4,A,골목상권,1000208,천장산로7길,1329,845,484
2014,4,A,골목상권,1000207,제기로5길,197,108,89
2014,4,A,골목상권,1000206,제기로21길,217,139,78
2014,4,A,골목상권,1000205,전농로4길,658,429,229
2014,4,A,골목상권,1000204,전농로3길,108,44,64
2014,4,A,골목상권,1000203,전농로29길,278,117,161
2014,4,A,골목상권,1000202,장한로8길,726,416,310
2014,4,A,골목상권,1000201,장한로5길,3252,2173,1079
2014,4,A,골목상권,1000200,장한로27길,158,49,109
2014,4,A,골목상권,1000199,장한로27가길,372,185,187
2014,4,A,골목상권,1000198,장한로26길,533,265,268
2014,4,A,골목상권,1000197,장한로26가길,327,170,157
2014,4,A,골목상권,1000196,장한로25길,993,463,530
2014,4,A,골목상권,1000195,장한로14길,193,165,28
2014,4,A,골목상권,1000194,이문로42길,223,83,140
2014,4,A,골목상권,1000193,왕산로43길,972,484,488
2014,4,A,골목상권,1000192,왕산로33길,178,118,60
2014,4,A,골목상권,1000191,왕산로32길,10,6,4
2014,4,A,골목상권,1000190,약령시로17길,249,139,110
2014,4,A,골목상권,1000189,서울시립대로4길,774,508,266
2014,4,A,골목상권,1000188,서울시립대로29길,190,111,79
2014,4,A,골목상권,1000187,서울시립대로16길,110,31,79
2014,4,A,골목상권,1000186,사가정로2길,130,93,37
2014,4,A,골목상권,1000185,사가정로23가길,91,61,30
2014,4,A,골목상권,1000184,사가정로13길,294,113,181
2014,4,A,골목상권,1000183,무학로45길,364,196,168
2014,4,A,골목상권,1000182,무학로16길,1050,920,130
2014,4,A,골목상권,1000181,망우로21길,178,101,77
2014,4,A,골목상권,1000180,망우로18길,551,250,301
2014,4,A,골목상권,1000179,망우로18가길,73,27,46
2014,4,A,골목상권,1000178,답십리로72길,8,7,1
2014,4,A,골목상권,1000177,답십리로69길,758,337,421
2014,4,A,골목상권,1000176,답십리로68길,165,108,57
2014,4,A,골목상권,1000175,답십리로64길,358,198,160
2014,4,A,골목상권,1000174,답십리로63길,87,56,31
2014,4,A,골목상권,1000173,답십리로60길,12,6,6
2014,4,A,골목상권,1000172,답십리로56길,8,6,2
2014,4,A,골목상권,1000171,답십리로23길,2,2,0
2014,4,A,골목상권,1000170,난계로30길,216,170,46
2014,4,A,골목상권,1000168,경희대로3길,255,158,97
2014,4,A,골목상권,1000167,천호대로129길,185,62,123
2014,4,A,골목상권,1000166,천호대로123길,363,154,209
2014,4,A,골목상권,1000165,천호대로109길,1371,820,551
2014,4,A,골목상권,1000164,자양번영로3길,92,41,51
2014,4,A,골목상권,1000162,자양로50길,22,7,15
2014,4,A,골목상권,1000161,자양로45길,517,282,235
2014,4,A,골목상권,1000160,자양로26길,324,114,210
2014,4,A,골목상권,1000159,자양로15길,372,222,150
2014,4,A,골목상권,1000158,자양로11길,1261,630,631
2014,4,A,골목상권,1000157,용마산로3길,871,487,384
2014,4,A,골목상권,1000156,용마산로21길,150,69,81
2014,4,A,골목상권,1000155,아차산로78길,1723,1079,644
2014,4,A,골목상권,1000154,아차산로65길,649,446,203
2014,4,A,골목상권,1000153,아차산로55길,536,260,276
2014,4,A,골목상권,1000152,아차산로51길,229,131,98
2014,4,A,골목상권,1000151,아차산로40길,516,304,212
2014,4,A,골목상권,1000150,면목로17길,223,139,84
2014,4,A,골목상권,1000149,뚝섬로64길,359,198,161
2014,4,A,골목상권,1000148,뚝섬로58길,203,89,114
2014,4,A,골목상권,1000147,뚝섬로54길,139,80,59
2014,4,A,골목상권,1000146,뚝섬로48길,744,355,389
2014,4,A,골목상권,1000145,뚝섬로24길,111,40,71
2014,4,A,골목상권,1000144,뚝섬로23길,90,61,29
2014,4,A,골목상권,1000143,동일로24길,9,4,5
2014,4,A,골목상권,1000142,동일로18길,135,64,71
2014,4,A,골목상권,1000141,능동로4길,206,81,125
2014,4,A,골목상권,1000140,능동로3길,184,80,104
2014,4,A,골목상권,1000139,능동로34길,707,425,282
2014,4,A,골목상권,1000138,능동로19길,351,230,121
2014,4,A,골목상권,1000137,능동로13길,300,96,204
2014,4,A,골목상권,1000136,긴고랑로9길,70,31,39
2014,4,A,골목상권,1000135,긴고랑로8길,238,210,28
2014,4,A,골목상권,1000134,긴고랑로7길,454,225,229
2014,4,A,골목상권,1000133,긴고랑로20길,524,237,287
2014,4,A,골목상권,1000132,광나루로52길,1585,802,783
2014,4,A,골목상권,1000131,광나루로40길,78,34,44
2014,4,A,골목상권,1000130,광나루로37길,275,168,107
2014,4,A,골목상권,1000129,광나루로36길,30,18,12
2014,4,A,골목상권,1000128,광나루로24길,105,59,46
2014,4,A,골목상권,1000127,광나루로12길,876,549,327
2014,4,A,골목상권,1000126,한림말길,93,61,32
2014,4,A,골목상권,1000124,청계천로10나길,1770,1009,761
2014,4,A,골목상권,1000123,장터길,34,11,23
2014,4,A,골목상권,1000122,용답중앙길,92,49,43
2014,4,A,골목상권,1000121,용답29길,1814,901,913
2014,4,A,골목상권,1000120,왕십리로6길,1324,762,562
2014,4,A,골목상권,1000119,왕십리로31길,135,62,73
2014,4,A,골목상권,1000118,왕십리로26길,3975,2177,1798
2014,4,A,골목상권,1000117,왕십리로21길,138,39,99
2014,4,A,골목상권,1000116,왕십리로14길,1896,1523,373
2014,4,A,골목상권,1000115,아차산로5길,2105,1449,656
2014,4,A,골목상권,1000114,아차산로15길,3620,2630,990
2014,4,A,골목상권,1000113,아차산로11길,3282,2095,1187
2014,4,A,골목상권,1000112,송정4가길,1143,585,558
2014,4,A,골목상권,1000111,송정12라길,223,162,61
2014,4,A,골목상권,1000110,성수일로6길,3109,1744,1365
2014,4,A,골목상권,1000109,성수이로7길,578,320,258
2014,4,A,골목상권,1000108,성수이로18길,2126,1519,607
2014,4,A,골목상권,1000107,성덕정길,595,369,226
2014,4,A,골목상권,1000106,성덕정17길,205,113,92
2014,4,A,골목상권,1000105,서울숲2길,1676,899,777
2014,4,A,골목상권,1000104,상원길,1519,1004,515
2014,4,A,골목상권,1000103,상원12길,140,86,54
2014,4,A,골목상권,1000102,사근동길,26,16,10
2014,4,A,골목상권,1000101,무학봉길,8,7,1
2014,4,A,골목상권,1000100,무학봉28길,169,74,95
2014,4,A,골목상권,1000099,무학로6길,350,204,146
2014,4,A,골목상권,1000098,무수막길,102,51,51
2014,4,A,골목상권,1000097,매봉길,27,16,11
2014,4,A,골목상권,1000096,마조로1길,169,68,101
2014,4,A,골목상권,1000095,마조로16길,806,550,256
2014,4,A,골목상권,1000094,마장로39길,15,11,4
2014,4,A,골목상권,1000093,마장로27길,104,38,66
2014,4,A,골목상권,1000091,둘레9길,396,237,159
2014,4,A,골목상권,1000090,금호산길,373,134,239
2014,4,A,골목상권,1000089,금호산2길,32,13,19
2014,4,A,골목상권,1000088,고산자로6길,15962,6588,9374
2014,4,A,골목상권,1000087,후암로28길,176,69,107
2014,4,A,골목상권,1000086,효창원로39길,53,33,20
2014,4,A,골목상권,1000085,회나무로13길,41,23,18
2014,4,A,골목상권,1000084,한남대로20길,832,504,328
2014,4,A,골목상권,1000082,한강대로7길,382,271,111
2014,4,A,골목상권,1000081,한강대로62길,663,455,208
2014,4,A,골목상권,1000080,한강대로52길,6319,2010,4309
2014,4,A,골목상권,1000079,한강대로43길,4686,3077,1609
2014,4,A,골목상권,1000078,한강대로15길,1905,429,1476
2014,4,A,골목상권,1000077,한강대로104길,4794,3508,1286
2014,4,A,골목상권,1000076,청파로73길,1414,815,599
2014,4,A,골목상권,1000075,청파로71길,257,136,121
2014,4,A,골목상권,1000074,청파로47나길,116,83,33
2014,4,A,골목상권,1000073,청파로47길,809,375,434
2014,4,A,골목상권,1000072,장문로45길,86,8,78
2014,4,A,골목상권,1000071,이태원로54길,2263,1575,688
2014,4,A,골목상권,1000070,이태원로27길,476,289,187
2014,4,A,골목상권,1000069,이촌로22길,195,111,84
2014,4,A,골목상권,1000068,원효로89길,909,739,170
2014,4,A,골목상권,1000067,원효로53길,696,434,262
2014,4,A,골목상권,1000066,원효로41길,2831,2036,795
2014,4,A,골목상권,1000065,원효로19길,913,669,244
2014,4,A,골목상권,1000064,우사단로4길,156,116,40
2014,4,A,골목상권,1000063,우사단로14길,1735,970,765
2014,4,A,골목상권,1000062,우사단로10길,58,29,29
2014,4,A,골목상권,1000061,신흥로20길,214,107,107
2014,4,A,골목상권,1000060,소월로20길,126,43,83
2014,4,A,골목상권,1000059,서빙고로71길,466,277,189
2014,4,A,골목상권,1000058,백범로90길,262,158,104
2014,4,A,골목상권,1000057,백범로79길,929,585,344
2014,4,A,골목상권,1000056,두텁바위로1길,2520,1458,1062
2014,4,A,골목상권,1000055,대사관로34길,295,167,128
2014,4,A,골목상권,1000054,녹사평대로46길,25,17,8
2014,4,A,골목상권,1000053,녹사평대로40나길,21,9,12
2014,4,A,골목상권,1000052,녹사평대로32길,334,176,158
2014,4,A,골목상권,1000051,녹사평대로26길,2210,1334,876
2014,4,A,골목상권,1000050,녹사평대로11길,271,175,96
2014,4,A,골목상권,1000049,퇴계로90길,460,193,267
2014,4,A,골목상권,1000048,퇴계로8길,2235,1321,914
2014,4,A,골목상권,1000047,퇴계로56길,864,659,205
2014,4,A,골목상권,1000046,퇴계로46길,1866,721,1145
2014,4,A,골목상권,1000045,퇴계로18길,2828,1335,1493
2014,4,A,골목상권,1000044,퇴계로12길,1007,455,552
2014,4,A,골목상권,1000043,청구로1길,213,106,107
2014,4,A,골목상권,1000042,청구로17길,1657,765,892
2014,4,A,골목상권,1000041,장충단로8길,3994,1255,2739
2014,4,A,골목상권,1000040,삼일대로4길,1356,977,379
2014,4,A,골목상권,1000039,명동길,34339,17638,16701
2014,4,A,골목상권,1000037,동호로20길,940,423,517
2014,4,A,골목상권,1000036,동호로15길,4452,2435,2017
2014,4,A,골목상권,1000035,동호로11길,11,9,2
2014,4,A,골목상권,1000034,동호로10길,4334,2316,2018
2014,4,A,골목상권,1000033,다산로39길,924,570,354
2014,4,A,골목상권,1000032,다산로38길,1309,727,582
2014,4,A,골목상권,1000031,다산로36길,46,26,20
2014,4,A,골목상권,1000030,다산로33길,367,193,174
2014,4,A,골목상권,1000029,난계로21길,176,117,59
2014,4,A,골목상권,1000028,난계로11길,1453,861,592
2014,4,A,골목상권,1000026,평창길,172,72,100
2014,4,A,골목상권,1000025,통일로12길,130,42,88
2014,4,A,골목상권,1000024,창신길,251,72,179
2014,4,A,골목상권,1000023,창신5길,7,4,3
2014,4,A,골목상권,1000022,창신2길,41,24,17
2014,4,A,골목상권,1000021,창경궁로35길,1281,361,920
2014,4,A,골목상권,1000020,지봉로8길,145,71,74
2014,4,A,골목상권,1000019,종로65길,560,284,276
2014,4,A,골목상권,1000016,자하문로7길,472,278,194
2014,4,A,골목상권,1000015,이화장길,2075,1037,1038
2014,4,A,골목상권,1000014,율곡로16길,58,20,38
2014,4,A,골목상권,1000013,율곡로10길,2193,1624,569
2014,4,A,골목상권,1000012,옥인길,476,224,252
2014,4,A,골목상권,1000011,숭인동길,16,6,10
2014,4,A,골목상권,1000010,성균관로5길,107,61,46
2014,4,A,골목상권,1000009,삼청로5길,447,180,267
2014,4,A,골목상권,1000008,북촌로5나길,1502,1054,448
2014,4,A,골목상권,1000007,북촌로5길,43,20,23
2014,4,A,골목상권,1000006,북촌로11길,17,9,8
2014,4,A,골목상권,1000005,백석동길,83,42,41
2014,4,A,골목상권,1000004,명륜길,10,7,3
2014,4,A,골목상권,1000003,돈화문로11가길,1092,600,492
2014,4,A,골목상권,1000001,계동길,780,367,413
2014,3,U,관광특구,1001496,강남 마이스 관광특구,22365,12773,9592
2014,3,U,관광특구,1001495,잠실 관광특구,25151,15240,9911
2014,3,U,관광특구,1001494,종로?청계 관광특구,29620,18806,10814
2014,3,U,관광특구,1001493,동대문패션타운 관광특구,14228,9610,4618
2014,3,U,관광특구,1001492,명동 남대문 북창동 다동 무교동 관광특구,175557,91363,84194
2014,3,U,관광특구,1001491,이태원 관광특구,5599,3213,2386
2014,3,R,전통시장,1001490,길동복조리시장,529,324,205
2014,3,R,전통시장,1001489,둔촌역전통시장,144,74,70
2014,3,R,전통시장,1001488,성내골목시장,6,2,4
2014,3,R,전통시장,1001487,천호시장,6,2,4
2014,3,R,전통시장,1001483,암사종합시장,535,242,293
2014,3,R,전통시장,1001482,고덕전통시장,402,389,13
2014,3,R,전통시장,1001481,명일골목시장,128,60,68
2014,3,R,전통시장,1001480,새마을시장,319,172,147
2014,3,R,전통시장,1001479,석촌시장,182,121,61
2014,3,R,전통시장,1001478,방이시장,638,423,215
2014,3,R,전통시장,1001477,마천시장,245,63,182
2014,3,R,전통시장,1001476,풍납시장,10,2,8
2014,3,R,전통시장,1001475,강남개포시장,45,35,10
2014,3,R,전통시장,1001474,도곡시장,525,245,280
2014,3,R,전통시장,1001471,영동전통시장,2700,2112,588
2014,3,R,전통시장,1001466,미성동도깨비시장,407,165,242
2014,3,R,전통시장,1001464,삼성동시장,185,97,88
2014,3,R,전통시장,1001463,신림중앙시장,12,8,4
2014,3,R,전통시장,1001462,강남골목시장,428,207,221
2014,3,R,전통시장,1001460,관악신사시장,294,222,72
2014,3,R,전통시장,1001459,신원시장,335,150,185
2014,3,R,전통시장,1001458,인헌시장,201,66,135
2014,3,R,전통시장,1001456,봉천현대시장,11,5,6
2014,3,R,전통시장,1001454,봉천제일종합시장,44,24,20
2014,3,R,전통시장,1001453,낙성대시장,21,13,8
2014,3,R,전통시장,1001452,중부시장,160,50,110
2014,3,R,전통시장,1001450,남성역골목시장,469,223,246
2014,3,R,전통시장,1001449,남성사계시장,1933,860,1073
2014,3,R,전통시장,1001448,흑석시장,168,52,116
2014,3,R,전통시장,1001447,상도4동도깨비골목시장,330,98,232
2014,3,R,전통시장,1001445,영도시장,101,42,59
2014,3,R,전통시장,1001441,본동인정시장,129,61,68
2014,3,R,전통시장,1001439,대림중앙시장,18,13,5
2014,3,R,전통시장,1001438,우리시장,23,10,13
2014,3,R,전통시장,1001437,영진시장A동,41,33,8
2014,3,R,전통시장,1001433,영일시장,4,2,2
2014,3,R,전통시장,1001431,영등포청과시장,160,96,64
2014,3,R,전통시장,1001430,영등포전통시장,4144,2089,2055
2014,3,R,전통시장,1001429,은행나무시장,40,9,31
2014,3,R,전통시장,1001427,현대시장,56,15,41
2014,3,R,전통시장,1001424,남문시장,385,143,242
2014,3,R,전통시장,1001423,독산동 우시장,127,53,74
2014,3,R,전통시장,1001421,개봉중앙시장,7,4,3
2014,3,R,전통시장,1001419,가리봉시장,14,7,7
2014,3,R,전통시장,1001418,남구로시장,7,4,3
2014,3,R,전통시장,1001417,구로시장,50,25,25
2014,3,R,전통시장,1001415,방신전통시장,176,139,37
2014,3,R,전통시장,1001414,송화골목시장,466,157,309
2014,3,R,전통시장,1001413,까치산시장,33,18,15
2014,3,R,전통시장,1001411,남부골목시장,171,76,95
2014,3,R,전통시장,1001409,화곡중앙골목시장,2,2,0
2014,3,R,전통시장,1001407,등마루시장,819,543,276
2014,3,R,전통시장,1001406,신정3동골목시장,213,92,121
2014,3,R,전통시장,1001405,신정2동골목시장,10,7,3
2014,3,R,전통시장,1001402,신월6동골목시장,255,110,145
2014,3,R,전통시장,1001401,신곡종합시장,22,13,9
2014,3,R,전통시장,1001400,신월3동골목시장,53,19,34
2014,3,R,전통시장,1001399,경창시장,158,88,70
2014,3,R,전통시장,1001398,월정로시장,91,52,39
2014,3,R,전통시장,1001397,신영시장,40,20,20
2014,3,R,전통시장,1001396,목4동시장,225,72,153
2014,3,R,전통시장,1001395,목3동시장,522,227,295
2014,3,R,전통시장,1001394,목2동시장,171,87,84
2014,3,R,전통시장,1001393,마포농수산물시장,375,249,126
2014,3,R,전통시장,1001391,망원월드컵시장,13,7,6
2014,3,R,전통시장,1001390,망원시장,41,23,18
2014,3,R,전통시장,1001386,신수시장,237,146,91
2014,3,R,전통시장,1001385,아현시장,68,46,22
2014,3,R,전통시장,1001374,대림골목시장,252,73,179
2014,3,R,전통시장,1001367,상계중앙시장,32,17,15
2014,3,R,전통시장,1001364,방학동도깨비시장,128,57,71
2014,3,R,전통시장,1001363,쌍문역골목시장,45,20,25
2014,3,R,전통시장,1001361,신도봉시장,9,3,6
2014,3,R,전통시장,1001359,창동신창시장,103,37,66
2014,3,R,전통시장,1001357,장미원골목시장,52,35,17
2014,3,R,전통시장,1001356,수유중앙시장,143,81,62
2014,3,R,전통시장,1001355,강북종합시장,50,18,32
2014,3,R,전통시장,1001354,우이시장,151,88,63
2014,3,R,전통시장,1001353,수유전통시장,461,148,313
2014,3,R,전통시장,1001352,번동북부골목시장,99,60,39
2014,3,R,전통시장,1001351,솔샘시장,88,30,58
2014,3,R,전통시장,1001349,방천골목시장,72,24,48
2014,3,R,전통시장,1001347,석관황금시장,44,24,20
2014,3,R,전통시장,1001343,장위전통시장,176,56,120
2014,3,R,전통시장,1001340,정릉시장,37,15,22
2014,3,R,전통시장,1001339,정릉아리랑시장,7,4,3
2014,3,R,전통시장,1001338,돈암제일시장,79,53,26
2014,3,R,전통시장,1001336,우림골목시장,219,107,112
2014,3,R,전통시장,1001335,묵1동도깨비시장,282,105,177
2014,3,R,전통시장,1001334,태능시장,3,2,1
2014,3,R,전통시장,1001333,중화제일시장,21,0,21
2014,3,R,전통시장,1001332,사가정시장,239,189,50
2014,3,R,전통시장,1001330,동원시장,37,16,21
2014,3,R,전통시장,1001329,동부골목시장,74,31,43
2014,3,R,전통시장,1001326,회기시장,126,53,73
2014,3,R,전통시장,1001323,답십리시장,15,11,4
2014,3,R,전통시장,1001321,답십리현대시장,90,67,23
2014,3,R,전통시장,1001319,청량리종합시장,9,7,2
2014,3,R,전통시장,1001317,청량리농수산물시장,15,13,2
2014,3,R,전통시장,1001316,서울약령시장,1284,833,451
2014,3,R,전통시장,1001313,청량리수산시장,155,80,75
2014,3,R,전통시장,1001310,구의시장,92,53,39
2014,3,R,전통시장,1001309,조양시장,65,40,25
2014,3,R,전통시장,1001308,영동교골목시장,19,11,8
2014,3,R,전통시장,1001307,능동로골목시장,266,252,14
2014,3,R,전통시장,1001304,자양골목시장,97,38,59
2014,3,R,전통시장,1001301,중곡제일시장,124,64,60
2014,3,R,전통시장,1001299,한아름시장,74,40,34
2014,3,R,전통시장,1001298,성동용답상가시장,227,114,113
2014,3,R,전통시장,1001297,뚝도시장,27,9,18
2014,3,R,전통시장,1001296,금남시장,15,12,3
2014,3,R,전통시장,1001295,행당시장,204,99,105
2014,3,R,전통시장,1001294,마장축산물시장,1431,993,438
2014,3,R,전통시장,1001289,용문전통시장,32,22,10
2014,3,R,전통시장,1001286,후암시장,27,10,17
2014,3,R,전통시장,1001285,합동(새벽)시장,2379,1238,1141
2014,3,R,전통시장,1001284,서울중앙시장,216,156,60
2014,3,R,전통시장,1001283,백학시장,462,254,208
2014,3,R,전통시장,1001282,약수시장,1439,546,893
2014,3,R,전통시장,1001281,청평화시장,2343,1649,694
2014,3,R,전통시장,1001280,제일평화시장,467,291,176
2014,3,R,전통시장,1001278,남평화시장,138,95,43
2014,3,R,전통시장,1001277,방산종합시장,1671,1130,541
2014,3,R,전통시장,1001275,인현시장,1249,831,418
2014,3,R,전통시장,1001274,신중부시장,2412,1638,774
2014,3,R,전통시장,1001273,남대문시장,6947,3776,3171
2014,3,R,전통시장,1001271,동묘시장,867,551,316
2014,3,R,전통시장,1001270,창신골목시장,209,120,89
2014,3,R,전통시장,1001268,충신시장,334,187,147
2014,3,R,전통시장,1001267,종로신진시장,20,9,11
2014,3,R,전통시장,1001266,동대문종합시장,226,154,72
2014,3,R,전통시장,1001265,광장시장,200,140,60
2014,3,D,발달상권,1001263,서울 노원구 노원역_3,633,267,366
2014,3,D,발달상권,1001261,서울 노원구 노원역_1,1069,322,747
2014,3,D,발달상권,1001260,창동역,2051,1347,704
2014,3,D,발달상권,1001259,서울 강북구 수유역_3,50,28,22
2014,3,D,발달상권,1001257,서울 강북구 수유역_2,3838,2010,1828
2014,3,D,발달상권,1001256,서울 강북구 수유역_1,67,48,19
2014,3,D,발달상권,1001255,서울 은평구 연신내역_3,538,173,365
2014,3,D,발달상권,1001254,서울 은평구 연신내역_2,309,132,177
2014,3,D,발달상권,1001253,서울 은평구 연신내역_1,46,20,26
2014,3,D,발달상권,1001252,서울 성북구 미아삼거리역_2,569,262,307
2014,3,D,발달상권,1001251,서울 강북구 미아삼거리역_1,439,158,281
2014,3,D,발달상권,1001250,서울 은평구 불광역_3,43,16,27
2014,3,D,발달상권,1001249,서울 은평구 불광역_2,68,25,43
2014,3,D,발달상권,1001248,서울 은평구 불광역_1,223,94,129
2014,3,D,발달상권,1001247,미아사거리_2,111,65,46
2014,3,D,발달상권,1001246,미아사거리_1,492,200,292
2014,3,D,발달상권,1001245,서울 성북구 성신여대입구역,4894,3048,1846
2014,3,D,발달상권,1001244,경희대학교,336,157,179
2014,3,D,발달상권,1001243,서울 성북구 안암역,64,35,29
2014,3,D,발달상권,1001242,혜화역 대학로_3,10153,3114,7039
2014,3,D,발달상권,1001241,혜화역 대학로_2,1393,824,569
2014,3,D,발달상권,1001240,혜화역 대학로_1,1155,613,542
2014,3,D,발달상권,1001239,디지털미디어시티,13683,9193,4490
2014,3,D,발달상권,1001238,서울 동대문구 청량리역,3191,2090,1101
2014,3,D,발달상권,1001236,서울 종로구 안국역_2,756,317,439
2014,3,D,발달상권,1001235,서울 종로구 안국역_1,12091,10040,2051
2014,3,D,발달상권,1001234,서울 종로구 경복궁역_1,189,74,115
2014,3,D,발달상권,1001233,서울 종로구 종로3가역_3,2839,1610,1229
2014,3,D,발달상권,1001232,서울 종로구 종로3가역_2,1873,1026,847
2014,3,D,발달상권,1001231,서울 동대문구 신설동역_2,3899,2008,1891
2014,3,D,발달상권,1001230,인사동,21645,13921,7724
2014,3,D,발달상권,1001229,서울 종로구 종로5가역_4,620,340,280
2014,3,D,발달상권,1001228,서울 종로구 종로5가역_3,5125,3477,1648
2014,3,D,발달상권,1001227,종로구청,14961,9043,5918
2014,3,D,발달상권,1001226,서울 종로구 종로5가역_2,14491,9283,5208
2014,3,D,발달상권,1001225,신설동역,682,426,256
2014,3,D,발달상권,1001224,서울 동대문구 신설동역_1,2,2,0
2014,3,D,발달상권,1001223,서울 종로구 광화문역_2,50793,32166,18627
2014,3,D,발달상권,1001222,동묘앞역,58,41,17
2014,3,D,발달상권,1001221,장안동사거리,479,247,232
2014,3,D,발달상권,1001220,서울 종로구 동대문역_2,769,456,313
2014,3,D,발달상권,1001218,동대문시장_2,461,302,159
2014,3,D,발달상권,1001217,서울 종로구 종로5가역_1,49,34,15
2014,3,D,발달상권,1001216,서울 종로구 종로3가역_1,3295,1499,1796
2014,3,D,발달상권,1001215,서울 종로구 광화문역_1,2145,1398,747
2014,3,D,발달상권,1001214,종각역,20746,13844,6902
2014,3,D,발달상권,1001213,종각역 젊음의 거리,1736,885,851
2014,3,D,발달상권,1001212,서대문구 서대문역_1,2524,827,1697
2014,3,D,발달상권,1001211,동대문시장_1,464,240,224
2014,3,D,발달상권,1001210,시청역_2,24724,15778,8946
2014,3,D,발달상권,1001209,서울시청,28092,13341,14751
2014,3,D,발달상권,1001208,서울 중구 을지로3가역_2,8541,5639,2902
2014,3,D,발달상권,1001207,서울 중구 신당역_2,966,537,429
2014,3,D,발달상권,1001206,서대문구 서대문역_2,2107,1435,672
2014,3,D,발달상권,1001205,동대문역사문화공원역,4408,2762,1646
2014,3,D,발달상권,1001204,서울 중구 을지로3가역_1,14874,10223,4651
2014,3,D,발달상권,1001203,명동거리,18466,9631,8835
2014,3,D,발달상권,1001202,롯데백화점,56999,31125,25874
2014,3,D,발달상권,1001201,서울 중구 신당역_1,1087,710,377
2014,3,D,발달상권,1001200,북창동,7371,4732,2639
2014,3,D,발달상권,1001199,서울 중구 충무로역_2,16168,7584,8584
2014,3,D,발달상권,1001198,서울 강서구 송정역,581,393,188
2014,3,D,발달상권,1001197,장한평역_2,11959,9686,2273
2014,3,D,발달상권,1001196,시청역_1,63049,36795,26254
2014,3,D,발달상권,1001195,왕십리역_2,988,605,383
2014,3,D,발달상권,1001194,서울 강서구 발산역,697,459,238
2014,3,D,발달상권,1001193,장한평역_1,2525,1697,828
2014,3,D,발달상권,1001192,서울 중구 충무로역_1,2676,1823,853
2014,3,D,발달상권,1001190,장한평역,2157,1490,667
2014,3,D,발달상권,1001189,서울 중구 명동역,2745,1420,1325
2014,3,D,발달상권,1001188,장충동 족발거리,198,87,111
2014,3,D,발달상권,1001187,한양시장,196,100,96
2014,3,D,발달상권,1001186,서울 서대문구 이대역,1239,489,750
2014,3,D,발달상권,1001185,서울 서대문구 신촌역,2694,1156,1538
2014,3,D,발달상권,1001184,서울 마포구 홍대입구역_3,778,547,231
2014,3,D,발달상권,1001183,서울 마포구 홍대입구역_2,2837,1336,1501
2014,3,D,발달상권,1001182,홍익대학교 주변,16924,8517,8407
2014,3,D,발달상권,1001181,서울 광진구 군자역,159,97,62
2014,3,D,발달상권,1001180,신촌역,181,105,76
2014,3,D,발달상권,1001179,강서구청,3408,2322,1086
2014,3,D,발달상권,1001178,서울 마포구 홍대입구역_1,748,460,288
2014,3,D,발달상권,1001175,서울 강동구 고덕역,455,267,188
2014,3,D,발달상권,1001173,서울 강동구 명일역,861,349,512
2014,3,D,발달상권,1001172,어린이대공원역,99,65,34
2014,3,D,발달상권,1001171,서울 마포구 공덕역_2,2811,1941,870
2014,3,D,발달상권,1001170,공덕역,6541,4192,2349
2014,3,D,발달상권,1001169,서울 용산구 숙대입구역,4154,2934,1220
2014,3,D,발달상권,1001168,남영역,14157,6548,7609
2014,3,D,발달상권,1001167,서울 마포구 공덕역_1,3876,1884,1992
2014,3,D,발달상권,1001166,서울 마포구 마포역_2,1235,592,643
2014,3,D,발달상권,1001165,서울 광진구 건대입구역_2,2579,897,1682
2014,3,D,발달상권,1001164,서울 마포구 마포역_1,9870,6130,3740
2014,3,D,발달상권,1001163,서울 강동구 천호역_2,3669,1786,1883
2014,3,D,발달상권,1001162,서울 광진구 건대입구역_1,975,530,445
2014,3,D,발달상권,1001161,건대입구역,714,402,312
2014,3,D,발달상권,1001160,서울 광진구 구의역,1060,688,372
2014,3,D,발달상권,1001159,서울 강동구 천호역,882,409,473
2014,3,D,발달상권,1001158,당산역_2,4897,3005,1892
2014,3,D,발달상권,1001156,서울 강동구 길동역,1862,1146,716
2014,3,D,발달상권,1001155,용산 전자상가_5,2170,1666,504
2014,3,D,발달상권,1001153,당산역_1,1084,672,412
2014,3,D,발달상권,1001152,서울 광진구 강변역,2041,1684,357
2014,3,D,발달상권,1001151,용산 전자상가_3,2552,1925,627
2014,3,D,발달상권,1001150,서울 용산구 이태원역,843,503,340
2014,3,D,발달상권,1001149,한남오거리,565,321,244
2014,3,D,발달상권,1001147,용산 전자상가_2,444,367,77
2014,3,D,발달상권,1001146,용산구청,79,44,35
2014,3,D,발달상권,1001145,용산 전자상가_1,8984,6860,2124
2014,3,D,발달상권,1001144,국회의사당역_2,36754,21609,15145
2014,3,D,발달상권,1001143,서울 용산구 신용산역,298,128,170
2014,3,D,발달상권,1001142,국회의사당역_1,5705,4455,1250
2014,3,D,발달상권,1001141,압구정 로데오거리_2,12906,5368,7538
2014,3,D,발달상권,1001140,서울 강남구 압구정역,9658,4693,4965
2014,3,D,발달상권,1001139,서울 영등포구 영등포구청역,3866,1356,2510
2014,3,D,발달상권,1001138,압구정 로데오거리_1,7296,2340,4956
2014,3,D,발달상권,1001137,서울 강동구 둔촌동역,48,19,29
2014,3,D,발달상권,1001136,오목교역,234,117,117
2014,3,D,발달상권,1001135,신사동 가로수길,20505,9585,10920
2014,3,D,발달상권,1001134,서울 영등포구 여의도역_2,45171,30020,15151
2014,3,D,발달상권,1001133,청담사거리_3,1333,419,914
2014,3,D,발달상권,1001132,영등포유통상가,1873,1302,571
2014,3,D,발달상권,1001131,청담역_2,1746,1369,377
2014,3,D,발달상권,1001130,청담역_1,205,165,40
2014,3,D,발달상권,1001129,청담사거리_2,1014,829,185
2014,3,D,발달상권,1001127,서울 영등포구 여의도역_1,54599,33310,21289
2014,3,D,발달상권,1001125,학동사거리_2,2804,1681,1123
2014,3,D,발달상권,1001124,서울 영등포구 영등포시장역,360,290,70
2014,3,D,발달상권,1001123,학동사거리_1,4223,2126,2097
2014,3,D,발달상권,1001122,여의도 시범아파트앞,2329,1538,791
2014,3,D,발달상권,1001121,영등포역_3,867,530,337
2014,3,D,발달상권,1001120,도산공원사거리_1,10114,6146,3968
2014,3,D,발달상권,1001119,영등포역_2,1036,588,448
2014,3,D,발달상권,1001118,문래동 주민센터,82,64,18
2014,3,D,발달상권,1001117,강남구 신사역_2,7507,5118,2389
2014,3,D,발달상권,1001115,서울 강남구 강남구청역_2,3661,2293,1368
2014,3,D,발달상권,1001114,강남구 신사역_1,2543,1175,1368
2014,3,D,발달상권,1001113,서울 동작구 노량진1동_1,88,38,50
2014,3,D,발달상권,1001112,서울 강남구 학동역_3,7252,4321,2931
2014,3,D,발달상권,1001111,서울 강남구 강남구청역_1,2906,1730,1176
2014,3,D,발달상권,1001110,잠실역,4525,3593,932
2014,3,D,발달상권,1001109,강남구 논현역_4,8122,3695,4427
2014,3,D,발달상권,1001108,학동역,929,467,462
2014,3,D,발달상권,1001107,방이동 먹자골목,5727,3932,1795
2014,3,D,발달상권,1001106,서울 강남구 학동역_2,5486,2636,2850
2014,3,D,발달상권,1001105,서울 동작구 노량진역,3479,2076,1403
2014,3,D,발달상권,1001104,삼성역_3,8740,4727,4013
2014,3,D,발달상권,1001103,코엑스,22365,12773,9592
2014,3,D,발달상권,1001102,서울 강남구 학동역_1,5933,3579,2354
2014,3,D,발달상권,1001101,선정릉역_2,5629,3596,2033
2014,3,D,발달상권,1001100,강남구 논현역_3,1636,833,803
2014,3,D,발달상권,1001099,포스코사거리_2,7834,4832,3002
2014,3,D,발달상권,1001098,포스코사거리_1,33834,21449,12385
2014,3,D,발달상권,1001097,잠실역 롯데월드,2770,1396,1374
2014,3,D,발달상권,1001096,신도림역,3764,2044,1720
2014,3,D,발달상권,1001095,강남구 논현역_2,7765,3856,3909
2014,3,D,발달상권,1001094,선정릉역_1,1363,951,412
2014,3,D,발달상권,1001093,신천역,6115,3361,2754
2014,3,D,발달상권,1001092,강남구 논현역_1,3021,1974,1047
2014,3,D,발달상권,1001091,삼성역_2,17519,10365,7154
2014,3,D,발달상권,1001090,삼정역_2,2531,1133,1398
2014,3,D,발달상권,1001089,삼정역_1,3012,1634,1378
2014,3,D,발달상권,1001088,삼성역_1,26418,17114,9304
2014,3,D,발달상권,1001087,서울 강남구 선릉역_2,6703,4272,2431
2014,3,D,발달상권,1001086,고속터미널역,14765,4660,10105
2014,3,D,발달상권,1001085,서울 서초구 강남역,31373,17774,13599
2014,3,D,발달상권,1001084,서울 강남구 선릉역_1,18377,8459,9918
2014,3,D,발달상권,1001082,선릉역_2,19698,10764,8934
2014,3,D,발달상권,1001081,서울 강남구 역삼역_2,26074,20598,5476
2014,3,D,발달상권,1001080,서울 송파구 석촌역_1,44,30,14
2014,3,D,발달상권,1001078,서울 강남구 강남역_2,6649,4351,2298
2014,3,D,발달상권,1001077,선릉역_1,70195,40217,29978
2014,3,D,발달상권,1001076,구로역,171,103,68
2014,3,D,발달상권,1001075,역삼역_2,4401,2458,1943
2014,3,D,발달상권,1001074,대림역_2,6594,5176,1418
2014,3,D,발달상권,1001073,서울 강남구 역삼역_1,25259,16026,9233
2014,3,D,발달상권,1001072,신대방삼거리역,290,170,120
2014,3,D,발달상권,1001071,서울 강남구 한티역,1366,513,853
2014,3,D,발달상권,1001070,은마아파트입구사거리_4,59,35,24
2014,3,D,발달상권,1001067,오류동역,1257,691,566
2014,3,D,발달상권,1001066,서울 강남구 강남역,39667,18739,20928
2014,3,D,발달상권,1001063,교대역_4,4800,2806,1994
2014,3,D,발달상권,1001062,서울 강남구 강남역_1,136211,99701,36510
2014,3,D,발달상권,1001061,방배동카페골목,100,39,61
2014,3,D,발달상권,1001060,가락시장,14346,9591,4755
2014,3,D,발달상권,1001059,교대역_3,4450,2785,1665
2014,3,D,발달상권,1001058,역삼역_1,1760,970,790
2014,3,D,발달상권,1001057,교대역_2,3036,1956,1080
2014,3,D,발달상권,1001056,서울 송파구 가락시장역,5339,3384,1955
2014,3,D,발달상권,1001055,서울 서초구 서초역,10956,4503,6453
2014,3,D,발달상권,1001054,서울 강남구 대치역_2,1275,791,484
2014,3,D,발달상권,1001052,뱅뱅사거리_2,25221,15747,9474
2014,3,D,발달상권,1001051,보라매공원,13735,8029,5706
2014,3,D,발달상권,1001050,교대역_1,13593,8058,5535
2014,3,D,발달상권,1001049,개봉동 현대아파트 인근,166,85,81
2014,3,D,발달상권,1001048,뱅뱅사거리,10410,7374,3036
2014,3,D,발달상권,1001047,뱅뱅사거리_1,9705,6944,2761
2014,3,D,발달상권,1001046,서울 관악구 신림역_4,900,442,458
2014,3,D,발달상권,1001045,동작구 총신대입구역_1,243,124,119
2014,3,D,발달상권,1001044,양재역_3,3225,2218,1007
2014,3,D,발달상권,1001043,동작구 총신대입구역_2,1082,561,521
2014,3,D,발달상권,1001042,서울 서초구 남부터미널역_3,1797,1072,725
2014,3,D,발달상권,1001041,서울 강남구 수서역,18796,11104,7692
2014,3,D,발달상권,1001039,서울 서초구 남부터미널역_2,9774,5034,4740
2014,3,D,발달상권,1001038,구로디지탈1단지,63179,41875,21304
2014,3,D,발달상권,1001037,양재역,153,83,70
2014,3,D,발달상권,1001035,매봉역,273,146,127
2014,3,D,발달상권,1001034,서울 서초구 방배역,3714,2217,1497
2014,3,D,발달상권,1001033,서울 서초구 남부터미널역_1,675,468,207
2014,3,D,발달상권,1001032,서울 관악구 신림역_2,24,14,10
2014,3,D,발달상권,1001031,서울 관악구 신림역_1,1754,844,910
2014,3,D,발달상권,1001030,양재역_2,8220,4555,3665
2014,3,D,발달상권,1001029,양재역_1,854,576,278
2014,3,D,발달상권,1001028,서울 관악구 서울대입구역_2,38,3,35
2014,3,D,발달상권,1001027,가산디지털단지역_3,28133,17023,11110
2014,3,D,발달상권,1001026,구로디지털단지역,2639,1809,830
2014,3,D,발달상권,1001025,서울 관악구 서울대입구역_1,2158,1000,1158
2014,3,D,발달상권,1001024,관악구 사당역_1,4260,1895,2365
2014,3,D,발달상권,1001023,가산디지털단지역_2,52837,32695,20142
2014,3,D,발달상권,1001022,관악구 사당역_2,398,190,208
2014,3,D,발달상권,1001021,가산디지털단지역_1,24367,16416,7951
2014,3,D,발달상권,1001020,장지역,3502,2323,1179
2014,3,D,발달상권,1001019,포이사거리_1,5568,2931,2637
2014,3,D,발달상권,1001018,포이사거리_2,7714,5018,2696
2014,3,D,발달상권,1001016,서울 관악구 대학동_1,68,41,27
2014,3,D,발달상권,1001015,서울 금천구 독산1동_1,2198,1585,613
2014,3,D,발달상권,1001013,양재 화물트럭터미널앞_2,229,102,127
2014,3,D,발달상권,1001012,양재 화물트럭터미널앞_1,4433,3474,959
2014,3,D,발달상권,1001011,서울 금천구 시흥1동_4,895,465,430
2014,3,A,골목상권,1001010,풍성로37가길,32,15,17
2014,3,A,골목상권,1001009,천호옛길,588,420,168
2014,3,A,골목상권,1001008,천호옛14길,556,287,269
2014,3,A,골목상권,1001007,천호대로219길,863,494,369
2014,3,A,골목상권,1001006,천호대로197길,21,8,13
2014,3,A,골목상권,1001005,천호대로187길,710,422,288
2014,3,A,골목상권,1001004,천호대로170길,324,116,208
2014,3,A,골목상권,1001003,천호대로162길,995,697,298
2014,3,A,골목상권,1001002,천중로51길,408,218,190
2014,3,A,골목상권,1001001,천중로39길,652,239,413
2014,3,A,골목상권,1001000,진황도로47길,1186,654,532
2014,3,A,골목상권,1000999,진황도로27길,375,228,147
2014,3,A,골목상권,1000998,올림픽로98길,39,23,16
2014,3,A,골목상권,1000995,올림픽로77길,8,3,5
2014,3,A,골목상권,1000994,올림픽로71길,246,174,72
2014,3,A,골목상권,1000993,올림픽로48길,5348,3302,2046
2014,3,A,골목상권,1000992,양재대로96길,1380,868,512
2014,3,A,골목상권,1000991,양재대로95길,574,319,255
2014,3,A,골목상권,1000990,양재대로91길,973,519,454
2014,3,A,골목상권,1000989,양재대로133길,265,103,162
2014,3,A,골목상권,1000988,양재대로124길,532,328,204
2014,3,A,골목상권,1000987,양재대로116길,175,73,102
2014,3,A,골목상권,1000986,양재대로101길,1197,687,510
2014,3,A,골목상권,1000985,암사길,339,152,187
2014,3,A,골목상권,1000984,성안로3길,1252,770,482
2014,3,A,골목상권,1000983,성내로5길,914,540,374
2014,3,A,골목상권,1000982,상일로5길,43,27,16
2014,3,A,골목상권,1000981,상암로5길,484,219,265
2014,3,A,골목상권,1000980,상암로51길,703,301,402
2014,3,A,골목상권,1000979,상암로4길,209,163,46
2014,3,A,골목상권,1000978,상암로14길,398,231,167
2014,3,A,골목상권,1000977,명일로13길,32,12,20
2014,3,A,골목상권,1000976,동남로85길,125,67,58
2014,3,A,골목상권,1000975,동남로82길,9,4,5
2014,3,A,골목상권,1000974,동남로65길,68,27,41
2014,3,A,골목상권,1000973,구천면로42길,323,164,159
2014,3,A,골목상권,1000972,구천면로41길,540,237,303
2014,3,A,골목상권,1000971,구천면로36길,36,21,15
2014,3,A,골목상권,1000969,고덕로25길,4,2,2
2014,3,A,골목상권,1000968,고덕로10길,194,107,87
2014,3,A,골목상권,1000967,강동대로53길,813,444,369
2014,3,A,골목상권,1000966,풍성로25길,991,377,614
2014,3,A,골목상권,1000965,오금로46길,1308,660,648
2014,3,A,골목상권,1000964,오금로36길,1611,1259,352
2014,3,A,골목상권,1000963,오금로11길,2427,1631,796
2014,3,A,골목상권,1000962,양재대로72길,622,345,277
2014,3,A,골목상권,1000961,양재대로71길,1046,655,391
2014,3,A,골목상권,1000960,양재대로64길,1489,649,840
2014,3,A,골목상권,1000959,양재대로62길,5410,3234,2176
2014,3,A,골목상권,1000958,송파대로30길,1595,1042,553
2014,3,A,골목상권,1000957,송이로36길,1859,1381,478
2014,3,A,골목상권,1000956,송이로32길,734,426,308
2014,3,A,골목상권,1000955,송이로23길,1635,932,703
2014,3,A,골목상권,1000954,삼전로13길,1628,938,690
2014,3,A,골목상권,1000953,백제고분로50길,3455,1833,1622
2014,3,A,골목상권,1000952,백제고분로46길,1581,1004,577
2014,3,A,골목상권,1000951,백제고분로45길,492,332,160
2014,3,A,골목상권,1000950,백제고분로42길,243,184,59
2014,3,A,골목상권,1000949,백제고분로39길,1113,878,235
2014,3,A,골목상권,1000948,백제고분로34길,1538,998,540
2014,3,A,골목상권,1000947,백제고분로33길,748,488,260
2014,3,A,골목상권,1000946,백제고분로32길,1018,457,561
2014,3,A,골목상권,1000945,백제고분로31길,295,189,106
2014,3,A,골목상권,1000944,백제고분로22길,1046,634,412
2014,3,A,골목상권,1000943,백제고분로21길,188,137,51
2014,3,A,골목상권,1000942,마천로51길,119,47,72
2014,3,A,골목상권,1000941,동남로20길,169,92,77
2014,3,A,골목상권,1000940,거마로20길,328,149,179
2014,3,A,골목상권,1000939,학동로77길,2948,1570,1378
2014,3,A,골목상권,1000938,학동로6길,2365,1165,1200
2014,3,A,골목상권,1000937,학동로56길,847,550,297
2014,3,A,골목상권,1000936,학동로38길,7186,4880,2306
2014,3,A,골목상권,1000935,테헤란로81길,520,126,394
2014,3,A,골목상권,1000934,일원로9길,492,265,227
2014,3,A,골목상권,1000933,일원로3길,232,108,124
2014,3,A,골목상권,1000932,영동대로65길,2781,1672,1109
2014,3,A,골목상권,1000931,영동대로112길,451,320,131
2014,3,A,골목상권,1000930,언주로81길,9138,4468,4670
2014,3,A,골목상권,1000929,압구정로2길,2780,1535,1245
2014,3,A,골목상권,1000928,선릉로18길,502,301,201
2014,3,A,골목상권,1000927,선릉로146길,1651,873,778
2014,3,A,골목상권,1000926,선릉로133길,150,79,71
2014,3,A,골목상권,1000925,선릉로132길,947,504,443
2014,3,A,골목상권,1000924,선릉로121길,1814,1004,810
2014,3,A,골목상권,1000923,삼성로75길,2533,1358,1175
2014,3,A,골목상권,1000922,삼성로69길,238,128,110
2014,3,A,골목상권,1000921,삼성로64길,546,271,275
2014,3,A,골목상권,1000920,삼성로63길,152,83,69
2014,3,A,골목상권,1000919,삼성로57길,897,289,608
2014,3,A,골목상권,1000918,삼성로147길,956,445,511
2014,3,A,골목상권,1000917,삼성로115길,313,195,118
2014,3,A,골목상권,1000916,봉은사로68길,190,98,92
2014,3,A,골목상권,1000915,봉은사로57길,682,486,196
2014,3,A,골목상권,1000914,봉은사로43길,1085,697,388
2014,3,A,골목상권,1000913,봉은사로29길,158,106,52
2014,3,A,골목상권,1000912,봉은사로109길,322,218,104
2014,3,A,골목상권,1000911,도산대로89길,2540,1114,1426
2014,3,A,골목상권,1000910,도산대로81길,4344,1461,2883
2014,3,A,골목상권,1000909,도산대로50길,2840,2226,614
2014,3,A,골목상권,1000908,도산대로38길,174,95,79
2014,3,A,골목상권,1000907,도산대로30길,2836,1387,1449
2014,3,A,골목상권,1000906,도산대로23길,1123,692,431
2014,3,A,골목상권,1000905,도산대로15길,1812,879,933
2014,3,A,골목상권,1000904,도곡로37길,3326,2189,1137
2014,3,A,골목상권,1000903,논현로8길,783,439,344
2014,3,A,골목상권,1000902,논현로63길,9551,2687,6864
2014,3,A,골목상권,1000901,논현로28길,12749,9307,3442
2014,3,A,골목상권,1000900,논현로26길,7049,4537,2512
2014,3,A,골목상권,1000898,논현로139길,1729,999,730
2014,3,A,골목상권,1000897,논현로123길,118,80,38
2014,3,A,골목상권,1000896,논현로115길,3648,2294,1354
2014,3,A,골목상권,1000895,논현로10길,2145,1389,756
2014,3,A,골목상권,1000894,논현로106길,3228,1769,1459
2014,3,A,골목상권,1000893,남부순환로365길,168,121,47
2014,3,A,골목상권,1000891,개포로28길,319,234,85
2014,3,A,골목상권,1000890,개포로20길,4251,2396,1855
2014,3,A,골목상권,1000889,개포로17길,3350,1960,1390
2014,3,A,골목상권,1000888,강남대로140길,4083,2292,1791
2014,3,A,골목상권,1000887,강남대로136길,1168,686,482
2014,3,A,골목상권,1000886,강남대로118길,608,340,268
2014,3,A,골목상권,1000885,서초중앙로8길,5818,4461,1357
2014,3,A,골목상권,1000884,방배중앙로21길,2249,874,1375
2014,3,A,골목상권,1000883,효령로72길,209,129,80
2014,3,A,골목상권,1000882,효령로34길,120,70,50
2014,3,A,골목상권,1000881,효령로31길,1278,827,451
2014,3,A,골목상권,1000880,효령로23길,711,456,255
2014,3,A,골목상권,1000879,청두곶길,2076,1538,538
2014,3,A,골목상권,1000878,주흥길,339,220,119
2014,3,A,골목상권,1000877,주흥15길,1535,994,541
2014,3,A,골목상권,1000876,언남길,2073,1534,539
2014,3,A,골목상권,1000875,신반포로45길,504,318,186
2014,3,A,골목상권,1000874,서초대로8길,242,156,86
2014,3,A,골목상권,1000873,서초대로64길,512,354,158
2014,3,A,골목상권,1000872,서초대로4길,790,583,207
2014,3,A,골목상권,1000871,서초대로25길,3737,2327,1410
2014,3,A,골목상권,1000870,서초대로23길,815,485,330
2014,3,A,골목상권,1000869,서초대로15길,1022,462,560
2014,3,A,골목상권,1000868,사평대로57길,240,119,121
2014,3,A,골목상권,1000867,사평대로26길,16,10,6
2014,3,A,골목상권,1000866,사평대로22길,1278,748,530
2014,3,A,골목상권,1000865,사임당로17길,1474,955,519
2014,3,A,골목상권,1000864,방배로42길,189,88,101
2014,3,A,골목상권,1000863,방배로35길,2137,1358,779
2014,3,A,골목상권,1000862,방배로18길,59,33,26
2014,3,A,골목상권,1000861,반포대로9길,709,475,234
2014,3,A,골목상권,1000860,바우뫼로39길,3209,1978,1231
2014,3,A,골목상권,1000859,마방로2길,3399,2198,1201
2014,3,A,골목상권,1000858,방배천로4안길,1801,1155,646
2014,3,A,골목상권,1000857,동산로19길,1389,943,446
2014,3,A,골목상권,1000856,동산로10길,2199,1266,933
2014,3,A,골목상권,1000855,동광로39길,45,23,22
2014,3,A,골목상권,1000854,동광로1길,1228,795,433
2014,3,A,골목상권,1000853,동광로12길,706,471,235
2014,3,A,골목상권,1000852,논현로27길,3627,2555,1072
2014,3,A,골목상권,1000851,논현로1길,568,356,212
2014,3,A,골목상권,1000850,남부순환로339길,11036,4728,6308
2014,3,A,골목상권,1000849,남부순환로325길,7835,4340,3495
2014,3,A,골목상권,1000848,남부순환로317길,1564,1189,375
2014,3,A,골목상권,1000847,고무래로8길,6438,3560,2878
2014,3,A,골목상권,1000846,강남대로8길,3124,2176,948
2014,3,A,골목상권,1000845,강남대로34길,894,611,283
2014,3,A,골목상권,1000844,강남대로23길,6290,4713,1577
2014,3,A,골목상권,1000843,소담길,30,8,22
2014,3,A,골목상권,1000842,원신길,273,115,158
2014,3,A,골목상권,1000840,양산길,498,344,154
2014,3,A,골목상권,1000839,호암로24길,537,218,319
2014,3,A,골목상권,1000838,호암로20길,40,26,14
2014,3,A,골목상권,1000837,행운길,94,60,34
2014,3,A,골목상권,1000836,행운1길,65,44,21
2014,3,A,골목상권,1000835,청림3길,25,16,9
2014,3,A,골목상권,1000834,청룡길,154,73,81
2014,3,A,골목상권,1000833,청룡8길,12,8,4
2014,3,A,골목상권,1000832,중앙길,290,105,185
2014,3,A,골목상권,1000831,조원중앙로2길,1114,786,328
2014,3,A,골목상권,1000830,조원로18길,968,485,483
2014,3,A,골목상권,1000829,조원로10길,258,122,136
2014,3,A,골목상권,1000828,장군봉2길,383,166,217
2014,3,A,골목상권,1000827,장군봉1길,95,16,79
2014,3,A,골목상권,1000826,인헌길,86,43,43
2014,3,A,골목상권,1000825,은천로25길,311,119,192
2014,3,A,골목상권,1000824,양녕로6길,734,445,289
2014,3,A,골목상권,1000823,신원로3길,19,13,6
2014,3,A,골목상권,1000822,신사로20길,47,26,21
2014,3,A,골목상권,1000820,신림로64길,235,127,108
2014,3,A,골목상권,1000819,신림로48길,81,47,34
2014,3,A,골목상권,1000818,신림로38길,47,23,24
2014,3,A,골목상권,1000817,신림로28길,307,220,87
2014,3,A,골목상권,1000816,신림로11길,475,429,46
2014,3,A,골목상권,1000815,신림동길,448,267,181
2014,3,A,골목상권,1000814,승방길,479,300,179
2014,3,A,골목상권,1000813,서림7길,235,81,154
2014,3,A,골목상권,1000812,봉천로33길,376,252,124
2014,3,A,골목상권,1000811,봉천로13길,194,60,134
2014,3,A,골목상권,1000810,복은길,177,64,113
2014,3,A,골목상권,1000808,법원단지9길,71,30,41
2014,3,A,골목상권,1000807,미성5길,61,32,29
2014,3,A,골목상권,1000806,대학길,55,29,26
2014,3,A,골목상권,1000805,대학14길,13,3,10
2014,3,A,골목상권,1000804,당곡길,333,162,171
2014,3,A,골목상권,1000803,남현길,230,77,153
2014,3,A,골목상권,1000802,남현3길,675,389,286
2014,3,A,골목상권,1000800,남부순환로248길,238,116,122
2014,3,A,골목상권,1000799,남부순환로234길,129,92,37
2014,3,A,골목상권,1000798,남부순환로172길,1600,876,724
2014,3,A,골목상권,1000797,남부순환로161길,20,7,13
2014,3,A,골목상권,1000796,남부순환로151길,171,101,70
2014,3,A,골목상권,1000795,남부순환로142길,72,26,46
2014,3,A,골목상권,1000794,난향길,165,43,122
2014,3,A,골목상권,1000793,난우길,395,187,208
2014,3,A,골목상권,1000792,난곡로74길,173,70,103
2014,3,A,골목상권,1000791,난곡로34길,27,10,17
2014,3,A,골목상권,1000790,난곡로26길,87,39,48
2014,3,A,골목상권,1000789,난곡로24길,31,15,16
2014,3,A,골목상권,1000788,낙성대역길,767,504,263
2014,3,A,골목상권,1000787,국회단지길,502,229,273
2014,3,A,골목상권,1000786,구암길,69,23,46
2014,3,A,골목상권,1000785,관천로22길,10,3,7
2014,3,A,골목상권,1000784,관천로15길,130,76,54
2014,3,A,골목상권,1000783,관악로30길,210,62,148
2014,3,A,골목상권,1000782,관악로28길,159,75,84
2014,3,A,골목상권,1000781,관악로14길,470,273,197
2014,3,A,골목상권,1000780,관악로10길,203,122,81
2014,3,A,골목상권,1000779,흑석로9길,178,81,97
2014,3,A,골목상권,1000778,흑석로13길,154,20,134
2014,3,A,골목상권,1000777,장승배기로27길,30,16,14
2014,3,A,골목상권,1000776,장승배기로19길,1,1,0
2014,3,A,골목상권,1000774,여의대방로46길,354,97,257
2014,3,A,골목상권,1000773,여의대방로24길,13023,5746,7277
2014,3,A,골목상권,1000772,여의대방로22카길,280,121,159
2014,3,A,골목상권,1000771,여의대방로22나길,142,51,91
2014,3,A,골목상권,1000770,여의대방로22길,199,115,84
2014,3,A,골목상권,1000769,양녕로26길,128,67,61
2014,3,A,골목상권,1000768,신대방길,110,68,42
2014,3,A,골목상권,1000766,성대로1길,367,151,216
2014,3,A,골목상권,1000765,서달로8가길,195,84,111
2014,3,A,골목상권,1000763,서달로14길,57,28,29
2014,3,A,골목상권,1000762,서달로10길,75,33,42
2014,3,A,골목상권,1000761,상도로62길,174,72,102
2014,3,A,골목상권,1000760,상도로61길,62,35,27
2014,3,A,골목상권,1000759,상도로47길,81,56,25
2014,3,A,골목상권,1000758,상도로37길,1877,974,903
2014,3,A,골목상권,1000757,상도로15길,310,134,176
2014,3,A,골목상권,1000756,사당로8길,126,67,59
2014,3,A,골목상권,1000755,사당로30길,317,214,103
2014,3,A,골목상권,1000754,사당로2차길,104,70,34
2014,3,A,골목상권,1000753,사당로29길,18,14,4
2014,3,A,골목상권,1000752,사당로26길,236,128,108
2014,3,A,골목상권,1000751,사당로23나길,140,45,95
2014,3,A,골목상권,1000750,사당로23길,18,13,5
2014,3,A,골목상권,1000749,사당로20길,160,110,50
2014,3,A,골목상권,1000748,사당로16길,129,42,87
2014,3,A,골목상권,1000747,사당로16가길,739,488,251
2014,3,A,골목상권,1000746,만양로8길,56,19,37
2014,3,A,골목상권,1000745,만양로14길,441,205,236
2014,3,A,골목상권,1000744,등용로14길,592,455,137
2014,3,A,골목상권,1000743,동작대로7길,1518,674,844
2014,3,A,골목상권,1000742,동작대로35길,255,94,161
2014,3,A,골목상권,1000741,동작대로33길,96,50,46
2014,3,A,골목상권,1000740,동작대로29길,41,24,17
2014,3,A,골목상권,1000739,동작대로17길,1292,745,547
2014,3,A,골목상권,1000738,대방동2길,450,219,231
2014,3,A,골목상권,1000737,대방동27길,109,59,50
2014,3,A,골목상권,1000736,노량진로6길,111,34,77
2014,3,A,골목상권,1000735,국사봉길,29,2,27
2014,3,A,골목상권,1000734,국사봉2길,122,84,38
2014,3,A,골목상권,1000733,국사봉1길,6,1,5
2014,3,A,골목상권,1000732,영신로9길,240,125,115
2014,3,A,골목상권,1000731,영등포로84길,278,79,199
2014,3,A,골목상권,1000730,영등포로80길,39,29,10
2014,3,A,골목상권,1000729,영등포로62길,2,1,1
2014,3,A,골목상권,1000728,영등포로35길,60,45,15
2014,3,A,골목상권,1000727,영등포로27길,363,213,150
2014,3,A,골목상권,1000724,여의대방로43나길,2656,1933,723
2014,3,A,골목상권,1000723,여의대방로39길,14,10,4
2014,3,A,골목상권,1000722,여의대방로35길,631,327,304
2014,3,A,골목상권,1000721,양평로28길,675,547,128
2014,3,A,골목상권,1000720,양평로22라길,42,30,12
2014,3,A,골목상권,1000719,양평로19길,882,606,276
2014,3,A,골목상권,1000718,신길로60길,421,176,245
2014,3,A,골목상권,1000717,신길로42길,417,235,182
2014,3,A,골목상권,1000716,신길로42가길,92,26,66
2014,3,A,골목상권,1000715,신길로39길,86,48,38
2014,3,A,골목상권,1000714,신길로17길,60,27,33
2014,3,A,골목상권,1000713,선유서로28길,401,221,180
2014,3,A,골목상권,1000712,선유서로25길,2185,1578,607
2014,3,A,골목상권,1000711,선유서로24길,174,91,83
2014,3,A,골목상권,1000710,선유로55길,2149,1377,772
2014,3,A,골목상권,1000709,디지털로74길,47,28,19
2014,3,A,골목상권,1000708,디지털로57길,6,1,5
2014,3,A,골목상권,1000707,디지털로37길,183,88,95
2014,3,A,골목상권,1000706,도신로62길,199,50,149
2014,3,A,골목상권,1000705,도신로60길,77,11,66
2014,3,A,골목상권,1000704,도신로29길,82,35,47
2014,3,A,골목상권,1000703,도신로15길,93,53,40
2014,3,A,골목상권,1000702,도림천로21길,107,51,56
2014,3,A,골목상권,1000701,도림로63길,33,23,10
2014,3,A,골목상권,1000700,도림로147길,1601,1191,410
2014,3,A,골목상권,1000699,도림로112길,8,7,1
2014,3,A,골목상권,1000698,대림로8길,1881,647,1234
2014,3,A,골목상권,1000697,대림로7길,14,5,9
2014,3,A,골목상권,1000696,대림로44길,30,18,12
2014,3,A,골목상권,1000695,대림로34길,168,58,110
2014,3,A,골목상권,1000694,대림로31길,859,458,401
2014,3,A,골목상권,1000693,대림로29길,1533,754,779
2014,3,A,골목상권,1000692,대림로22길,311,169,142
2014,3,A,골목상권,1000691,당산로46길,3626,2266,1360
2014,3,A,골목상권,1000690,당산로38길,306,250,56
2014,3,A,골목상권,1000689,당산로37길,3484,2178,1306
2014,3,A,골목상권,1000688,당산로31길,4168,2371,1797
2014,3,A,골목상권,1000687,국회대로56길,1656,1073,583
2014,3,A,골목상권,1000686,경인로90길,303,181,122
2014,3,A,골목상권,1000685,경인로80길,1667,1234,433
2014,3,A,골목상권,1000684,경인로77길,592,461,131
2014,3,A,골목상권,1000683,가마산로61길,208,94,114
2014,3,A,골목상권,1000682,시흥대로94길,653,366,287
2014,3,A,골목상권,1000681,시흥대로84길,170,63,107
2014,3,A,골목상권,1000680,시흥대로68길,334,114,220
2014,3,A,골목상권,1000679,시흥대로63길,2613,1407,1206
2014,3,A,골목상권,1000678,시흥대로62가길,408,108,300
2014,3,A,골목상권,1000677,시흥대로36길,342,216,126
2014,3,A,골목상권,1000676,시흥대로22길,472,343,129
2014,3,A,골목상권,1000675,시흥대로153길,643,359,284
2014,3,A,골목상권,1000674,시흥대로150길,540,261,279
2014,3,A,골목상권,1000673,시흥대로141길,700,450,250
2014,3,A,골목상권,1000672,시흥대로138길,12,6,6
2014,3,A,골목상권,1000671,시흥대로120길,619,446,173
2014,3,A,골목상권,1000670,벚꽃로56길,1630,1207,423
2014,3,A,골목상권,1000669,범안로17길,188,101,87
2014,3,A,골목상권,1000668,범안로11길,776,604,172
2014,3,A,골목상권,1000667,문성로5길,164,52,112
2014,3,A,골목상권,1000666,독산로85길,65,25,40
2014,3,A,골목상권,1000665,독산로78다길,236,97,139
2014,3,A,골목상권,1000664,독산로70길,4,3,1
2014,3,A,골목상권,1000663,독산로64길,147,30,117
2014,3,A,골목상권,1000662,독산로50길,107,34,73
2014,3,A,골목상권,1000661,독산로40길,50,18,32
2014,3,A,골목상권,1000660,독산로108길,762,320,442
2014,3,A,골목상권,1000659,남부순환로112길,13,6,7
2014,3,A,골목상권,1000658,금하로24길,160,51,109
2014,3,A,골목상권,1000657,금하로1길,44,26,18
2014,3,A,골목상권,1000656,금하로14길,9,4,5
2014,3,A,골목상권,1000655,가산로5길,502,399,103
2014,3,A,골목상권,1000654,가산로3길,2442,1867,575
2014,3,A,골목상권,1000653,중앙로1길,1387,994,393
2014,3,A,골목상권,1000652,중앙로15길,191,57,134
2014,3,A,골목상권,1000651,우마길,23,16,7
2014,3,A,골목상권,1000650,오류로8길,218,98,120
2014,3,A,골목상권,1000649,신도림로13길,714,566,148
2014,3,A,골목상권,1000648,새말로18길,1165,465,700
2014,3,A,골목상권,1000647,부일로1길,729,602,127
2014,3,A,골목상권,1000646,부일로15길,175,160,15
2014,3,A,골목상권,1000645,부일로11길,23,8,15
2014,3,A,골목상권,1000644,디지털로32길,1437,781,656
2014,3,A,골목상권,1000643,디지털로32가길,6823,4919,1904
2014,3,A,골목상권,1000642,디지털로27길,407,254,153
2014,3,A,골목상권,1000641,도림로6길,117,52,65
2014,3,A,골목상권,1000640,도림로12길,88,35,53
2014,3,A,골목상권,1000639,남부순환로97길,246,80,166
2014,3,A,골목상권,1000638,구로중앙로8길,266,114,152
2014,3,A,골목상권,1000637,구로중앙로7길,190,80,110
2014,3,A,골목상권,1000636,구로중앙로42길,725,576,149
2014,3,A,골목상권,1000635,구로중앙로34길,554,305,249
2014,3,A,골목상권,1000634,구로중앙로28길,2844,1405,1439
2014,3,A,골목상권,1000633,구로중앙로19길,10,7,3
2014,3,A,골목상권,1000632,구로동로8길,148,50,98
2014,3,A,골목상권,1000631,구로동로7길,165,66,99
2014,3,A,골목상권,1000630,구로동로42길,27,18,9
2014,3,A,골목상권,1000629,구로동로41길,435,252,183
2014,3,A,골목상권,1000628,구로동로38길,46,19,27
2014,3,A,골목상권,1000627,구로동로28길,184,76,108
2014,3,A,골목상권,1000626,구로동로15길,28,5,23
2014,3,A,골목상권,1000625,공원로6가길,268,212,56
2014,3,A,골목상권,1000624,고척로52길,253,67,186
2014,3,A,골목상권,1000623,고척로27다길,192,75,117
2014,3,A,골목상권,1000622,고척로27길,233,98,135
2014,3,A,골목상권,1000621,고척로21나길,240,56,184
2014,3,A,골목상권,1000620,경인로47길,788,432,356
2014,3,A,골목상권,1000619,경인로35길,272,115,157
2014,3,A,골목상권,1000618,경인로31길,53,15,38
2014,3,A,골목상권,1000617,경인로15길,84,46,38
2014,3,A,골목상권,1000616,개봉로3길,336,199,137
2014,3,A,골목상권,1000615,개봉로2길,458,126,332
2014,3,A,골목상권,1000614,개봉로23가길,834,502,332
2014,3,A,골목상권,1000613,개봉로20길,105,60,45
2014,3,A,골목상권,1000612,개봉로1길,40,22,18
2014,3,A,골목상권,1000611,개봉로17다길,128,60,68
2014,3,A,골목상권,1000610,개봉로17길,858,423,435
2014,3,A,골목상권,1000609,개봉로11길,58,13,45
2014,3,A,골목상권,1000608,화곡로64길,2240,1173,1067
2014,3,A,골목상권,1000607,화곡로59길,451,182,269
2014,3,A,골목상권,1000606,화곡로44나길,793,657,136
2014,3,A,골목상권,1000605,화곡로31길,1321,540,781
2014,3,A,골목상권,1000604,화곡로20길,473,309,164
2014,3,A,골목상권,1000603,화곡로13길,253,87,166
2014,3,A,골목상권,1000602,초원로16길,453,232,221
2014,3,A,골목상권,1000601,초록마을로8길,182,25,157
2014,3,A,골목상권,1000600,초록마을로3길,41,19,22
2014,3,A,골목상권,1000599,월정로20길,5,1,4
2014,3,A,골목상권,1000598,우장산로6길,290,161,129
2014,3,A,골목상권,1000597,양천로73가길,1380,913,467
2014,3,A,골목상권,1000596,양천로71길,231,140,91
2014,3,A,골목상권,1000595,양천로49길,838,662,176
2014,3,A,골목상권,1000594,양천로26길,90,41,49
2014,3,A,골목상권,1000593,양천로24길,207,104,103
2014,3,A,골목상권,1000592,양천로24가길,676,300,376
2014,3,A,골목상권,1000591,양천로14길,362,258,104
2014,3,A,골목상권,1000590,방화대로6라길,685,458,227
2014,3,A,골목상권,1000589,방화대로21길,710,412,298
2014,3,A,골목상권,1000588,등촌로5길,9,2,7
2014,3,A,골목상권,1000587,등촌로55길,453,320,133
2014,3,A,골목상권,1000586,등촌로51길,11,11,0
2014,3,A,골목상권,1000585,등촌로39길,44,14,30
2014,3,A,골목상권,1000584,등촌로13길,241,126,115
2014,3,A,골목상권,1000583,남부순환로11길,441,325,116
2014,3,A,골목상권,1000582,까치산로4길,119,52,67
2014,3,A,골목상권,1000581,국회대로7길,332,204,128
2014,3,A,골목상권,1000580,공항대로8길,217,118,99
2014,3,A,골목상권,1000579,공항대로61길,225,144,81
2014,3,A,골목상권,1000578,공항대로59다길,816,594,222
2014,3,A,골목상권,1000577,공항대로59길,1143,766,377
2014,3,A,골목상권,1000576,공항대로55길,687,507,180
2014,3,A,골목상권,1000575,공항대로42길,11,7,4
2014,3,A,골목상권,1000574,공항대로38길,248,132,116
2014,3,A,골목상권,1000573,곰달래로60길,543,288,255
2014,3,A,골목상권,1000572,곰달래로53길,58,11,47
2014,3,A,골목상권,1000571,곰달래로47길,35,12,23
2014,3,A,골목상권,1000570,곰달래로31길,13,11,2
2014,3,A,골목상권,1000569,곰달래로25길,538,211,327
2014,3,A,골목상권,1000568,개화동로25길,629,433,196
2014,3,A,골목상권,1000567,개화동로23길,100,60,40
2014,3,A,골목상권,1000566,강서로8길,123,74,49
2014,3,A,골목상권,1000565,강서로5라길,266,158,108
2014,3,A,골목상권,1000564,강서로5나길,103,58,45
2014,3,A,골목상권,1000563,강서로5가길,44,27,17
2014,3,A,골목상권,1000562,강서로47라길,56,32,24
2014,3,A,골목상권,1000561,강서로47길,391,196,195
2014,3,A,골목상권,1000560,강서로45다길,495,186,309
2014,3,A,골목상권,1000559,강서로45길,100,54,46
2014,3,A,골목상권,1000558,강서로35길,170,103,67
2014,3,A,골목상권,1000557,강서로29길,290,166,124
2014,3,A,골목상권,1000556,강서로18길,31,11,20
2014,3,A,골목상권,1000555,강서로17가길,96,39,57
2014,3,A,골목상권,1000554,강서로15길,282,155,127
2014,3,A,골목상권,1000553,가로공원로80길,112,62,50
2014,3,A,골목상권,1000552,가로공원로76가길,15,7,8
2014,3,A,골목상권,1000551,화곡로4길,286,118,168
2014,3,A,골목상권,1000550,화곡로3길,164,54,110
2014,3,A,골목상권,1000549,지양로7길,219,67,152
2014,3,A,골목상권,1000548,중앙로55길,350,185,165
2014,3,A,골목상권,1000547,중앙로51길,126,64,62
2014,3,A,골목상권,1000546,중앙로47길,85,13,72
2014,3,A,골목상권,1000545,중앙로45길,166,61,105
2014,3,A,골목상권,1000544,중앙로36길,2,2,0
2014,3,A,골목상권,1000543,중앙로32길,427,223,204
2014,3,A,골목상권,1000542,중앙로25길,260,75,185
2014,3,A,골목상권,1000541,은행정로7길,441,156,285
2014,3,A,골목상권,1000539,오목로5길,292,160,132
2014,3,A,골목상권,1000538,오목로3길,477,421,56
2014,3,A,골목상권,1000537,오목로30길,160,79,81
2014,3,A,골목상권,1000536,오목로23길,654,348,306
2014,3,A,골목상권,1000535,신월로20길,178,73,105
2014,3,A,골목상권,1000534,신월로15길,712,344,368
2014,3,A,골목상권,1000533,신목로6길,265,141,124
2014,3,A,골목상권,1000532,신목로5길,879,344,535
2014,3,A,골목상권,1000531,신목로2길,98,45,53
2014,3,A,골목상권,1000530,목동중앙서로8가길,206,111,95
2014,3,A,골목상권,1000529,목동중앙서로7길,225,88,137
2014,3,A,골목상권,1000528,목동중앙북로8길,445,183,262
2014,3,A,골목상권,1000527,목동중앙북로16길,235,68,167
2014,3,A,골목상권,1000526,목동중앙본로7길,85,29,56
2014,3,A,골목상권,1000525,목동중앙로3길,102,55,47
2014,3,A,골목상권,1000524,목동중앙로13나길,230,147,83
2014,3,A,골목상권,1000523,목동중앙남로3가길,557,383,174
2014,3,A,골목상권,1000522,목동로9길,2344,1519,825
2014,3,A,골목상권,1000521,목동로19길,971,419,552
2014,3,A,골목상권,1000519,목동동로12길,387,152,235
2014,3,A,골목상권,1000518,목동남로4길,10,5,5
2014,3,A,골목상권,1000517,남부순환로88길,299,118,181
2014,3,A,골목상권,1000516,남부순환로79길,466,352,114
2014,3,A,골목상권,1000515,남부순환로70길,573,388,185
2014,3,A,골목상권,1000514,남부순환로58길,144,76,68
2014,3,A,골목상권,1000513,남부순환로40길,17,8,9
2014,3,A,골목상권,1000512,남부순환로33길,1229,988,241
2014,3,A,골목상권,1000511,곰달래로5길,45,25,20
2014,3,A,골목상권,1000510,곰달래로3길,407,222,185
2014,3,A,골목상권,1000509,곰달래로2길,323,201,122
2014,3,A,골목상권,1000508,곰달래로10길,362,279,83
2014,3,A,골목상권,1000507,가로공원로58길,88,20,68
2014,3,A,골목상권,1000506,효창원로93길,99,54,45
2014,3,A,골목상권,1000505,토정로37길,158,73,85
2014,3,A,골목상권,1000504,월드컵로8길,2051,1070,981
2014,3,A,골목상권,1000503,월드컵로7길,4,2,2
2014,3,A,골목상권,1000502,월드컵로36길,113,32,81
2014,3,A,골목상권,1000501,월드컵로25길,240,124,116
2014,3,A,골목상권,1000500,월드컵로19길,356,145,211
2014,3,A,골목상권,1000499,월드컵로16길,2268,1275,993
2014,3,A,골목상권,1000498,월드컵로11길,194,82,112
2014,3,A,골목상권,1000497,월드컵로10길,1688,924,764
2014,3,A,골목상권,1000496,와우산로3길,229,157,72
2014,3,A,골목상권,1000495,와우산로29길,128,55,73
2014,3,A,골목상권,1000494,와우산로29가길,13,6,7
2014,3,A,골목상권,1000493,양화진길,463,327,136
2014,3,A,골목상권,1000492,양화로1길,4400,2284,2116
2014,3,A,골목상권,1000491,양화로11길,371,266,105
2014,3,A,골목상권,1000490,신촌로30길,23,11,12
2014,3,A,골목상권,1000489,신촌로28가길,107,40,67
2014,3,A,골목상권,1000488,신촌로12길,1137,567,570
2014,3,A,골목상권,1000487,숭문길,2709,1740,969
2014,3,A,골목상권,1000486,숭문8길,117,72,45
2014,3,A,골목상권,1000485,성지3길,513,273,240
2014,3,A,골목상권,1000484,성산로4길,2444,1639,805
2014,3,A,골목상권,1000483,성미산로32길,328,185,143
2014,3,A,골목상권,1000482,성미산로1길,502,402,100
2014,3,A,골목상권,1000481,성미산로11길,878,569,309
2014,3,A,골목상권,1000480,백범로16길,523,292,231
2014,3,A,골목상권,1000479,방울내로9안길,286,168,118
2014,3,A,골목상권,1000478,모래내로7길,237,122,115
2014,3,A,골목상권,1000477,매봉산로2길,2571,1702,869
2014,3,A,골목상권,1000476,망원로2길,201,130,71
2014,3,A,골목상권,1000475,망원로11길,872,485,387
2014,3,A,골목상권,1000474,만리재옛길,1087,462,625
2014,3,A,골목상권,1000473,마포대로4길,351,154,197
2014,3,A,골목상권,1000472,마포대로20길,1838,866,972
2014,3,A,골목상권,1000471,마포대로12길,72,40,32
2014,3,A,골목상권,1000470,동교로38길,154,62,92
2014,3,A,골목상권,1000469,동교로27길,3142,1531,1611
2014,3,A,골목상권,1000468,동교로25길,812,387,425
2014,3,A,골목상권,1000467,동교로19길,4753,2938,1815
2014,3,A,골목상권,1000466,동교로17길,779,398,381
2014,3,A,골목상권,1000465,독막로8길,420,209,211
2014,3,A,골목상권,1000464,독막로32길,489,210,279
2014,3,A,골목상권,1000463,독막로22길,71,41,30
2014,3,A,골목상권,1000462,도화길,1203,622,581
2014,3,A,골목상권,1000461,도화4길,384,141,243
2014,3,A,골목상권,1000460,대흥로28길,67,53,14
2014,3,A,골목상권,1000459,대흥로21길,565,118,447
2014,3,A,골목상권,1000458,광성로6길,110,76,34
2014,3,A,골목상권,1000457,홍제내길,101,59,42
2014,3,A,골목상권,1000456,홍연길,77,45,32
2014,3,A,골목상권,1000455,통일로39길,13,11,2
2014,3,A,골목상권,1000454,통일로37길,363,138,225
2014,3,A,골목상권,1000453,통일로11길,13,9,4
2014,3,A,골목상권,1000452,충정로6길,10100,6131,3969
2014,3,A,골목상권,1000451,충정로4길,2810,1910,900
2014,3,A,골목상권,1000450,증가로6길,199,87,112
2014,3,A,골목상권,1000449,증가로23나길,360,178,182
2014,3,A,골목상권,1000448,증가로20가길,290,95,195
2014,3,A,골목상권,1000447,증가로10길,179,93,86
2014,3,A,골목상권,1000446,응암로1길,327,240,87
2014,3,A,골목상권,1000445,연희로10길,89,60,29
2014,3,A,골목상권,1000444,신촌로37길,161,75,86
2014,3,A,골목상권,1000443,수색로8길,1478,1356,122
2014,3,A,골목상권,1000442,세무서길,346,131,215
2014,3,A,골목상권,1000440,세검정로1길,223,128,95
2014,3,A,골목상권,1000439,북아현로4길,360,98,262
2014,3,A,골목상권,1000438,모래내로15길,84,29,55
2014,3,A,골목상권,1000437,명지대길,329,239,90
2014,3,A,골목상권,1000436,독립문로8길,705,282,423
2014,3,A,골목상권,1000435,가재울로6길,22,12,10
2014,3,A,골목상권,1000434,통일로92길,60,31,29
2014,3,A,골목상권,1000433,통일로87길,181,72,109
2014,3,A,골목상권,1000432,통일로78길,201,67,134
2014,3,A,골목상권,1000430,진흥로1길,508,175,333
2014,3,A,골목상권,1000429,진흥로12길,330,138,192
2014,3,A,골목상권,1000428,증산서길,355,274,81
2014,3,A,골목상권,1000427,증산로9길,86,35,51
2014,3,A,골목상권,1000426,증산로5길,687,346,341
2014,3,A,골목상권,1000425,증산로21길,248,174,74
2014,3,A,골목상권,1000424,증산로17길,540,315,225
2014,3,A,골목상권,1000423,증산로15길,168,65,103
2014,3,A,골목상권,1000422,증산로13길,57,32,25
2014,3,A,골목상권,1000421,응암로34길,80,47,33
2014,3,A,골목상권,1000420,응암로22길,176,60,116
2014,3,A,골목상권,1000419,응암로14길,303,82,221
2014,3,A,골목상권,1000418,응암로13길,212,75,137
2014,3,A,골목상권,1000417,응암로12길,194,85,109
2014,3,A,골목상권,1000416,은평로8길,254,146,108
2014,3,A,골목상권,1000415,은평로3길,288,93,195
2014,3,A,골목상권,1000414,은평로20길,22,8,14
2014,3,A,골목상권,1000413,은평로13길,565,382,183
2014,3,A,골목상권,1000412,은평로10길,298,186,112
2014,3,A,골목상권,1000411,연서로5길,43,15,28
2014,3,A,골목상권,1000410,연서로41길,220,74,146
2014,3,A,골목상권,1000409,연서로3길,121,57,64
2014,3,A,골목상권,1000408,연서로34길,115,33,82
2014,3,A,골목상권,1000407,연서로33길,24,7,17
2014,3,A,골목상권,1000406,연서로29길,273,86,187
2014,3,A,골목상권,1000405,연서로28길,618,294,324
2014,3,A,골목상권,1000404,연서로27길,56,27,29
2014,3,A,골목상권,1000403,연서로21길,430,244,186
2014,3,A,골목상권,1000402,연서로17길,956,380,576
2014,3,A,골목상권,1000401,연서로16길,272,110,162
2014,3,A,골목상권,1000400,연서로13길,682,228,454
2014,3,A,골목상권,1000399,연서로11길,181,96,85
2014,3,A,골목상권,1000398,역말로9길,19,15,4
2014,3,A,골목상권,1000397,수색로18길,696,580,116
2014,3,A,골목상권,1000396,서오릉로8길,13,7,6
2014,3,A,골목상권,1000395,서오릉로21길,423,160,263
2014,3,A,골목상권,1000394,불광천길,154,77,77
2014,3,A,골목상권,1000393,갈현로7길,951,263,688
2014,3,A,골목상권,1000392,갈현로41길,80,26,54
2014,3,A,골목상권,1000391,갈현로33길,26,7,19
2014,3,A,골목상권,1000390,갈현로1길,111,45,66
2014,3,A,골목상권,1000389,가좌로7길,48,20,28
2014,3,A,골목상권,1000388,한글비석로44길,488,266,222
2014,3,A,골목상권,1000387,한글비석로24길,350,140,210
2014,3,A,골목상권,1000386,한글비석로22길,565,256,309
2014,3,A,골목상권,1000385,석계로1길,114,72,42
2014,3,A,골목상권,1000384,상계로9가길,233,95,138
2014,3,A,골목상권,1000382,상계로12길,10,6,4
2014,3,A,골목상권,1000381,동일로242길,546,422,124
2014,3,A,골목상권,1000380,동일로192길,459,247,212
2014,3,A,골목상권,1000379,동일로173가길,2211,1252,959
2014,3,A,골목상권,1000378,공릉로58길,94,36,58
2014,3,A,골목상권,1000377,해등로16길,49,38,11
2014,3,A,골목상권,1000376,우이천로4다길,173,99,74
2014,3,A,골목상권,1000375,우이천로32길,93,44,49
2014,3,A,골목상권,1000374,시루봉로23길,46,19,27
2014,3,A,골목상권,1000373,삼양로144길,58,43,15
2014,3,A,골목상권,1000372,방학로6가길,161,91,70
2014,3,A,골목상권,1000371,방학로5길,151,84,67
2014,3,A,골목상권,1000370,방학로15길,340,235,105
2014,3,A,골목상권,1000369,방학로10길,102,64,38
2014,3,A,골목상권,1000367,도봉산4길,301,270,31
2014,3,A,골목상권,1000366,도봉로181길,264,129,135
2014,3,A,골목상권,1000365,도봉로169나길,229,111,118
2014,3,A,골목상권,1000364,도봉로156길,324,163,161
2014,3,A,골목상권,1000363,도봉로152가길,763,583,180
2014,3,A,골목상권,1000362,도봉로147길,601,349,252
2014,3,A,골목상권,1000360,도봉로114길,459,141,318
2014,3,A,골목상권,1000359,도봉로109길,18,7,11
2014,3,A,골목상권,1000358,도당로29길,878,542,336
2014,3,A,골목상권,1000357,도당로19길,159,74,85
2014,3,A,골목상권,1000356,도당로13바길,180,63,117
2014,3,A,골목상권,1000355,도당로13가길,126,55,71
2014,3,A,골목상권,1000354,덕릉로60길,57,29,28
2014,3,A,골목상권,1000353,노해로63다길,482,232,250
2014,3,A,골목상권,1000352,노해로60길,276,131,145
2014,3,A,골목상권,1000351,한천로140길,124,76,48
2014,3,A,골목상권,1000350,한천로139가길,44,27,17
2014,3,A,골목상권,1000349,한천로132길,280,105,175
2014,3,A,골목상권,1000348,한천로130길,271,111,160
2014,3,A,골목상권,1000347,한천로124나길,90,42,48
2014,3,A,골목상권,1000346,한천로109길,603,288,315
2014,3,A,골목상권,1000345,인수봉로79길,173,44,129
2014,3,A,골목상권,1000344,인수봉로72길,81,35,46
2014,3,A,골목상권,1000343,인수봉로56길,9,1,8
2014,3,A,골목상권,1000342,오패산로67길,537,297,240
2014,3,A,골목상권,1000341,오패산로52길,77,24,53
2014,3,A,골목상권,1000340,오패산로30길,1,0,1
2014,3,A,골목상권,1000339,수유로12길,230,144,86
2014,3,A,골목상권,1000338,솔샘로65길,515,236,279
2014,3,A,골목상권,1000337,솔매로50길,704,283,421
2014,3,A,골목상권,1000336,솔매로45길,231,91,140
2014,3,A,골목상권,1000335,솔매로41길,85,28,57
2014,3,A,골목상권,1000334,삼양로93길,16,4,12
2014,3,A,골목상권,1000333,삼양로77길,347,132,215
2014,3,A,골목상권,1000332,삼양로54길,3,2,1
2014,3,A,골목상권,1000331,삼양로41길,299,137,162
2014,3,A,골목상권,1000329,삼양로24길,70,29,41
2014,3,A,골목상권,1000328,삼양로20길,131,47,84
2014,3,A,골목상권,1000327,삼각산로28길,761,451,310
2014,3,A,골목상권,1000326,도봉로99길,163,96,67
2014,3,A,골목상권,1000325,도봉로8길,251,179,72
2014,3,A,골목상권,1000324,도봉로76길,318,168,150
2014,3,A,골목상권,1000323,도봉로67길,8,4,4
2014,3,A,골목상권,1000322,도봉로45길,162,95,67
2014,3,A,골목상권,1000321,도봉로18길,569,254,315
2014,3,A,골목상권,1000320,도봉로13길,41,20,21
2014,3,A,골목상권,1000319,덕릉로41길,685,593,92
2014,3,A,골목상권,1000318,덕릉로40길,863,697,166
2014,3,A,골목상권,1000317,노해로33길,27,10,17
2014,3,A,골목상권,1000315,노해로17길,177,82,95
2014,3,A,골목상권,1000314,화랑로40길,123,66,57
2014,3,A,골목상권,1000313,화랑로32길,394,290,104
2014,3,A,골목상권,1000312,화랑로1길,183,99,84
2014,3,A,골목상권,1000311,화랑로19길,338,184,154
2014,3,A,골목상권,1000310,화랑로14길,49,22,27
2014,3,A,골목상권,1000309,화랑로13길,82,40,42
2014,3,A,골목상권,1000308,한천로76길,118,73,45
2014,3,A,골목상권,1000307,한천로101가길,43,27,16
2014,3,A,골목상권,1000306,창경궁로43길,19,14,5
2014,3,A,골목상권,1000305,지봉로20길,154,109,45
2014,3,A,골목상권,1000304,종암로5길,109,79,30
2014,3,A,골목상권,1000303,종암로24가길,252,122,130
2014,3,A,골목상권,1000302,종암로21길,110,43,67
2014,3,A,골목상권,1000301,종암로19길,366,99,267
2014,3,A,골목상권,1000300,종암로16길,57,24,33
2014,3,A,골목상권,1000299,정릉로8길,161,97,64
2014,3,A,골목상권,1000298,정릉로27길,197,84,113
2014,3,A,골목상권,1000296,장위로50길,964,550,414
2014,3,A,골목상권,1000295,장월로1길,343,129,214
2014,3,A,골목상권,1000294,인촌로6길,1944,1031,913
2014,3,A,골목상권,1000293,인촌로5길,25,4,21
2014,3,A,골목상권,1000292,인촌로24길,287,127,160
2014,3,A,골목상권,1000291,개운사길,2651,1746,905
2014,3,A,골목상권,1000290,인촌로1길,144,98,46
2014,3,A,골목상권,1000289,인촌로17가길,2881,1168,1713
2014,3,A,골목상권,1000288,오패산로4길,423,161,262
2014,3,A,골목상권,1000287,오패산로3길,1224,662,562
2014,3,A,골목상권,1000286,오패산로19길,33,19,14
2014,3,A,골목상권,1000285,안암로5길,564,357,207
2014,3,A,골목상권,1000284,아리랑로4길,673,261,412
2014,3,A,골목상권,1000283,솔샘로6길,124,67,57
2014,3,A,골목상권,1000282,성북로8길,28,13,15
2014,3,A,골목상권,1000281,삼양로8길,56,38,18
2014,3,A,골목상권,1000280,삼선교로16가길,665,371,294
2014,3,A,골목상권,1000279,삼선교로10다길,91,34,57
2014,3,A,골목상권,1000278,삼선교로10길,221,96,125
2014,3,A,골목상권,1000277,보문로32길,890,397,493
2014,3,A,골목상권,1000276,보문로31길,854,368,486
2014,3,A,골목상권,1000274,보문로13길,551,338,213
2014,3,A,골목상권,1000273,보국문로16길,275,190,85
2014,3,A,골목상권,1000270,동소문로26가길,262,161,101
2014,3,A,골목상권,1000269,동소문로15길,63,26,37
2014,3,A,골목상권,1000268,동소문로13길,763,415,348
2014,3,A,골목상권,1000267,돌곶이로8길,202,117,85
2014,3,A,골목상권,1000266,돌곶이로41길,40,19,21
2014,3,A,골목상권,1000265,돌곶이로28길,203,115,88
2014,3,A,골목상권,1000264,돌곶이로27길,44,27,17
2014,3,A,골목상권,1000263,돌곶이로22길,116,64,52
2014,3,A,골목상권,1000261,길음로7길,8,4,4
2014,3,A,골목상권,1000260,중랑천로10길,652,363,289
2014,3,A,골목상권,1000259,용마산로94길,422,263,159
2014,3,A,골목상권,1000258,용마산로118길,481,207,274
2014,3,A,골목상권,1000257,용마산로112길,233,111,122
2014,3,A,골목상권,1000256,용마산로100길,468,331,137
2014,3,A,골목상권,1000255,신내로7가길,286,66,220
2014,3,A,골목상권,1000254,사가정로54길,89,31,58
2014,3,A,골목상권,1000253,사가정로42길,69,22,47
2014,3,A,골목상권,1000252,봉화산로56길,558,142,416
2014,3,A,골목상권,1000251,봉화산로4길,264,105,159
2014,3,A,골목상권,1000250,봉화산로30길,333,221,112
2014,3,A,골목상권,1000249,봉우재로33길,50,21,29
2014,3,A,골목상권,1000248,면목로78길,229,128,101
2014,3,A,골목상권,1000247,면목로56길,255,209,46
2014,3,A,골목상권,1000246,면목로55길,410,131,279
2014,3,A,골목상권,1000245,면목로49길,533,169,364
2014,3,A,골목상권,1000244,면목로48길,94,49,45
2014,3,A,골목상권,1000243,면목로45길,85,39,46
2014,3,A,골목상권,1000242,면목로33길,420,171,249
2014,3,A,골목상권,1000241,면목로21길,29,17,12
2014,3,A,골목상권,1000240,망우로73길,7,3,4
2014,3,A,골목상권,1000239,망우로68길,93,49,44
2014,3,A,골목상권,1000238,동일로163길,100,69,31
2014,3,A,골목상권,1000237,동일로157길,167,89,78
2014,3,A,골목상권,1000236,동일로149길,1094,817,277
2014,3,A,골목상권,1000235,동일로140길,225,85,140
2014,3,A,골목상권,1000234,동일로139길,55,32,23
2014,3,A,골목상권,1000233,동일로139가길,1014,610,404
2014,3,A,골목상권,1000232,동일로130길,95,26,69
2014,3,A,골목상권,1000231,동일로123길,187,93,94
2014,3,A,골목상권,1000230,동일로112길,194,76,118
2014,3,A,골목상권,1000229,동일로101길,305,114,191
2014,3,A,골목상권,1000228,동일로100길,32,13,19
2014,3,A,골목상권,1000227,답십리로75길,81,43,38
2014,3,A,골목상권,1000226,공릉로2길,540,272,268
2014,3,A,골목상권,1000225,공릉로12가길,50,35,15
2014,3,A,골목상권,1000224,겸재로54길,96,53,43
2014,3,A,골목상권,1000223,겸재로36길,313,255,58
2014,3,A,골목상권,1000222,겸재로29길,426,198,228
2014,3,A,골목상권,1000221,휘경로3길,190,106,84
2014,3,A,골목상권,1000220,휘경로2길,6,2,4
2014,3,A,골목상권,1000219,휘경로23길,19,1,18
2014,3,A,골목상권,1000218,휘경로14길,78,35,43
2014,3,A,골목상권,1000217,한천로46길,357,120,237
2014,3,A,골목상권,1000216,한천로40길,280,163,117
2014,3,A,골목상권,1000215,한천로33길,83,31,52
2014,3,A,골목상권,1000214,한천로14길,550,335,215
2014,3,A,골목상권,1000213,천호대로97길,342,219,123
2014,3,A,골목상권,1000212,천호대로77길,2011,1104,907
2014,3,A,골목상권,1000211,천호대로45길,175,121,54
2014,3,A,골목상권,1000210,천호대로17길,1820,1119,701
2014,3,A,골목상권,1000209,천호대로12길,791,548,243
2014,3,A,골목상권,1000208,천장산로7길,1294,819,475
2014,3,A,골목상권,1000207,제기로5길,195,108,87
2014,3,A,골목상권,1000206,제기로21길,221,148,73
2014,3,A,골목상권,1000205,전농로4길,662,431,231
2014,3,A,골목상권,1000204,전농로3길,89,38,51
2014,3,A,골목상권,1000203,전농로29길,273,115,158
2014,3,A,골목상권,1000202,장한로8길,746,431,315
2014,3,A,골목상권,1000201,장한로5길,3554,2441,1113
2014,3,A,골목상권,1000200,장한로27길,143,49,94
2014,3,A,골목상권,1000199,장한로27가길,358,181,177
2014,3,A,골목상권,1000198,장한로26길,507,258,249
2014,3,A,골목상권,1000197,장한로26가길,292,147,145
2014,3,A,골목상권,1000196,장한로25길,930,429,501
2014,3,A,골목상권,1000195,장한로14길,208,179,29
2014,3,A,골목상권,1000194,이문로42길,219,81,138
2014,3,A,골목상권,1000193,왕산로43길,932,467,465
2014,3,A,골목상권,1000192,왕산로33길,172,110,62
2014,3,A,골목상권,1000191,왕산로32길,9,6,3
2014,3,A,골목상권,1000190,약령시로17길,247,139,108
2014,3,A,골목상권,1000189,서울시립대로4길,759,508,251
2014,3,A,골목상권,1000188,서울시립대로29길,187,112,75
2014,3,A,골목상권,1000187,서울시립대로16길,102,27,75
2014,3,A,골목상권,1000186,사가정로2길,139,99,40
2014,3,A,골목상권,1000185,사가정로23가길,102,70,32
2014,3,A,골목상권,1000184,사가정로13길,299,116,183
2014,3,A,골목상권,1000183,무학로45길,345,197,148
2014,3,A,골목상권,1000182,무학로16길,1081,933,148
2014,3,A,골목상권,1000181,망우로21길,180,96,84
2014,3,A,골목상권,1000180,망우로18길,614,283,331
2014,3,A,골목상권,1000179,망우로18가길,69,25,44
2014,3,A,골목상권,1000178,답십리로72길,8,6,2
2014,3,A,골목상권,1000177,답십리로69길,663,314,349
2014,3,A,골목상권,1000176,답십리로68길,144,92,52
2014,3,A,골목상권,1000175,답십리로64길,358,209,149
2014,3,A,골목상권,1000174,답십리로63길,67,44,23
2014,3,A,골목상권,1000173,답십리로60길,12,6,6
2014,3,A,골목상권,1000172,답십리로56길,8,6,2
2014,3,A,골목상권,1000171,답십리로23길,2,2,0
2014,3,A,골목상권,1000170,난계로30길,553,363,190
2014,3,A,골목상권,1000168,경희대로3길,247,166,81
2014,3,A,골목상권,1000167,천호대로129길,190,63,127
2014,3,A,골목상권,1000166,천호대로123길,301,144,157
2014,3,A,골목상권,1000165,천호대로109길,1429,801,628
2014,3,A,골목상권,1000164,자양번영로3길,76,34,42
2014,3,A,골목상권,1000162,자양로50길,27,10,17
2014,3,A,골목상권,1000161,자양로45길,512,283,229
2014,3,A,골목상권,1000160,자양로26길,336,117,219
2014,3,A,골목상권,1000159,자양로15길,337,207,130
2014,3,A,골목상권,1000158,자양로11길,1230,631,599
2014,3,A,골목상권,1000157,용마산로3길,827,481,346
2014,3,A,골목상권,1000156,용마산로21길,152,71,81
2014,3,A,골목상권,1000155,아차산로78길,1616,1052,564
2014,3,A,골목상권,1000154,아차산로65길,568,377,191
2014,3,A,골목상권,1000153,아차산로55길,588,273,315
2014,3,A,골목상권,1000152,아차산로51길,230,141,89
2014,3,A,골목상권,1000151,아차산로40길,478,268,210
2014,3,A,골목상권,1000150,면목로17길,241,151,90
2014,3,A,골목상권,1000149,뚝섬로64길,365,200,165
2014,3,A,골목상권,1000148,뚝섬로58길,202,85,117
2014,3,A,골목상권,1000147,뚝섬로54길,115,66,49
2014,3,A,골목상권,1000146,뚝섬로48길,728,334,394
2014,3,A,골목상권,1000145,뚝섬로24길,105,36,69
2014,3,A,골목상권,1000144,뚝섬로23길,96,65,31
2014,3,A,골목상권,1000143,동일로24길,9,2,7
2014,3,A,골목상권,1000142,동일로18길,132,65,67
2014,3,A,골목상권,1000141,능동로4길,210,82,128
2014,3,A,골목상권,1000140,능동로3길,162,73,89
2014,3,A,골목상권,1000139,능동로34길,742,455,287
2014,3,A,골목상권,1000138,능동로19길,326,205,121
2014,3,A,골목상권,1000137,능동로13길,286,86,200
2014,3,A,골목상권,1000136,긴고랑로9길,72,34,38
2014,3,A,골목상권,1000135,긴고랑로8길,230,206,24
2014,3,A,골목상권,1000134,긴고랑로7길,454,228,226
2014,3,A,골목상권,1000133,긴고랑로20길,499,225,274
2014,3,A,골목상권,1000132,광나루로52길,1552,784,768
2014,3,A,골목상권,1000131,광나루로40길,73,34,39
2014,3,A,골목상권,1000130,광나루로37길,244,148,96
2014,3,A,골목상권,1000129,광나루로36길,35,21,14
2014,3,A,골목상권,1000128,광나루로24길,94,54,40
2014,3,A,골목상권,1000127,광나루로12길,898,582,316
2014,3,A,골목상권,1000126,한림말길,88,55,33
2014,3,A,골목상권,1000124,청계천로10나길,1699,986,713
2014,3,A,골목상권,1000123,장터길,33,9,24
2014,3,A,골목상권,1000122,용답중앙길,80,44,36
2014,3,A,골목상권,1000121,용답29길,1777,851,926
2014,3,A,골목상권,1000120,왕십리로6길,1259,719,540
2014,3,A,골목상권,1000119,왕십리로31길,105,51,54
2014,3,A,골목상권,1000118,왕십리로26길,3343,2171,1172
2014,3,A,골목상권,1000117,왕십리로21길,141,45,96
2014,3,A,골목상권,1000116,왕십리로14길,1375,1147,228
2014,3,A,골목상권,1000115,아차산로5길,1797,1299,498
2014,3,A,골목상권,1000114,아차산로15길,3751,2766,985
2014,3,A,골목상권,1000113,아차산로11길,3301,2127,1174
2014,3,A,골목상권,1000112,송정4가길,1186,651,535
2014,3,A,골목상권,1000111,송정12라길,177,125,52
2014,3,A,골목상권,1000110,성수일로6길,2878,1709,1169
2014,3,A,골목상권,1000109,성수이로7길,612,350,262
2014,3,A,골목상권,1000108,성수이로18길,2275,1650,625
2014,3,A,골목상권,1000107,성덕정길,604,379,225
2014,3,A,골목상권,1000106,성덕정17길,204,114,90
2014,3,A,골목상권,1000105,서울숲2길,1533,786,747
2014,3,A,골목상권,1000104,상원길,1404,925,479
2014,3,A,골목상권,1000103,상원12길,147,94,53
2014,3,A,골목상권,1000102,사근동길,27,18,9
2014,3,A,골목상권,1000101,무학봉길,8,7,1
2014,3,A,골목상권,1000100,무학봉28길,140,62,78
2014,3,A,골목상권,1000099,무학로6길,335,198,137
2014,3,A,골목상권,1000098,무수막길,103,53,50
2014,3,A,골목상권,1000097,매봉길,20,10,10
2014,3,A,골목상권,1000096,마조로1길,193,73,120
2014,3,A,골목상권,1000095,마조로16길,839,583,256
2014,3,A,골목상권,1000094,마장로39길,17,15,2
2014,3,A,골목상권,1000093,마장로27길,91,32,59
2014,3,A,골목상권,1000091,둘레9길,517,321,196
2014,3,A,골목상권,1000090,금호산길,360,131,229
2014,3,A,골목상권,1000089,금호산2길,32,13,19
2014,3,A,골목상권,1000088,고산자로6길,15675,6612,9063
2014,3,A,골목상권,1000087,후암로28길,168,69,99
2014,3,A,골목상권,1000086,효창원로39길,47,30,17
2014,3,A,골목상권,1000085,회나무로13길,38,25,13
2014,3,A,골목상권,1000084,한남대로20길,813,499,314
2014,3,A,골목상권,1000082,한강대로7길,384,280,104
2014,3,A,골목상권,1000081,한강대로62길,693,504,189
2014,3,A,골목상권,1000080,한강대로52길,5995,1976,4019
2014,3,A,골목상권,1000079,한강대로43길,4766,3123,1643
2014,3,A,골목상권,1000078,한강대로15길,1801,409,1392
2014,3,A,골목상권,1000077,한강대로104길,4903,3592,1311
2014,3,A,골목상권,1000076,청파로73길,1613,870,743
2014,3,A,골목상권,1000075,청파로71길,248,135,113
2014,3,A,골목상권,1000074,청파로47나길,434,185,249
2014,3,A,골목상권,1000073,청파로47길,823,373,450
2014,3,A,골목상권,1000072,장문로45길,79,8,71
2014,3,A,골목상권,1000071,이태원로54길,1774,1116,658
2014,3,A,골목상권,1000070,이태원로27길,477,288,189
2014,3,A,골목상권,1000069,이촌로22길,197,117,80
2014,3,A,골목상권,1000068,원효로89길,902,736,166
2014,3,A,골목상권,1000067,원효로53길,717,457,260
2014,3,A,골목상권,1000066,원효로41길,2588,1864,724
2014,3,A,골목상권,1000065,원효로19길,910,671,239
2014,3,A,골목상권,1000064,우사단로4길,160,119,41
2014,3,A,골목상권,1000063,우사단로14길,1746,986,760
2014,3,A,골목상권,1000062,우사단로10길,54,29,25
2014,3,A,골목상권,1000061,신흥로20길,215,109,106
2014,3,A,골목상권,1000060,소월로20길,124,41,83
2014,3,A,골목상권,1000059,서빙고로71길,476,288,188
2014,3,A,골목상권,1000058,백범로90길,290,163,127
2014,3,A,골목상권,1000057,백범로79길,948,612,336
2014,3,A,골목상권,1000056,두텁바위로1길,2374,1359,1015
2014,3,A,골목상권,1000055,대사관로34길,325,180,145
2014,3,A,골목상권,1000054,녹사평대로46길,32,15,17
2014,3,A,골목상권,1000053,녹사평대로40나길,20,7,13
2014,3,A,골목상권,1000052,녹사평대로32길,385,189,196
2014,3,A,골목상권,1000051,녹사평대로26길,2026,1204,822
2014,3,A,골목상권,1000050,녹사평대로11길,259,168,91
2014,3,A,골목상권,1000049,퇴계로90길,468,192,276
2014,3,A,골목상권,1000048,퇴계로8길,2545,1390,1155
2014,3,A,골목상권,1000047,퇴계로56길,765,596,169
2014,3,A,골목상권,1000046,퇴계로46길,1890,753,1137
2014,3,A,골목상권,1000045,퇴계로18길,2637,1276,1361
2014,3,A,골목상권,1000044,퇴계로12길,1088,458,630
2014,3,A,골목상권,1000043,청구로1길,214,107,107
2014,3,A,골목상권,1000042,청구로17길,1659,763,896
2014,3,A,골목상권,1000041,장충단로8길,4136,1262,2874
2014,3,A,골목상권,1000040,삼일대로4길,1285,938,347
2014,3,A,골목상권,1000039,명동길,34330,18294,16036
2014,3,A,골목상권,1000037,동호로20길,912,414,498
2014,3,A,골목상권,1000036,동호로15길,5095,2724,2371
2014,3,A,골목상권,1000035,동호로11길,11,9,2
2014,3,A,골목상권,1000034,동호로10길,4210,2179,2031
2014,3,A,골목상권,1000033,다산로39길,923,572,351
2014,3,A,골목상권,1000032,다산로38길,1359,744,615
2014,3,A,골목상권,1000031,다산로36길,45,27,18
2014,3,A,골목상권,1000030,다산로33길,313,185,128
2014,3,A,골목상권,1000029,난계로21길,176,117,59
2014,3,A,골목상권,1000028,난계로11길,1433,899,534
2014,3,A,골목상권,1000026,평창길,161,66,95
2014,3,A,골목상권,1000025,통일로12길,129,40,89
2014,3,A,골목상권,1000024,창신길,239,66,173
2014,3,A,골목상권,1000023,창신5길,2,0,2
2014,3,A,골목상권,1000022,창신2길,45,27,18
2014,3,A,골목상권,1000021,창경궁로35길,1305,380,925
2014,3,A,골목상권,1000020,지봉로8길,152,68,84
2014,3,A,골목상권,1000019,종로65길,513,262,251
2014,3,A,골목상권,1000016,자하문로7길,504,295,209
2014,3,A,골목상권,1000015,이화장길,2011,1033,978
2014,3,A,골목상권,1000014,율곡로16길,69,25,44
2014,3,A,골목상권,1000013,율곡로10길,2100,1550,550
2014,3,A,골목상권,1000012,옥인길,474,224,250
2014,3,A,골목상권,1000011,숭인동길,13,6,7
2014,3,A,골목상권,1000010,성균관로5길,113,68,45
2014,3,A,골목상권,1000009,삼청로5길,413,159,254
2014,3,A,골목상권,1000008,북촌로5나길,1454,1037,417
2014,3,A,골목상권,1000007,북촌로5길,41,20,21
2014,3,A,골목상권,1000006,북촌로11길,17,7,10
2014,3,A,골목상권,1000005,백석동길,91,51,40
2014,3,A,골목상권,1000004,명륜길,7,5,2
2014,3,A,골목상권,1000003,돈화문로11가길,1028,564,464
2014,3,A,골목상권,1000001,계동길,777,378,399
2014,2,U,관광특구,1001496,강남 마이스 관광특구,22365,12773,9592
2014,2,U,관광특구,1001495,잠실 관광특구,25151,15240,9911
2014,2,U,관광특구,1001494,종로?청계 관광특구,29620,18806,10814
2014,2,U,관광특구,1001493,동대문패션타운 관광특구,14228,9610,4618
2014,2,U,관광특구,1001492,명동 남대문 북창동 다동 무교동 관광특구,175557,91363,84194
2014,2,U,관광특구,1001491,이태원 관광특구,5599,3213,2386
2014,2,R,전통시장,1001490,길동복조리시장,529,324,205
2014,2,R,전통시장,1001489,둔촌역전통시장,144,74,70
2014,2,R,전통시장,1001488,성내골목시장,6,2,4
2014,2,R,전통시장,1001487,천호시장,6,2,4
2014,2,R,전통시장,1001483,암사종합시장,535,242,293
2014,2,R,전통시장,1001482,고덕전통시장,402,389,13
2014,2,R,전통시장,1001481,명일골목시장,128,60,68
2014,2,R,전통시장,1001480,새마을시장,319,172,147
2014,2,R,전통시장,1001479,석촌시장,182,121,61
2014,2,R,전통시장,1001478,방이시장,638,423,215
2014,2,R,전통시장,1001477,마천시장,245,63,182
2014,2,R,전통시장,1001476,풍납시장,10,2,8
2014,2,R,전통시장,1001475,강남개포시장,45,35,10
2014,2,R,전통시장,1001474,도곡시장,525,245,280
2014,2,R,전통시장,1001471,영동전통시장,2700,2112,588
2014,2,R,전통시장,1001466,미성동도깨비시장,407,165,242
2014,2,R,전통시장,1001464,삼성동시장,185,97,88
2014,2,R,전통시장,1001463,신림중앙시장,12,8,4
2014,2,R,전통시장,1001462,강남골목시장,428,207,221
2014,2,R,전통시장,1001460,관악신사시장,294,222,72
2014,2,R,전통시장,1001459,신원시장,335,150,185
2014,2,R,전통시장,1001458,인헌시장,201,66,135
2014,2,R,전통시장,1001456,봉천현대시장,11,5,6
2014,2,R,전통시장,1001454,봉천제일종합시장,44,24,20
2014,2,R,전통시장,1001453,낙성대시장,21,13,8
2014,2,R,전통시장,1001452,중부시장,160,50,110
2014,2,R,전통시장,1001450,남성역골목시장,469,223,246
2014,2,R,전통시장,1001449,남성사계시장,1933,860,1073
2014,2,R,전통시장,1001448,흑석시장,168,52,116
2014,2,R,전통시장,1001447,상도4동도깨비골목시장,330,98,232
2014,2,R,전통시장,1001445,영도시장,101,42,59
2014,2,R,전통시장,1001441,본동인정시장,129,61,68
2014,2,R,전통시장,1001439,대림중앙시장,18,13,5
2014,2,R,전통시장,1001438,우리시장,23,10,13
2014,2,R,전통시장,1001437,영진시장A동,41,33,8
2014,2,R,전통시장,1001433,영일시장,4,2,2
2014,2,R,전통시장,1001431,영등포청과시장,160,96,64
2014,2,R,전통시장,1001430,영등포전통시장,4144,2089,2055
2014,2,R,전통시장,1001429,은행나무시장,40,9,31
2014,2,R,전통시장,1001427,현대시장,56,15,41
2014,2,R,전통시장,1001424,남문시장,385,143,242
2014,2,R,전통시장,1001423,독산동 우시장,127,53,74
2014,2,R,전통시장,1001421,개봉중앙시장,7,4,3
2014,2,R,전통시장,1001419,가리봉시장,14,7,7
2014,2,R,전통시장,1001418,남구로시장,7,4,3
2014,2,R,전통시장,1001417,구로시장,50,25,25
2014,2,R,전통시장,1001415,방신전통시장,176,139,37
2014,2,R,전통시장,1001414,송화골목시장,466,157,309
2014,2,R,전통시장,1001413,까치산시장,33,18,15
2014,2,R,전통시장,1001411,남부골목시장,171,76,95
2014,2,R,전통시장,1001409,화곡중앙골목시장,2,2,0
2014,2,R,전통시장,1001407,등마루시장,819,543,276
2014,2,R,전통시장,1001406,신정3동골목시장,213,92,121
2014,2,R,전통시장,1001405,신정2동골목시장,10,7,3
2014,2,R,전통시장,1001402,신월6동골목시장,255,110,145
2014,2,R,전통시장,1001401,신곡종합시장,22,13,9
2014,2,R,전통시장,1001400,신월3동골목시장,53,19,34
2014,2,R,전통시장,1001399,경창시장,158,88,70
2014,2,R,전통시장,1001398,월정로시장,91,52,39
2014,2,R,전통시장,1001397,신영시장,40,20,20
2014,2,R,전통시장,1001396,목4동시장,225,72,153
2014,2,R,전통시장,1001395,목3동시장,522,227,295
2014,2,R,전통시장,1001394,목2동시장,171,87,84
2014,2,R,전통시장,1001393,마포농수산물시장,375,249,126
2014,2,R,전통시장,1001391,망원월드컵시장,13,7,6
2014,2,R,전통시장,1001390,망원시장,41,23,18
2014,2,R,전통시장,1001386,신수시장,237,146,91
2014,2,R,전통시장,1001385,아현시장,68,46,22
2014,2,R,전통시장,1001374,대림골목시장,252,73,179
2014,2,R,전통시장,1001367,상계중앙시장,32,17,15
2014,2,R,전통시장,1001364,방학동도깨비시장,128,57,71
2014,2,R,전통시장,1001363,쌍문역골목시장,45,20,25
2014,2,R,전통시장,1001361,신도봉시장,9,3,6
2014,2,R,전통시장,1001359,창동신창시장,103,37,66
2014,2,R,전통시장,1001357,장미원골목시장,52,35,17
2014,2,R,전통시장,1001356,수유중앙시장,143,81,62
2014,2,R,전통시장,1001355,강북종합시장,50,18,32
2014,2,R,전통시장,1001354,우이시장,151,88,63
2014,2,R,전통시장,1001353,수유전통시장,461,148,313
2014,2,R,전통시장,1001352,번동북부골목시장,99,60,39
2014,2,R,전통시장,1001351,솔샘시장,88,30,58
2014,2,R,전통시장,1001349,방천골목시장,72,24,48
2014,2,R,전통시장,1001347,석관황금시장,44,24,20
2014,2,R,전통시장,1001343,장위전통시장,176,56,120
2014,2,R,전통시장,1001340,정릉시장,37,15,22
2014,2,R,전통시장,1001339,정릉아리랑시장,7,4,3
2014,2,R,전통시장,1001338,돈암제일시장,79,53,26
2014,2,R,전통시장,1001336,우림골목시장,219,107,112
2014,2,R,전통시장,1001335,묵1동도깨비시장,282,105,177
2014,2,R,전통시장,1001334,태능시장,3,2,1
2014,2,R,전통시장,1001333,중화제일시장,21,0,21
2014,2,R,전통시장,1001332,사가정시장,239,189,50
2014,2,R,전통시장,1001330,동원시장,37,16,21
2014,2,R,전통시장,1001329,동부골목시장,74,31,43
2014,2,R,전통시장,1001326,회기시장,126,53,73
2014,2,R,전통시장,1001323,답십리시장,15,11,4
2014,2,R,전통시장,1001321,답십리현대시장,90,67,23
2014,2,R,전통시장,1001319,청량리종합시장,9,7,2
2014,2,R,전통시장,1001317,청량리농수산물시장,15,13,2
2014,2,R,전통시장,1001316,서울약령시장,1284,833,451
2014,2,R,전통시장,1001313,청량리수산시장,155,80,75
2014,2,R,전통시장,1001310,구의시장,92,53,39
2014,2,R,전통시장,1001309,조양시장,65,40,25
2014,2,R,전통시장,1001308,영동교골목시장,19,11,8
2014,2,R,전통시장,1001307,능동로골목시장,266,252,14
2014,2,R,전통시장,1001304,자양골목시장,97,38,59
2014,2,R,전통시장,1001301,중곡제일시장,124,64,60
2014,2,R,전통시장,1001299,한아름시장,74,40,34
2014,2,R,전통시장,1001298,성동용답상가시장,227,114,113
2014,2,R,전통시장,1001297,뚝도시장,27,9,18
2014,2,R,전통시장,1001296,금남시장,15,12,3
2014,2,R,전통시장,1001295,행당시장,204,99,105
2014,2,R,전통시장,1001294,마장축산물시장,1431,993,438
2014,2,R,전통시장,1001289,용문전통시장,32,22,10
2014,2,R,전통시장,1001286,후암시장,27,10,17
2014,2,R,전통시장,1001285,합동(새벽)시장,2379,1238,1141
2014,2,R,전통시장,1001284,서울중앙시장,216,156,60
2014,2,R,전통시장,1001283,백학시장,462,254,208
2014,2,R,전통시장,1001282,약수시장,1439,546,893
2014,2,R,전통시장,1001281,청평화시장,2343,1649,694
2014,2,R,전통시장,1001280,제일평화시장,467,291,176
2014,2,R,전통시장,1001278,남평화시장,138,95,43
2014,2,R,전통시장,1001277,방산종합시장,1671,1130,541
2014,2,R,전통시장,1001275,인현시장,1249,831,418
2014,2,R,전통시장,1001274,신중부시장,2412,1638,774
2014,2,R,전통시장,1001273,남대문시장,6947,3776,3171
2014,2,R,전통시장,1001271,동묘시장,867,551,316
2014,2,R,전통시장,1001270,창신골목시장,209,120,89
2014,2,R,전통시장,1001268,충신시장,334,187,147
2014,2,R,전통시장,1001267,종로신진시장,20,9,11
2014,2,R,전통시장,1001266,동대문종합시장,226,154,72
2014,2,R,전통시장,1001265,광장시장,200,140,60
2014,2,D,발달상권,1001263,서울 노원구 노원역_3,633,267,366
2014,2,D,발달상권,1001261,서울 노원구 노원역_1,1069,322,747
2014,2,D,발달상권,1001260,창동역,2051,1347,704
2014,2,D,발달상권,1001259,서울 강북구 수유역_3,50,28,22
2014,2,D,발달상권,1001257,서울 강북구 수유역_2,3838,2010,1828
2014,2,D,발달상권,1001256,서울 강북구 수유역_1,67,48,19
2014,2,D,발달상권,1001255,서울 은평구 연신내역_3,538,173,365
2014,2,D,발달상권,1001254,서울 은평구 연신내역_2,309,132,177
2014,2,D,발달상권,1001253,서울 은평구 연신내역_1,46,20,26
2014,2,D,발달상권,1001252,서울 성북구 미아삼거리역_2,569,262,307
2014,2,D,발달상권,1001251,서울 강북구 미아삼거리역_1,439,158,281
2014,2,D,발달상권,1001250,서울 은평구 불광역_3,43,16,27
2014,2,D,발달상권,1001249,서울 은평구 불광역_2,68,25,43
2014,2,D,발달상권,1001248,서울 은평구 불광역_1,223,94,129
2014,2,D,발달상권,1001247,미아사거리_2,111,65,46
2014,2,D,발달상권,1001246,미아사거리_1,492,200,292
2014,2,D,발달상권,1001245,서울 성북구 성신여대입구역,4894,3048,1846
2014,2,D,발달상권,1001244,경희대학교,336,157,179
2014,2,D,발달상권,1001243,서울 성북구 안암역,64,35,29
2014,2,D,발달상권,1001242,혜화역 대학로_3,10153,3114,7039
2014,2,D,발달상권,1001241,혜화역 대학로_2,1393,824,569
2014,2,D,발달상권,1001240,혜화역 대학로_1,1155,613,542
2014,2,D,발달상권,1001239,디지털미디어시티,13683,9193,4490
2014,2,D,발달상권,1001238,서울 동대문구 청량리역,3191,2090,1101
2014,2,D,발달상권,1001236,서울 종로구 안국역_2,756,317,439
2014,2,D,발달상권,1001235,서울 종로구 안국역_1,12091,10040,2051
2014,2,D,발달상권,1001234,서울 종로구 경복궁역_1,189,74,115
2014,2,D,발달상권,1001233,서울 종로구 종로3가역_3,2839,1610,1229
2014,2,D,발달상권,1001232,서울 종로구 종로3가역_2,1873,1026,847
2014,2,D,발달상권,1001231,서울 동대문구 신설동역_2,3899,2008,1891
2014,2,D,발달상권,1001230,인사동,21645,13921,7724
2014,2,D,발달상권,1001229,서울 종로구 종로5가역_4,620,340,280
2014,2,D,발달상권,1001228,서울 종로구 종로5가역_3,5125,3477,1648
2014,2,D,발달상권,1001227,종로구청,14961,9043,5918
2014,2,D,발달상권,1001226,서울 종로구 종로5가역_2,14491,9283,5208
2014,2,D,발달상권,1001225,신설동역,682,426,256
2014,2,D,발달상권,1001224,서울 동대문구 신설동역_1,2,2,0
2014,2,D,발달상권,1001223,서울 종로구 광화문역_2,50793,32166,18627
2014,2,D,발달상권,1001222,동묘앞역,58,41,17
2014,2,D,발달상권,1001221,장안동사거리,479,247,232
2014,2,D,발달상권,1001220,서울 종로구 동대문역_2,769,456,313
2014,2,D,발달상권,1001218,동대문시장_2,461,302,159
2014,2,D,발달상권,1001217,서울 종로구 종로5가역_1,49,34,15
2014,2,D,발달상권,1001216,서울 종로구 종로3가역_1,3295,1499,1796
2014,2,D,발달상권,1001215,서울 종로구 광화문역_1,2145,1398,747
2014,2,D,발달상권,1001214,종각역,20746,13844,6902
2014,2,D,발달상권,1001213,종각역 젊음의 거리,1736,885,851
2014,2,D,발달상권,1001212,서대문구 서대문역_1,2524,827,1697
2014,2,D,발달상권,1001211,동대문시장_1,464,240,224
2014,2,D,발달상권,1001210,시청역_2,24724,15778,8946
2014,2,D,발달상권,1001209,서울시청,28092,13341,14751
2014,2,D,발달상권,1001208,서울 중구 을지로3가역_2,8541,5639,2902
2014,2,D,발달상권,1001207,서울 중구 신당역_2,966,537,429
2014,2,D,발달상권,1001206,서대문구 서대문역_2,2107,1435,672
2014,2,D,발달상권,1001205,동대문역사문화공원역,4408,2762,1646
2014,2,D,발달상권,1001204,서울 중구 을지로3가역_1,14874,10223,4651
2014,2,D,발달상권,1001203,명동거리,18466,9631,8835
2014,2,D,발달상권,1001202,롯데백화점,56999,31125,25874
2014,2,D,발달상권,1001201,서울 중구 신당역_1,1087,710,377
2014,2,D,발달상권,1001200,북창동,7371,4732,2639
2014,2,D,발달상권,1001199,서울 중구 충무로역_2,16168,7584,8584
2014,2,D,발달상권,1001198,서울 강서구 송정역,581,393,188
2014,2,D,발달상권,1001197,장한평역_2,11959,9686,2273
2014,2,D,발달상권,1001196,시청역_1,63049,36795,26254
2014,2,D,발달상권,1001195,왕십리역_2,988,605,383
2014,2,D,발달상권,1001194,서울 강서구 발산역,697,459,238
2014,2,D,발달상권,1001193,장한평역_1,2525,1697,828
2014,2,D,발달상권,1001192,서울 중구 충무로역_1,2676,1823,853
2014,2,D,발달상권,1001190,장한평역,2157,1490,667
2014,2,D,발달상권,1001189,서울 중구 명동역,2745,1420,1325
2014,2,D,발달상권,1001188,장충동 족발거리,198,87,111
2014,2,D,발달상권,1001187,한양시장,196,100,96
2014,2,D,발달상권,1001186,서울 서대문구 이대역,1239,489,750
2014,2,D,발달상권,1001185,서울 서대문구 신촌역,2694,1156,1538
2014,2,D,발달상권,1001184,서울 마포구 홍대입구역_3,778,547,231
2014,2,D,발달상권,1001183,서울 마포구 홍대입구역_2,2837,1336,1501
2014,2,D,발달상권,1001182,홍익대학교 주변,16924,8517,8407
2014,2,D,발달상권,1001181,서울 광진구 군자역,159,97,62
2014,2,D,발달상권,1001180,신촌역,181,105,76
2014,2,D,발달상권,1001179,강서구청,3408,2322,1086
2014,2,D,발달상권,1001178,서울 마포구 홍대입구역_1,748,460,288
2014,2,D,발달상권,1001175,서울 강동구 고덕역,455,267,188
2014,2,D,발달상권,1001173,서울 강동구 명일역,861,349,512
2014,2,D,발달상권,1001172,어린이대공원역,99,65,34
2014,2,D,발달상권,1001171,서울 마포구 공덕역_2,2811,1941,870
2014,2,D,발달상권,1001170,공덕역,6541,4192,2349
2014,2,D,발달상권,1001169,서울 용산구 숙대입구역,4154,2934,1220
2014,2,D,발달상권,1001168,남영역,14157,6548,7609
2014,2,D,발달상권,1001167,서울 마포구 공덕역_1,3876,1884,1992
2014,2,D,발달상권,1001166,서울 마포구 마포역_2,1235,592,643
2014,2,D,발달상권,1001165,서울 광진구 건대입구역_2,2579,897,1682
2014,2,D,발달상권,1001164,서울 마포구 마포역_1,9870,6130,3740
2014,2,D,발달상권,1001163,서울 강동구 천호역_2,3669,1786,1883
2014,2,D,발달상권,1001162,서울 광진구 건대입구역_1,975,530,445
2014,2,D,발달상권,1001161,건대입구역,714,402,312
2014,2,D,발달상권,1001160,서울 광진구 구의역,1060,688,372
2014,2,D,발달상권,1001159,서울 강동구 천호역,882,409,473
2014,2,D,발달상권,1001158,당산역_2,4897,3005,1892
2014,2,D,발달상권,1001156,서울 강동구 길동역,1862,1146,716
2014,2,D,발달상권,1001155,용산 전자상가_5,2170,1666,504
2014,2,D,발달상권,1001153,당산역_1,1084,672,412
2014,2,D,발달상권,1001152,서울 광진구 강변역,2041,1684,357
2014,2,D,발달상권,1001151,용산 전자상가_3,2552,1925,627
2014,2,D,발달상권,1001150,서울 용산구 이태원역,843,503,340
2014,2,D,발달상권,1001149,한남오거리,565,321,244
2014,2,D,발달상권,1001147,용산 전자상가_2,444,367,77
2014,2,D,발달상권,1001146,용산구청,79,44,35
2014,2,D,발달상권,1001145,용산 전자상가_1,8984,6860,2124
2014,2,D,발달상권,1001144,국회의사당역_2,36754,21609,15145
2014,2,D,발달상권,1001143,서울 용산구 신용산역,298,128,170
2014,2,D,발달상권,1001142,국회의사당역_1,5705,4455,1250
2014,2,D,발달상권,1001141,압구정 로데오거리_2,12906,5368,7538
2014,2,D,발달상권,1001140,서울 강남구 압구정역,9658,4693,4965
2014,2,D,발달상권,1001139,서울 영등포구 영등포구청역,3866,1356,2510
2014,2,D,발달상권,1001138,압구정 로데오거리_1,7296,2340,4956
2014,2,D,발달상권,1001137,서울 강동구 둔촌동역,48,19,29
2014,2,D,발달상권,1001136,오목교역,234,117,117
2014,2,D,발달상권,1001135,신사동 가로수길,20505,9585,10920
2014,2,D,발달상권,1001134,서울 영등포구 여의도역_2,45171,30020,15151
2014,2,D,발달상권,1001133,청담사거리_3,1333,419,914
2014,2,D,발달상권,1001132,영등포유통상가,1873,1302,571
2014,2,D,발달상권,1001131,청담역_2,1746,1369,377
2014,2,D,발달상권,1001130,청담역_1,205,165,40
2014,2,D,발달상권,1001129,청담사거리_2,1014,829,185
2014,2,D,발달상권,1001127,서울 영등포구 여의도역_1,54599,33310,21289
2014,2,D,발달상권,1001125,학동사거리_2,2804,1681,1123
2014,2,D,발달상권,1001124,서울 영등포구 영등포시장역,360,290,70
2014,2,D,발달상권,1001123,학동사거리_1,4223,2126,2097
2014,2,D,발달상권,1001122,여의도 시범아파트앞,2329,1538,791
2014,2,D,발달상권,1001121,영등포역_3,867,530,337
2014,2,D,발달상권,1001120,도산공원사거리_1,10114,6146,3968
2014,2,D,발달상권,1001119,영등포역_2,1036,588,448
2014,2,D,발달상권,1001118,문래동 주민센터,82,64,18
2014,2,D,발달상권,1001117,강남구 신사역_2,7507,5118,2389
2014,2,D,발달상권,1001115,서울 강남구 강남구청역_2,3661,2293,1368
2014,2,D,발달상권,1001114,강남구 신사역_1,2543,1175,1368
2014,2,D,발달상권,1001113,서울 동작구 노량진1동_1,88,38,50
2014,2,D,발달상권,1001112,서울 강남구 학동역_3,7252,4321,2931
2014,2,D,발달상권,1001111,서울 강남구 강남구청역_1,2906,1730,1176
2014,2,D,발달상권,1001110,잠실역,4525,3593,932
2014,2,D,발달상권,1001109,강남구 논현역_4,8122,3695,4427
2014,2,D,발달상권,1001108,학동역,929,467,462
2014,2,D,발달상권,1001107,방이동 먹자골목,5727,3932,1795
2014,2,D,발달상권,1001106,서울 강남구 학동역_2,5486,2636,2850
2014,2,D,발달상권,1001105,서울 동작구 노량진역,3479,2076,1403
2014,2,D,발달상권,1001104,삼성역_3,8740,4727,4013
2014,2,D,발달상권,1001103,코엑스,22365,12773,9592
2014,2,D,발달상권,1001102,서울 강남구 학동역_1,5933,3579,2354
2014,2,D,발달상권,1001101,선정릉역_2,5629,3596,2033
2014,2,D,발달상권,1001100,강남구 논현역_3,1636,833,803
2014,2,D,발달상권,1001099,포스코사거리_2,7834,4832,3002
2014,2,D,발달상권,1001098,포스코사거리_1,33834,21449,12385
2014,2,D,발달상권,1001097,잠실역 롯데월드,2770,1396,1374
2014,2,D,발달상권,1001096,신도림역,3764,2044,1720
2014,2,D,발달상권,1001095,강남구 논현역_2,7765,3856,3909
2014,2,D,발달상권,1001094,선정릉역_1,1363,951,412
2014,2,D,발달상권,1001093,신천역,6115,3361,2754
2014,2,D,발달상권,1001092,강남구 논현역_1,3021,1974,1047
2014,2,D,발달상권,1001091,삼성역_2,17519,10365,7154
2014,2,D,발달상권,1001090,삼정역_2,2531,1133,1398
2014,2,D,발달상권,1001089,삼정역_1,3012,1634,1378
2014,2,D,발달상권,1001088,삼성역_1,26418,17114,9304
2014,2,D,발달상권,1001087,서울 강남구 선릉역_2,6703,4272,2431
2014,2,D,발달상권,1001086,고속터미널역,14765,4660,10105
2014,2,D,발달상권,1001085,서울 서초구 강남역,31373,17774,13599
2014,2,D,발달상권,1001084,서울 강남구 선릉역_1,18377,8459,9918
2014,2,D,발달상권,1001082,선릉역_2,19698,10764,8934
2014,2,D,발달상권,1001081,서울 강남구 역삼역_2,26074,20598,5476
2014,2,D,발달상권,1001080,서울 송파구 석촌역_1,44,30,14
2014,2,D,발달상권,1001078,서울 강남구 강남역_2,6649,4351,2298
2014,2,D,발달상권,1001077,선릉역_1,70195,40217,29978
2014,2,D,발달상권,1001076,구로역,171,103,68
2014,2,D,발달상권,1001075,역삼역_2,4401,2458,1943
2014,2,D,발달상권,1001074,대림역_2,6594,5176,1418
2014,2,D,발달상권,1001073,서울 강남구 역삼역_1,25259,16026,9233
2014,2,D,발달상권,1001072,신대방삼거리역,290,170,120
2014,2,D,발달상권,1001071,서울 강남구 한티역,1366,513,853
2014,2,D,발달상권,1001070,은마아파트입구사거리_4,59,35,24
2014,2,D,발달상권,1001067,오류동역,1257,691,566
2014,2,D,발달상권,1001066,서울 강남구 강남역,39667,18739,20928
2014,2,D,발달상권,1001063,교대역_4,4800,2806,1994
2014,2,D,발달상권,1001062,서울 강남구 강남역_1,136211,99701,36510
2014,2,D,발달상권,1001061,방배동카페골목,100,39,61
2014,2,D,발달상권,1001060,가락시장,14346,9591,4755
2014,2,D,발달상권,1001059,교대역_3,4450,2785,1665
2014,2,D,발달상권,1001058,역삼역_1,1760,970,790
2014,2,D,발달상권,1001057,교대역_2,3036,1956,1080
2014,2,D,발달상권,1001056,서울 송파구 가락시장역,5339,3384,1955
2014,2,D,발달상권,1001055,서울 서초구 서초역,10956,4503,6453
2014,2,D,발달상권,1001054,서울 강남구 대치역_2,1275,791,484
2014,2,D,발달상권,1001052,뱅뱅사거리_2,25221,15747,9474
2014,2,D,발달상권,1001051,보라매공원,13735,8029,5706
2014,2,D,발달상권,1001050,교대역_1,13593,8058,5535
2014,2,D,발달상권,1001049,개봉동 현대아파트 인근,166,85,81
2014,2,D,발달상권,1001048,뱅뱅사거리,10410,7374,3036
2014,2,D,발달상권,1001047,뱅뱅사거리_1,9705,6944,2761
2014,2,D,발달상권,1001046,서울 관악구 신림역_4,900,442,458
2014,2,D,발달상권,1001045,동작구 총신대입구역_1,243,124,119
2014,2,D,발달상권,1001044,양재역_3,3225,2218,1007
2014,2,D,발달상권,1001043,동작구 총신대입구역_2,1082,561,521
2014,2,D,발달상권,1001042,서울 서초구 남부터미널역_3,1797,1072,725
2014,2,D,발달상권,1001041,서울 강남구 수서역,18796,11104,7692
2014,2,D,발달상권,1001039,서울 서초구 남부터미널역_2,9774,5034,4740
2014,2,D,발달상권,1001038,구로디지탈1단지,63179,41875,21304
2014,2,D,발달상권,1001037,양재역,153,83,70
2014,2,D,발달상권,1001035,매봉역,273,146,127
2014,2,D,발달상권,1001034,서울 서초구 방배역,3714,2217,1497
2014,2,D,발달상권,1001033,서울 서초구 남부터미널역_1,675,468,207
2014,2,D,발달상권,1001032,서울 관악구 신림역_2,24,14,10
2014,2,D,발달상권,1001031,서울 관악구 신림역_1,1754,844,910
2014,2,D,발달상권,1001030,양재역_2,8220,4555,3665
2014,2,D,발달상권,1001029,양재역_1,854,576,278
2014,2,D,발달상권,1001028,서울 관악구 서울대입구역_2,38,3,35
2014,2,D,발달상권,1001027,가산디지털단지역_3,28133,17023,11110
2014,2,D,발달상권,1001026,구로디지털단지역,2639,1809,830
2014,2,D,발달상권,1001025,서울 관악구 서울대입구역_1,2158,1000,1158
2014,2,D,발달상권,1001024,관악구 사당역_1,4260,1895,2365
2014,2,D,발달상권,1001023,가산디지털단지역_2,52837,32695,20142
2014,2,D,발달상권,1001022,관악구 사당역_2,398,190,208
2014,2,D,발달상권,1001021,가산디지털단지역_1,24367,16416,7951
2014,2,D,발달상권,1001020,장지역,3502,2323,1179
2014,2,D,발달상권,1001019,포이사거리_1,5568,2931,2637
2014,2,D,발달상권,1001018,포이사거리_2,7714,5018,2696
2014,2,D,발달상권,1001016,서울 관악구 대학동_1,68,41,27
2014,2,D,발달상권,1001015,서울 금천구 독산1동_1,2198,1585,613
2014,2,D,발달상권,1001013,양재 화물트럭터미널앞_2,229,102,127
2014,2,D,발달상권,1001012,양재 화물트럭터미널앞_1,4433,3474,959
2014,2,D,발달상권,1001011,서울 금천구 시흥1동_4,895,465,430
2014,2,A,골목상권,1001010,풍성로37가길,32,15,17
2014,2,A,골목상권,1001009,천호옛길,588,420,168
2014,2,A,골목상권,1001008,천호옛14길,556,287,269
2014,2,A,골목상권,1001007,천호대로219길,863,494,369
2014,2,A,골목상권,1001006,천호대로197길,21,8,13
2014,2,A,골목상권,1001005,천호대로187길,710,422,288
2014,2,A,골목상권,1001004,천호대로170길,324,116,208
2014,2,A,골목상권,1001003,천호대로162길,995,697,298
2014,2,A,골목상권,1001002,천중로51길,408,218,190
2014,2,A,골목상권,1001001,천중로39길,652,239,413
2014,2,A,골목상권,1001000,진황도로47길,1186,654,532
2014,2,A,골목상권,1000999,진황도로27길,375,228,147
2014,2,A,골목상권,1000998,올림픽로98길,39,23,16
2014,2,A,골목상권,1000995,올림픽로77길,8,3,5
2014,2,A,골목상권,1000994,올림픽로71길,246,174,72
2014,2,A,골목상권,1000993,올림픽로48길,5348,3302,2046
2014,2,A,골목상권,1000992,양재대로96길,1380,868,512
2014,2,A,골목상권,1000991,양재대로95길,574,319,255
2014,2,A,골목상권,1000990,양재대로91길,973,519,454
2014,2,A,골목상권,1000989,양재대로133길,265,103,162
2014,2,A,골목상권,1000988,양재대로124길,532,328,204
2014,2,A,골목상권,1000987,양재대로116길,175,73,102
2014,2,A,골목상권,1000986,양재대로101길,1197,687,510
2014,2,A,골목상권,1000985,암사길,339,152,187
2014,2,A,골목상권,1000984,성안로3길,1252,770,482
2014,2,A,골목상권,1000983,성내로5길,914,540,374
2014,2,A,골목상권,1000982,상일로5길,43,27,16
2014,2,A,골목상권,1000981,상암로5길,484,219,265
2014,2,A,골목상권,1000980,상암로51길,703,301,402
2014,2,A,골목상권,1000979,상암로4길,209,163,46
2014,2,A,골목상권,1000978,상암로14길,398,231,167
2014,2,A,골목상권,1000977,명일로13길,32,12,20
2014,2,A,골목상권,1000976,동남로85길,125,67,58
2014,2,A,골목상권,1000975,동남로82길,9,4,5
2014,2,A,골목상권,1000974,동남로65길,68,27,41
2014,2,A,골목상권,1000973,구천면로42길,323,164,159
2014,2,A,골목상권,1000972,구천면로41길,540,237,303
2014,2,A,골목상권,1000971,구천면로36길,36,21,15
2014,2,A,골목상권,1000969,고덕로25길,4,2,2
2014,2,A,골목상권,1000968,고덕로10길,194,107,87
2014,2,A,골목상권,1000967,강동대로53길,813,444,369
2014,2,A,골목상권,1000966,풍성로25길,991,377,614
2014,2,A,골목상권,1000965,오금로46길,1308,660,648
2014,2,A,골목상권,1000964,오금로36길,1611,1259,352
2014,2,A,골목상권,1000963,오금로11길,2427,1631,796
2014,2,A,골목상권,1000962,양재대로72길,622,345,277
2014,2,A,골목상권,1000961,양재대로71길,1046,655,391
2014,2,A,골목상권,1000960,양재대로64길,1489,649,840
2014,2,A,골목상권,1000959,양재대로62길,5410,3234,2176
2014,2,A,골목상권,1000958,송파대로30길,1595,1042,553
2014,2,A,골목상권,1000957,송이로36길,1859,1381,478
2014,2,A,골목상권,1000956,송이로32길,734,426,308
2014,2,A,골목상권,1000955,송이로23길,1635,932,703
2014,2,A,골목상권,1000954,삼전로13길,1628,938,690
2014,2,A,골목상권,1000953,백제고분로50길,3455,1833,1622
2014,2,A,골목상권,1000952,백제고분로46길,1581,1004,577
2014,2,A,골목상권,1000951,백제고분로45길,492,332,160
2014,2,A,골목상권,1000950,백제고분로42길,243,184,59
2014,2,A,골목상권,1000949,백제고분로39길,1113,878,235
2014,2,A,골목상권,1000948,백제고분로34길,1538,998,540
2014,2,A,골목상권,1000947,백제고분로33길,748,488,260
2014,2,A,골목상권,1000946,백제고분로32길,1018,457,561
2014,2,A,골목상권,1000945,백제고분로31길,295,189,106
2014,2,A,골목상권,1000944,백제고분로22길,1046,634,412
2014,2,A,골목상권,1000943,백제고분로21길,188,137,51
2014,2,A,골목상권,1000942,마천로51길,119,47,72
2014,2,A,골목상권,1000941,동남로20길,169,92,77
2014,2,A,골목상권,1000940,거마로20길,328,149,179
2014,2,A,골목상권,1000939,학동로77길,2948,1570,1378
2014,2,A,골목상권,1000938,학동로6길,2365,1165,1200
2014,2,A,골목상권,1000937,학동로56길,847,550,297
2014,2,A,골목상권,1000936,학동로38길,7186,4880,2306
2014,2,A,골목상권,1000935,테헤란로81길,520,126,394
2014,2,A,골목상권,1000934,일원로9길,492,265,227
2014,2,A,골목상권,1000933,일원로3길,232,108,124
2014,2,A,골목상권,1000932,영동대로65길,2781,1672,1109
2014,2,A,골목상권,1000931,영동대로112길,451,320,131
2014,2,A,골목상권,1000930,언주로81길,9138,4468,4670
2014,2,A,골목상권,1000929,압구정로2길,2780,1535,1245
2014,2,A,골목상권,1000928,선릉로18길,502,301,201
2014,2,A,골목상권,1000927,선릉로146길,1651,873,778
2014,2,A,골목상권,1000926,선릉로133길,150,79,71
2014,2,A,골목상권,1000925,선릉로132길,947,504,443
2014,2,A,골목상권,1000924,선릉로121길,1814,1004,810
2014,2,A,골목상권,1000923,삼성로75길,2533,1358,1175
2014,2,A,골목상권,1000922,삼성로69길,238,128,110
2014,2,A,골목상권,1000921,삼성로64길,546,271,275
2014,2,A,골목상권,1000920,삼성로63길,152,83,69
2014,2,A,골목상권,1000919,삼성로57길,897,289,608
2014,2,A,골목상권,1000918,삼성로147길,956,445,511
2014,2,A,골목상권,1000917,삼성로115길,313,195,118
2014,2,A,골목상권,1000916,봉은사로68길,190,98,92
2014,2,A,골목상권,1000915,봉은사로57길,682,486,196
2014,2,A,골목상권,1000914,봉은사로43길,1085,697,388
2014,2,A,골목상권,1000913,봉은사로29길,158,106,52
2014,2,A,골목상권,1000912,봉은사로109길,322,218,104
2014,2,A,골목상권,1000911,도산대로89길,2540,1114,1426
2014,2,A,골목상권,1000910,도산대로81길,4344,1461,2883
2014,2,A,골목상권,1000909,도산대로50길,2840,2226,614
2014,2,A,골목상권,1000908,도산대로38길,174,95,79
2014,2,A,골목상권,1000907,도산대로30길,2836,1387,1449
2014,2,A,골목상권,1000906,도산대로23길,1123,692,431
2014,2,A,골목상권,1000905,도산대로15길,1812,879,933
2014,2,A,골목상권,1000904,도곡로37길,3326,2189,1137
2014,2,A,골목상권,1000903,논현로8길,783,439,344
2014,2,A,골목상권,1000902,논현로63길,9551,2687,6864
2014,2,A,골목상권,1000901,논현로28길,12749,9307,3442
2014,2,A,골목상권,1000900,논현로26길,7049,4537,2512
2014,2,A,골목상권,1000898,논현로139길,1729,999,730
2014,2,A,골목상권,1000897,논현로123길,118,80,38
2014,2,A,골목상권,1000896,논현로115길,3648,2294,1354
2014,2,A,골목상권,1000895,논현로10길,2145,1389,756
2014,2,A,골목상권,1000894,논현로106길,3228,1769,1459
2014,2,A,골목상권,1000893,남부순환로365길,168,121,47
2014,2,A,골목상권,1000891,개포로28길,319,234,85
2014,2,A,골목상권,1000890,개포로20길,4251,2396,1855
2014,2,A,골목상권,1000889,개포로17길,3350,1960,1390
2014,2,A,골목상권,1000888,강남대로140길,4083,2292,1791
2014,2,A,골목상권,1000887,강남대로136길,1168,686,482
2014,2,A,골목상권,1000886,강남대로118길,608,340,268
2014,2,A,골목상권,1000885,서초중앙로8길,5818,4461,1357
2014,2,A,골목상권,1000884,방배중앙로21길,2249,874,1375
2014,2,A,골목상권,1000883,효령로72길,209,129,80
2014,2,A,골목상권,1000882,효령로34길,120,70,50
2014,2,A,골목상권,1000881,효령로31길,1278,827,451
2014,2,A,골목상권,1000880,효령로23길,711,456,255
2014,2,A,골목상권,1000879,청두곶길,2076,1538,538
2014,2,A,골목상권,1000878,주흥길,339,220,119
2014,2,A,골목상권,1000877,주흥15길,1535,994,541
2014,2,A,골목상권,1000876,언남길,2073,1534,539
2014,2,A,골목상권,1000875,신반포로45길,504,318,186
2014,2,A,골목상권,1000874,서초대로8길,242,156,86
2014,2,A,골목상권,1000873,서초대로64길,512,354,158
2014,2,A,골목상권,1000872,서초대로4길,790,583,207
2014,2,A,골목상권,1000871,서초대로25길,3737,2327,1410
2014,2,A,골목상권,1000870,서초대로23길,815,485,330
2014,2,A,골목상권,1000869,서초대로15길,1022,462,560
2014,2,A,골목상권,1000868,사평대로57길,240,119,121
2014,2,A,골목상권,1000867,사평대로26길,16,10,6
2014,2,A,골목상권,1000866,사평대로22길,1278,748,530
2014,2,A,골목상권,1000865,사임당로17길,1474,955,519
2014,2,A,골목상권,1000864,방배로42길,189,88,101
2014,2,A,골목상권,1000863,방배로35길,2137,1358,779
2014,2,A,골목상권,1000862,방배로18길,59,33,26
2014,2,A,골목상권,1000861,반포대로9길,709,475,234
2014,2,A,골목상권,1000860,바우뫼로39길,3209,1978,1231
2014,2,A,골목상권,1000859,마방로2길,3399,2198,1201
2014,2,A,골목상권,1000858,방배천로4안길,1801,1155,646
2014,2,A,골목상권,1000857,동산로19길,1389,943,446
2014,2,A,골목상권,1000856,동산로10길,2199,1266,933
2014,2,A,골목상권,1000855,동광로39길,45,23,22
2014,2,A,골목상권,1000854,동광로1길,1228,795,433
2014,2,A,골목상권,1000853,동광로12길,706,471,235
2014,2,A,골목상권,1000852,논현로27길,3627,2555,1072
2014,2,A,골목상권,1000851,논현로1길,568,356,212
2014,2,A,골목상권,1000850,남부순환로339길,11036,4728,6308
2014,2,A,골목상권,1000849,남부순환로325길,7835,4340,3495
2014,2,A,골목상권,1000848,남부순환로317길,1564,1189,375
2014,2,A,골목상권,1000847,고무래로8길,6438,3560,2878
2014,2,A,골목상권,1000846,강남대로8길,3124,2176,948
2014,2,A,골목상권,1000845,강남대로34길,894,611,283
2014,2,A,골목상권,1000844,강남대로23길,6290,4713,1577
2014,2,A,골목상권,1000843,소담길,30,8,22
2014,2,A,골목상권,1000842,원신길,273,115,158
2014,2,A,골목상권,1000840,양산길,498,344,154
2014,2,A,골목상권,1000839,호암로24길,537,218,319
2014,2,A,골목상권,1000838,호암로20길,40,26,14
2014,2,A,골목상권,1000837,행운길,94,60,34
2014,2,A,골목상권,1000836,행운1길,65,44,21
2014,2,A,골목상권,1000835,청림3길,25,16,9
2014,2,A,골목상권,1000834,청룡길,154,73,81
2014,2,A,골목상권,1000833,청룡8길,12,8,4
2014,2,A,골목상권,1000832,중앙길,290,105,185
2014,2,A,골목상권,1000831,조원중앙로2길,1114,786,328
2014,2,A,골목상권,1000830,조원로18길,968,485,483
2014,2,A,골목상권,1000829,조원로10길,258,122,136
2014,2,A,골목상권,1000828,장군봉2길,383,166,217
2014,2,A,골목상권,1000827,장군봉1길,95,16,79
2014,2,A,골목상권,1000826,인헌길,86,43,43
2014,2,A,골목상권,1000825,은천로25길,311,119,192
2014,2,A,골목상권,1000824,양녕로6길,734,445,289
2014,2,A,골목상권,1000823,신원로3길,19,13,6
2014,2,A,골목상권,1000822,신사로20길,47,26,21
2014,2,A,골목상권,1000820,신림로64길,235,127,108
2014,2,A,골목상권,1000819,신림로48길,81,47,34
2014,2,A,골목상권,1000818,신림로38길,47,23,24
2014,2,A,골목상권,1000817,신림로28길,307,220,87
2014,2,A,골목상권,1000816,신림로11길,475,429,46
2014,2,A,골목상권,1000815,신림동길,448,267,181
2014,2,A,골목상권,1000814,승방길,479,300,179
2014,2,A,골목상권,1000813,서림7길,235,81,154
2014,2,A,골목상권,1000812,봉천로33길,376,252,124
2014,2,A,골목상권,1000811,봉천로13길,194,60,134
2014,2,A,골목상권,1000810,복은길,177,64,113
2014,2,A,골목상권,1000808,법원단지9길,71,30,41
2014,2,A,골목상권,1000807,미성5길,61,32,29
2014,2,A,골목상권,1000806,대학길,55,29,26
2014,2,A,골목상권,1000805,대학14길,13,3,10
2014,2,A,골목상권,1000804,당곡길,333,162,171
2014,2,A,골목상권,1000803,남현길,230,77,153
2014,2,A,골목상권,1000802,남현3길,675,389,286
2014,2,A,골목상권,1000800,남부순환로248길,238,116,122
2014,2,A,골목상권,1000799,남부순환로234길,129,92,37
2014,2,A,골목상권,1000798,남부순환로172길,1600,876,724
2014,2,A,골목상권,1000797,남부순환로161길,20,7,13
2014,2,A,골목상권,1000796,남부순환로151길,171,101,70
2014,2,A,골목상권,1000795,남부순환로142길,72,26,46
2014,2,A,골목상권,1000794,난향길,165,43,122
2014,2,A,골목상권,1000793,난우길,395,187,208
2014,2,A,골목상권,1000792,난곡로74길,173,70,103
2014,2,A,골목상권,1000791,난곡로34길,27,10,17
2014,2,A,골목상권,1000790,난곡로26길,87,39,48
2014,2,A,골목상권,1000789,난곡로24길,31,15,16
2014,2,A,골목상권,1000788,낙성대역길,767,504,263
2014,2,A,골목상권,1000787,국회단지길,502,229,273
2014,2,A,골목상권,1000786,구암길,69,23,46
2014,2,A,골목상권,1000785,관천로22길,10,3,7
2014,2,A,골목상권,1000784,관천로15길,130,76,54
2014,2,A,골목상권,1000783,관악로30길,210,62,148
2014,2,A,골목상권,1000782,관악로28길,159,75,84
2014,2,A,골목상권,1000781,관악로14길,470,273,197
2014,2,A,골목상권,1000780,관악로10길,203,122,81
2014,2,A,골목상권,1000779,흑석로9길,178,81,97
2014,2,A,골목상권,1000778,흑석로13길,154,20,134
2014,2,A,골목상권,1000777,장승배기로27길,30,16,14
2014,2,A,골목상권,1000776,장승배기로19길,1,1,0
2014,2,A,골목상권,1000774,여의대방로46길,354,97,257
2014,2,A,골목상권,1000773,여의대방로24길,13023,5746,7277
2014,2,A,골목상권,1000772,여의대방로22카길,280,121,159
2014,2,A,골목상권,1000771,여의대방로22나길,142,51,91
2014,2,A,골목상권,1000770,여의대방로22길,199,115,84
2014,2,A,골목상권,1000769,양녕로26길,128,67,61
2014,2,A,골목상권,1000768,신대방길,110,68,42
2014,2,A,골목상권,1000766,성대로1길,367,151,216
2014,2,A,골목상권,1000765,서달로8가길,195,84,111
2014,2,A,골목상권,1000763,서달로14길,57,28,29
2014,2,A,골목상권,1000762,서달로10길,75,33,42
2014,2,A,골목상권,1000761,상도로62길,174,72,102
2014,2,A,골목상권,1000760,상도로61길,62,35,27
2014,2,A,골목상권,1000759,상도로47길,81,56,25
2014,2,A,골목상권,1000758,상도로37길,1877,974,903
2014,2,A,골목상권,1000757,상도로15길,310,134,176
2014,2,A,골목상권,1000756,사당로8길,126,67,59
2014,2,A,골목상권,1000755,사당로30길,317,214,103
2014,2,A,골목상권,1000754,사당로2차길,104,70,34
2014,2,A,골목상권,1000753,사당로29길,18,14,4
2014,2,A,골목상권,1000752,사당로26길,236,128,108
2014,2,A,골목상권,1000751,사당로23나길,140,45,95
2014,2,A,골목상권,1000750,사당로23길,18,13,5
2014,2,A,골목상권,1000749,사당로20길,160,110,50
2014,2,A,골목상권,1000748,사당로16길,129,42,87
2014,2,A,골목상권,1000747,사당로16가길,739,488,251
2014,2,A,골목상권,1000746,만양로8길,56,19,37
2014,2,A,골목상권,1000745,만양로14길,441,205,236
2014,2,A,골목상권,1000744,등용로14길,592,455,137
2014,2,A,골목상권,1000743,동작대로7길,1518,674,844
2014,2,A,골목상권,1000742,동작대로35길,255,94,161
2014,2,A,골목상권,1000741,동작대로33길,96,50,46
2014,2,A,골목상권,1000740,동작대로29길,41,24,17
2014,2,A,골목상권,1000739,동작대로17길,1292,745,547
2014,2,A,골목상권,1000738,대방동2길,450,219,231
2014,2,A,골목상권,1000737,대방동27길,109,59,50
2014,2,A,골목상권,1000736,노량진로6길,111,34,77
2014,2,A,골목상권,1000735,국사봉길,29,2,27
2014,2,A,골목상권,1000734,국사봉2길,122,84,38
2014,2,A,골목상권,1000733,국사봉1길,6,1,5
2014,2,A,골목상권,1000732,영신로9길,240,125,115
2014,2,A,골목상권,1000731,영등포로84길,278,79,199
2014,2,A,골목상권,1000730,영등포로80길,39,29,10
2014,2,A,골목상권,1000729,영등포로62길,2,1,1
2014,2,A,골목상권,1000728,영등포로35길,60,45,15
2014,2,A,골목상권,1000727,영등포로27길,363,213,150
2014,2,A,골목상권,1000724,여의대방로43나길,2656,1933,723
2014,2,A,골목상권,1000723,여의대방로39길,14,10,4
2014,2,A,골목상권,1000722,여의대방로35길,631,327,304
2014,2,A,골목상권,1000721,양평로28길,675,547,128
2014,2,A,골목상권,1000720,양평로22라길,42,30,12
2014,2,A,골목상권,1000719,양평로19길,882,606,276
2014,2,A,골목상권,1000718,신길로60길,421,176,245
2014,2,A,골목상권,1000717,신길로42길,417,235,182
2014,2,A,골목상권,1000716,신길로42가길,92,26,66
2014,2,A,골목상권,1000715,신길로39길,86,48,38
2014,2,A,골목상권,1000714,신길로17길,60,27,33
2014,2,A,골목상권,1000713,선유서로28길,401,221,180
2014,2,A,골목상권,1000712,선유서로25길,2185,1578,607
2014,2,A,골목상권,1000711,선유서로24길,174,91,83
2014,2,A,골목상권,1000710,선유로55길,2149,1377,772
2014,2,A,골목상권,1000709,디지털로74길,47,28,19
2014,2,A,골목상권,1000708,디지털로57길,6,1,5
2014,2,A,골목상권,1000707,디지털로37길,183,88,95
2014,2,A,골목상권,1000706,도신로62길,199,50,149
2014,2,A,골목상권,1000705,도신로60길,77,11,66
2014,2,A,골목상권,1000704,도신로29길,82,35,47
2014,2,A,골목상권,1000703,도신로15길,93,53,40
2014,2,A,골목상권,1000702,도림천로21길,107,51,56
2014,2,A,골목상권,1000701,도림로63길,33,23,10
2014,2,A,골목상권,1000700,도림로147길,1601,1191,410
2014,2,A,골목상권,1000699,도림로112길,8,7,1
2014,2,A,골목상권,1000698,대림로8길,1881,647,1234
2014,2,A,골목상권,1000697,대림로7길,14,5,9
2014,2,A,골목상권,1000696,대림로44길,30,18,12
2014,2,A,골목상권,1000695,대림로34길,168,58,110
2014,2,A,골목상권,1000694,대림로31길,859,458,401
2014,2,A,골목상권,1000693,대림로29길,1533,754,779
2014,2,A,골목상권,1000692,대림로22길,311,169,142
2014,2,A,골목상권,1000691,당산로46길,3626,2266,1360
2014,2,A,골목상권,1000690,당산로38길,306,250,56
2014,2,A,골목상권,1000689,당산로37길,3484,2178,1306
2014,2,A,골목상권,1000688,당산로31길,4168,2371,1797
2014,2,A,골목상권,1000687,국회대로56길,1656,1073,583
2014,2,A,골목상권,1000686,경인로90길,303,181,122
2014,2,A,골목상권,1000685,경인로80길,1667,1234,433
2014,2,A,골목상권,1000684,경인로77길,592,461,131
2014,2,A,골목상권,1000683,가마산로61길,208,94,114
2014,2,A,골목상권,1000682,시흥대로94길,653,366,287
2014,2,A,골목상권,1000681,시흥대로84길,170,63,107
2014,2,A,골목상권,1000680,시흥대로68길,334,114,220
2014,2,A,골목상권,1000679,시흥대로63길,2613,1407,1206
2014,2,A,골목상권,1000678,시흥대로62가길,408,108,300
2014,2,A,골목상권,1000677,시흥대로36길,342,216,126
2014,2,A,골목상권,1000676,시흥대로22길,472,343,129
2014,2,A,골목상권,1000675,시흥대로153길,643,359,284
2014,2,A,골목상권,1000674,시흥대로150길,540,261,279
2014,2,A,골목상권,1000673,시흥대로141길,700,450,250
2014,2,A,골목상권,1000672,시흥대로138길,12,6,6
2014,2,A,골목상권,1000671,시흥대로120길,619,446,173
2014,2,A,골목상권,1000670,벚꽃로56길,1630,1207,423
2014,2,A,골목상권,1000669,범안로17길,188,101,87
2014,2,A,골목상권,1000668,범안로11길,776,604,172
2014,2,A,골목상권,1000667,문성로5길,164,52,112
2014,2,A,골목상권,1000666,독산로85길,65,25,40
2014,2,A,골목상권,1000665,독산로78다길,236,97,139
2014,2,A,골목상권,1000664,독산로70길,4,3,1
2014,2,A,골목상권,1000663,독산로64길,147,30,117
2014,2,A,골목상권,1000662,독산로50길,107,34,73
2014,2,A,골목상권,1000661,독산로40길,50,18,32
2014,2,A,골목상권,1000660,독산로108길,762,320,442
2014,2,A,골목상권,1000659,남부순환로112길,13,6,7
2014,2,A,골목상권,1000658,금하로24길,160,51,109
2014,2,A,골목상권,1000657,금하로1길,44,26,18
2014,2,A,골목상권,1000656,금하로14길,9,4,5
2014,2,A,골목상권,1000655,가산로5길,502,399,103
2014,2,A,골목상권,1000654,가산로3길,2442,1867,575
2014,2,A,골목상권,1000653,중앙로1길,1387,994,393
2014,2,A,골목상권,1000652,중앙로15길,191,57,134
2014,2,A,골목상권,1000651,우마길,23,16,7
2014,2,A,골목상권,1000650,오류로8길,218,98,120
2014,2,A,골목상권,1000649,신도림로13길,714,566,148
2014,2,A,골목상권,1000648,새말로18길,1165,465,700
2014,2,A,골목상권,1000647,부일로1길,729,602,127
2014,2,A,골목상권,1000646,부일로15길,175,160,15
2014,2,A,골목상권,1000645,부일로11길,23,8,15
2014,2,A,골목상권,1000644,디지털로32길,1437,781,656
2014,2,A,골목상권,1000643,디지털로32가길,6823,4919,1904
2014,2,A,골목상권,1000642,디지털로27길,407,254,153
2014,2,A,골목상권,1000641,도림로6길,117,52,65
2014,2,A,골목상권,1000640,도림로12길,88,35,53
2014,2,A,골목상권,1000639,남부순환로97길,246,80,166
2014,2,A,골목상권,1000638,구로중앙로8길,266,114,152
2014,2,A,골목상권,1000637,구로중앙로7길,190,80,110
2014,2,A,골목상권,1000636,구로중앙로42길,725,576,149
2014,2,A,골목상권,1000635,구로중앙로34길,554,305,249
2014,2,A,골목상권,1000634,구로중앙로28길,2844,1405,1439
2014,2,A,골목상권,1000633,구로중앙로19길,10,7,3
2014,2,A,골목상권,1000632,구로동로8길,148,50,98
2014,2,A,골목상권,1000631,구로동로7길,165,66,99
2014,2,A,골목상권,1000630,구로동로42길,27,18,9
2014,2,A,골목상권,1000629,구로동로41길,435,252,183
2014,2,A,골목상권,1000628,구로동로38길,46,19,27
2014,2,A,골목상권,1000627,구로동로28길,184,76,108
2014,2,A,골목상권,1000626,구로동로15길,28,5,23
2014,2,A,골목상권,1000625,공원로6가길,268,212,56
2014,2,A,골목상권,1000624,고척로52길,253,67,186
2014,2,A,골목상권,1000623,고척로27다길,192,75,117
2014,2,A,골목상권,1000622,고척로27길,233,98,135
2014,2,A,골목상권,1000621,고척로21나길,240,56,184
2014,2,A,골목상권,1000620,경인로47길,788,432,356
2014,2,A,골목상권,1000619,경인로35길,272,115,157
2014,2,A,골목상권,1000618,경인로31길,53,15,38
2014,2,A,골목상권,1000617,경인로15길,84,46,38
2014,2,A,골목상권,1000616,개봉로3길,336,199,137
2014,2,A,골목상권,1000615,개봉로2길,458,126,332
2014,2,A,골목상권,1000614,개봉로23가길,834,502,332
2014,2,A,골목상권,1000613,개봉로20길,105,60,45
2014,2,A,골목상권,1000612,개봉로1길,40,22,18
2014,2,A,골목상권,1000611,개봉로17다길,128,60,68
2014,2,A,골목상권,1000610,개봉로17길,858,423,435
2014,2,A,골목상권,1000609,개봉로11길,58,13,45
2014,2,A,골목상권,1000608,화곡로64길,2240,1173,1067
2014,2,A,골목상권,1000607,화곡로59길,451,182,269
2014,2,A,골목상권,1000606,화곡로44나길,793,657,136
2014,2,A,골목상권,1000605,화곡로31길,1321,540,781
2014,2,A,골목상권,1000604,화곡로20길,473,309,164
2014,2,A,골목상권,1000603,화곡로13길,253,87,166
2014,2,A,골목상권,1000602,초원로16길,453,232,221
2014,2,A,골목상권,1000601,초록마을로8길,182,25,157
2014,2,A,골목상권,1000600,초록마을로3길,41,19,22
2014,2,A,골목상권,1000599,월정로20길,5,1,4
2014,2,A,골목상권,1000598,우장산로6길,290,161,129
2014,2,A,골목상권,1000597,양천로73가길,1380,913,467
2014,2,A,골목상권,1000596,양천로71길,231,140,91
2014,2,A,골목상권,1000595,양천로49길,838,662,176
2014,2,A,골목상권,1000594,양천로26길,90,41,49
2014,2,A,골목상권,1000593,양천로24길,207,104,103
2014,2,A,골목상권,1000592,양천로24가길,676,300,376
2014,2,A,골목상권,1000591,양천로14길,362,258,104
2014,2,A,골목상권,1000590,방화대로6라길,685,458,227
2014,2,A,골목상권,1000589,방화대로21길,710,412,298
2014,2,A,골목상권,1000588,등촌로5길,9,2,7
2014,2,A,골목상권,1000587,등촌로55길,453,320,133
2014,2,A,골목상권,1000586,등촌로51길,11,11,0
2014,2,A,골목상권,1000585,등촌로39길,44,14,30
2014,2,A,골목상권,1000584,등촌로13길,241,126,115
2014,2,A,골목상권,1000583,남부순환로11길,441,325,116
2014,2,A,골목상권,1000582,까치산로4길,119,52,67
2014,2,A,골목상권,1000581,국회대로7길,332,204,128
2014,2,A,골목상권,1000580,공항대로8길,217,118,99
2014,2,A,골목상권,1000579,공항대로61길,225,144,81
2014,2,A,골목상권,1000578,공항대로59다길,816,594,222
2014,2,A,골목상권,1000577,공항대로59길,1143,766,377
2014,2,A,골목상권,1000576,공항대로55길,687,507,180
2014,2,A,골목상권,1000575,공항대로42길,11,7,4
2014,2,A,골목상권,1000574,공항대로38길,248,132,116
2014,2,A,골목상권,1000573,곰달래로60길,543,288,255
2014,2,A,골목상권,1000572,곰달래로53길,58,11,47
2014,2,A,골목상권,1000571,곰달래로47길,35,12,23
2014,2,A,골목상권,1000570,곰달래로31길,13,11,2
2014,2,A,골목상권,1000569,곰달래로25길,538,211,327
2014,2,A,골목상권,1000568,개화동로25길,629,433,196
2014,2,A,골목상권,1000567,개화동로23길,100,60,40
2014,2,A,골목상권,1000566,강서로8길,123,74,49
2014,2,A,골목상권,1000565,강서로5라길,266,158,108
2014,2,A,골목상권,1000564,강서로5나길,103,58,45
2014,2,A,골목상권,1000563,강서로5가길,44,27,17
2014,2,A,골목상권,1000562,강서로47라길,56,32,24
2014,2,A,골목상권,1000561,강서로47길,391,196,195
2014,2,A,골목상권,1000560,강서로45다길,495,186,309
2014,2,A,골목상권,1000559,강서로45길,100,54,46
2014,2,A,골목상권,1000558,강서로35길,170,103,67
2014,2,A,골목상권,1000557,강서로29길,290,166,124
2014,2,A,골목상권,1000556,강서로18길,31,11,20
2014,2,A,골목상권,1000555,강서로17가길,96,39,57
2014,2,A,골목상권,1000554,강서로15길,282,155,127
2014,2,A,골목상권,1000553,가로공원로80길,112,62,50
2014,2,A,골목상권,1000552,가로공원로76가길,15,7,8
2014,2,A,골목상권,1000551,화곡로4길,286,118,168
2014,2,A,골목상권,1000550,화곡로3길,164,54,110
2014,2,A,골목상권,1000549,지양로7길,219,67,152
2014,2,A,골목상권,1000548,중앙로55길,350,185,165
2014,2,A,골목상권,1000547,중앙로51길,126,64,62
2014,2,A,골목상권,1000546,중앙로47길,85,13,72
2014,2,A,골목상권,1000545,중앙로45길,166,61,105
2014,2,A,골목상권,1000544,중앙로36길,2,2,0
2014,2,A,골목상권,1000543,중앙로32길,427,223,204
2014,2,A,골목상권,1000542,중앙로25길,260,75,185
2014,2,A,골목상권,1000541,은행정로7길,441,156,285
2014,2,A,골목상권,1000539,오목로5길,292,160,132
2014,2,A,골목상권,1000538,오목로3길,477,421,56
2014,2,A,골목상권,1000537,오목로30길,160,79,81
2014,2,A,골목상권,1000536,오목로23길,654,348,306
2014,2,A,골목상권,1000535,신월로20길,178,73,105
2014,2,A,골목상권,1000534,신월로15길,712,344,368
2014,2,A,골목상권,1000533,신목로6길,265,141,124
2014,2,A,골목상권,1000532,신목로5길,879,344,535
2014,2,A,골목상권,1000531,신목로2길,98,45,53
2014,2,A,골목상권,1000530,목동중앙서로8가길,206,111,95
2014,2,A,골목상권,1000529,목동중앙서로7길,225,88,137
2014,2,A,골목상권,1000528,목동중앙북로8길,445,183,262
2014,2,A,골목상권,1000527,목동중앙북로16길,235,68,167
2014,2,A,골목상권,1000526,목동중앙본로7길,85,29,56
2014,2,A,골목상권,1000525,목동중앙로3길,102,55,47
2014,2,A,골목상권,1000524,목동중앙로13나길,230,147,83
2014,2,A,골목상권,1000523,목동중앙남로3가길,557,383,174
2014,2,A,골목상권,1000522,목동로9길,2344,1519,825
2014,2,A,골목상권,1000521,목동로19길,971,419,552
2014,2,A,골목상권,1000519,목동동로12길,387,152,235
2014,2,A,골목상권,1000518,목동남로4길,10,5,5
2014,2,A,골목상권,1000517,남부순환로88길,299,118,181
2014,2,A,골목상권,1000516,남부순환로79길,466,352,114
2014,2,A,골목상권,1000515,남부순환로70길,573,388,185
2014,2,A,골목상권,1000514,남부순환로58길,144,76,68
2014,2,A,골목상권,1000513,남부순환로40길,17,8,9
2014,2,A,골목상권,1000512,남부순환로33길,1229,988,241
2014,2,A,골목상권,1000511,곰달래로5길,45,25,20
2014,2,A,골목상권,1000510,곰달래로3길,407,222,185
2014,2,A,골목상권,1000509,곰달래로2길,323,201,122
2014,2,A,골목상권,1000508,곰달래로10길,362,279,83
2014,2,A,골목상권,1000507,가로공원로58길,88,20,68
2014,2,A,골목상권,1000506,효창원로93길,99,54,45
2014,2,A,골목상권,1000505,토정로37길,158,73,85
2014,2,A,골목상권,1000504,월드컵로8길,2051,1070,981
2014,2,A,골목상권,1000503,월드컵로7길,4,2,2
2014,2,A,골목상권,1000502,월드컵로36길,113,32,81
2014,2,A,골목상권,1000501,월드컵로25길,240,124,116
2014,2,A,골목상권,1000500,월드컵로19길,356,145,211
2014,2,A,골목상권,1000499,월드컵로16길,2268,1275,993
2014,2,A,골목상권,1000498,월드컵로11길,194,82,112
2014,2,A,골목상권,1000497,월드컵로10길,1688,924,764
2014,2,A,골목상권,1000496,와우산로3길,229,157,72
2014,2,A,골목상권,1000495,와우산로29길,128,55,73
2014,2,A,골목상권,1000494,와우산로29가길,13,6,7
2014,2,A,골목상권,1000493,양화진길,463,327,136
2014,2,A,골목상권,1000492,양화로1길,4400,2284,2116
2014,2,A,골목상권,1000491,양화로11길,371,266,105
2014,2,A,골목상권,1000490,신촌로30길,23,11,12
2014,2,A,골목상권,1000489,신촌로28가길,107,40,67
2014,2,A,골목상권,1000488,신촌로12길,1137,567,570
2014,2,A,골목상권,1000487,숭문길,2709,1740,969
2014,2,A,골목상권,1000486,숭문8길,117,72,45
2014,2,A,골목상권,1000485,성지3길,513,273,240
2014,2,A,골목상권,1000484,성산로4길,2444,1639,805
2014,2,A,골목상권,1000483,성미산로32길,328,185,143
2014,2,A,골목상권,1000482,성미산로1길,502,402,100
2014,2,A,골목상권,1000481,성미산로11길,878,569,309
2014,2,A,골목상권,1000480,백범로16길,523,292,231
2014,2,A,골목상권,1000479,방울내로9안길,286,168,118
2014,2,A,골목상권,1000478,모래내로7길,237,122,115
2014,2,A,골목상권,1000477,매봉산로2길,2571,1702,869
2014,2,A,골목상권,1000476,망원로2길,201,130,71
2014,2,A,골목상권,1000475,망원로11길,872,485,387
2014,2,A,골목상권,1000474,만리재옛길,1087,462,625
2014,2,A,골목상권,1000473,마포대로4길,351,154,197
2014,2,A,골목상권,1000472,마포대로20길,1838,866,972
2014,2,A,골목상권,1000471,마포대로12길,72,40,32
2014,2,A,골목상권,1000470,동교로38길,154,62,92
2014,2,A,골목상권,1000469,동교로27길,3142,1531,1611
2014,2,A,골목상권,1000468,동교로25길,812,387,425
2014,2,A,골목상권,1000467,동교로19길,4753,2938,1815
2014,2,A,골목상권,1000466,동교로17길,779,398,381
2014,2,A,골목상권,1000465,독막로8길,420,209,211
2014,2,A,골목상권,1000464,독막로32길,489,210,279
2014,2,A,골목상권,1000463,독막로22길,71,41,30
2014,2,A,골목상권,1000462,도화길,1203,622,581
2014,2,A,골목상권,1000461,도화4길,384,141,243
2014,2,A,골목상권,1000460,대흥로28길,67,53,14
2014,2,A,골목상권,1000459,대흥로21길,565,118,447
2014,2,A,골목상권,1000458,광성로6길,110,76,34
2014,2,A,골목상권,1000457,홍제내길,101,59,42
2014,2,A,골목상권,1000456,홍연길,77,45,32
2014,2,A,골목상권,1000455,통일로39길,13,11,2
2014,2,A,골목상권,1000454,통일로37길,363,138,225
2014,2,A,골목상권,1000453,통일로11길,13,9,4
2014,2,A,골목상권,1000452,충정로6길,10100,6131,3969
2014,2,A,골목상권,1000451,충정로4길,2810,1910,900
2014,2,A,골목상권,1000450,증가로6길,199,87,112
2014,2,A,골목상권,1000449,증가로23나길,360,178,182
2014,2,A,골목상권,1000448,증가로20가길,290,95,195
2014,2,A,골목상권,1000447,증가로10길,179,93,86
2014,2,A,골목상권,1000446,응암로1길,327,240,87
2014,2,A,골목상권,1000445,연희로10길,89,60,29
2014,2,A,골목상권,1000444,신촌로37길,161,75,86
2014,2,A,골목상권,1000443,수색로8길,1478,1356,122
2014,2,A,골목상권,1000442,세무서길,346,131,215
2014,2,A,골목상권,1000440,세검정로1길,223,128,95
2014,2,A,골목상권,1000439,북아현로4길,360,98,262
2014,2,A,골목상권,1000438,모래내로15길,84,29,55
2014,2,A,골목상권,1000437,명지대길,329,239,90
2014,2,A,골목상권,1000436,독립문로8길,705,282,423
2014,2,A,골목상권,1000435,가재울로6길,22,12,10
2014,2,A,골목상권,1000434,통일로92길,60,31,29
2014,2,A,골목상권,1000433,통일로87길,181,72,109
2014,2,A,골목상권,1000432,통일로78길,201,67,134
2014,2,A,골목상권,1000430,진흥로1길,508,175,333
2014,2,A,골목상권,1000429,진흥로12길,330,138,192
2014,2,A,골목상권,1000428,증산서길,355,274,81
2014,2,A,골목상권,1000427,증산로9길,86,35,51
2014,2,A,골목상권,1000426,증산로5길,687,346,341
2014,2,A,골목상권,1000425,증산로21길,248,174,74
2014,2,A,골목상권,1000424,증산로17길,540,315,225
2014,2,A,골목상권,1000423,증산로15길,168,65,103
2014,2,A,골목상권,1000422,증산로13길,57,32,25
2014,2,A,골목상권,1000421,응암로34길,80,47,33
2014,2,A,골목상권,1000420,응암로22길,176,60,116
2014,2,A,골목상권,1000419,응암로14길,303,82,221
2014,2,A,골목상권,1000418,응암로13길,212,75,137
2014,2,A,골목상권,1000417,응암로12길,194,85,109
2014,2,A,골목상권,1000416,은평로8길,254,146,108
2014,2,A,골목상권,1000415,은평로3길,288,93,195
2014,2,A,골목상권,1000414,은평로20길,22,8,14
2014,2,A,골목상권,1000413,은평로13길,565,382,183
2014,2,A,골목상권,1000412,은평로10길,298,186,112
2014,2,A,골목상권,1000411,연서로5길,43,15,28
2014,2,A,골목상권,1000410,연서로41길,220,74,146
2014,2,A,골목상권,1000409,연서로3길,121,57,64
2014,2,A,골목상권,1000408,연서로34길,115,33,82
2014,2,A,골목상권,1000407,연서로33길,24,7,17
2014,2,A,골목상권,1000406,연서로29길,273,86,187
2014,2,A,골목상권,1000405,연서로28길,618,294,324
2014,2,A,골목상권,1000404,연서로27길,56,27,29
2014,2,A,골목상권,1000403,연서로21길,430,244,186
2014,2,A,골목상권,1000402,연서로17길,956,380,576
2014,2,A,골목상권,1000401,연서로16길,272,110,162
2014,2,A,골목상권,1000400,연서로13길,682,228,454
2014,2,A,골목상권,1000399,연서로11길,181,96,85
2014,2,A,골목상권,1000398,역말로9길,19,15,4
2014,2,A,골목상권,1000397,수색로18길,696,580,116
2014,2,A,골목상권,1000396,서오릉로8길,13,7,6
2014,2,A,골목상권,1000395,서오릉로21길,423,160,263
2014,2,A,골목상권,1000394,불광천길,154,77,77
2014,2,A,골목상권,1000393,갈현로7길,951,263,688
2014,2,A,골목상권,1000392,갈현로41길,80,26,54
2014,2,A,골목상권,1000391,갈현로33길,26,7,19
2014,2,A,골목상권,1000390,갈현로1길,111,45,66
2014,2,A,골목상권,1000389,가좌로7길,48,20,28
2014,2,A,골목상권,1000388,한글비석로44길,488,266,222
2014,2,A,골목상권,1000387,한글비석로24길,350,140,210
2014,2,A,골목상권,1000386,한글비석로22길,565,256,309
2014,2,A,골목상권,1000385,석계로1길,114,72,42
2014,2,A,골목상권,1000384,상계로9가길,233,95,138
2014,2,A,골목상권,1000382,상계로12길,10,6,4
2014,2,A,골목상권,1000381,동일로242길,546,422,124
2014,2,A,골목상권,1000380,동일로192길,459,247,212
2014,2,A,골목상권,1000379,동일로173가길,2211,1252,959
2014,2,A,골목상권,1000378,공릉로58길,94,36,58
2014,2,A,골목상권,1000377,해등로16길,49,38,11
2014,2,A,골목상권,1000376,우이천로4다길,173,99,74
2014,2,A,골목상권,1000375,우이천로32길,93,44,49
2014,2,A,골목상권,1000374,시루봉로23길,46,19,27
2014,2,A,골목상권,1000373,삼양로144길,58,43,15
2014,2,A,골목상권,1000372,방학로6가길,161,91,70
2014,2,A,골목상권,1000371,방학로5길,151,84,67
2014,2,A,골목상권,1000370,방학로15길,340,235,105
2014,2,A,골목상권,1000369,방학로10길,102,64,38
2014,2,A,골목상권,1000367,도봉산4길,301,270,31
2014,2,A,골목상권,1000366,도봉로181길,264,129,135
2014,2,A,골목상권,1000365,도봉로169나길,229,111,118
2014,2,A,골목상권,1000364,도봉로156길,324,163,161
2014,2,A,골목상권,1000363,도봉로152가길,763,583,180
2014,2,A,골목상권,1000362,도봉로147길,601,349,252
2014,2,A,골목상권,1000360,도봉로114길,459,141,318
2014,2,A,골목상권,1000359,도봉로109길,18,7,11
2014,2,A,골목상권,1000358,도당로29길,878,542,336
2014,2,A,골목상권,1000357,도당로19길,159,74,85
2014,2,A,골목상권,1000356,도당로13바길,180,63,117
2014,2,A,골목상권,1000355,도당로13가길,126,55,71
2014,2,A,골목상권,1000354,덕릉로60길,57,29,28
2014,2,A,골목상권,1000353,노해로63다길,482,232,250
2014,2,A,골목상권,1000352,노해로60길,276,131,145
2014,2,A,골목상권,1000351,한천로140길,124,76,48
2014,2,A,골목상권,1000350,한천로139가길,44,27,17
2014,2,A,골목상권,1000349,한천로132길,280,105,175
2014,2,A,골목상권,1000348,한천로130길,271,111,160
2014,2,A,골목상권,1000347,한천로124나길,90,42,48
2014,2,A,골목상권,1000346,한천로109길,603,288,315
2014,2,A,골목상권,1000345,인수봉로79길,173,44,129
2014,2,A,골목상권,1000344,인수봉로72길,81,35,46
2014,2,A,골목상권,1000343,인수봉로56길,9,1,8
2014,2,A,골목상권,1000342,오패산로67길,537,297,240
2014,2,A,골목상권,1000341,오패산로52길,77,24,53
2014,2,A,골목상권,1000340,오패산로30길,1,0,1
2014,2,A,골목상권,1000339,수유로12길,230,144,86
2014,2,A,골목상권,1000338,솔샘로65길,515,236,279
2014,2,A,골목상권,1000337,솔매로50길,704,283,421
2014,2,A,골목상권,1000336,솔매로45길,231,91,140
2014,2,A,골목상권,1000335,솔매로41길,85,28,57
2014,2,A,골목상권,1000334,삼양로93길,16,4,12
2014,2,A,골목상권,1000333,삼양로77길,347,132,215
2014,2,A,골목상권,1000332,삼양로54길,3,2,1
2014,2,A,골목상권,1000331,삼양로41길,299,137,162
2014,2,A,골목상권,1000329,삼양로24길,70,29,41
2014,2,A,골목상권,1000328,삼양로20길,131,47,84
2014,2,A,골목상권,1000327,삼각산로28길,761,451,310
2014,2,A,골목상권,1000326,도봉로99길,163,96,67
2014,2,A,골목상권,1000325,도봉로8길,251,179,72
2014,2,A,골목상권,1000324,도봉로76길,318,168,150
2014,2,A,골목상권,1000323,도봉로67길,8,4,4
2014,2,A,골목상권,1000322,도봉로45길,162,95,67
2014,2,A,골목상권,1000321,도봉로18길,569,254,315
2014,2,A,골목상권,1000320,도봉로13길,41,20,21
2014,2,A,골목상권,1000319,덕릉로41길,685,593,92
2014,2,A,골목상권,1000318,덕릉로40길,863,697,166
2014,2,A,골목상권,1000317,노해로33길,27,10,17
2014,2,A,골목상권,1000315,노해로17길,177,82,95
2014,2,A,골목상권,1000314,화랑로40길,123,66,57
2014,2,A,골목상권,1000313,화랑로32길,394,290,104
2014,2,A,골목상권,1000312,화랑로1길,183,99,84
2014,2,A,골목상권,1000311,화랑로19길,338,184,154
2014,2,A,골목상권,1000310,화랑로14길,49,22,27
2014,2,A,골목상권,1000309,화랑로13길,82,40,42
2014,2,A,골목상권,1000308,한천로76길,118,73,45
2014,2,A,골목상권,1000307,한천로101가길,43,27,16
2014,2,A,골목상권,1000306,창경궁로43길,19,14,5
2014,2,A,골목상권,1000305,지봉로20길,154,109,45
2014,2,A,골목상권,1000304,종암로5길,109,79,30
2014,2,A,골목상권,1000303,종암로24가길,252,122,130
2014,2,A,골목상권,1000302,종암로21길,110,43,67
2014,2,A,골목상권,1000301,종암로19길,366,99,267
2014,2,A,골목상권,1000300,종암로16길,57,24,33
2014,2,A,골목상권,1000299,정릉로8길,161,97,64
2014,2,A,골목상권,1000298,정릉로27길,197,84,113
2014,2,A,골목상권,1000296,장위로50길,964,550,414
2014,2,A,골목상권,1000295,장월로1길,343,129,214
2014,2,A,골목상권,1000294,인촌로6길,1944,1031,913
2014,2,A,골목상권,1000293,인촌로5길,25,4,21
2014,2,A,골목상권,1000292,인촌로24길,287,127,160
2014,2,A,골목상권,1000291,개운사길,2651,1746,905
2014,2,A,골목상권,1000290,인촌로1길,144,98,46
2014,2,A,골목상권,1000289,인촌로17가길,2881,1168,1713
2014,2,A,골목상권,1000288,오패산로4길,423,161,262
2014,2,A,골목상권,1000287,오패산로3길,1224,662,562
2014,2,A,골목상권,1000286,오패산로19길,33,19,14
2014,2,A,골목상권,1000285,안암로5길,564,357,207
2014,2,A,골목상권,1000284,아리랑로4길,673,261,412
2014,2,A,골목상권,1000283,솔샘로6길,124,67,57
2014,2,A,골목상권,1000282,성북로8길,28,13,15
2014,2,A,골목상권,1000281,삼양로8길,56,38,18
2014,2,A,골목상권,1000280,삼선교로16가길,665,371,294
2014,2,A,골목상권,1000279,삼선교로10다길,91,34,57
2014,2,A,골목상권,1000278,삼선교로10길,221,96,125
2014,2,A,골목상권,1000277,보문로32길,890,397,493
2014,2,A,골목상권,1000276,보문로31길,854,368,486
2014,2,A,골목상권,1000274,보문로13길,551,338,213
2014,2,A,골목상권,1000273,보국문로16길,275,190,85
2014,2,A,골목상권,1000270,동소문로26가길,262,161,101
2014,2,A,골목상권,1000269,동소문로15길,63,26,37
2014,2,A,골목상권,1000268,동소문로13길,763,415,348
2014,2,A,골목상권,1000267,돌곶이로8길,202,117,85
2014,2,A,골목상권,1000266,돌곶이로41길,40,19,21
2014,2,A,골목상권,1000265,돌곶이로28길,203,115,88
2014,2,A,골목상권,1000264,돌곶이로27길,44,27,17
2014,2,A,골목상권,1000263,돌곶이로22길,116,64,52
2014,2,A,골목상권,1000261,길음로7길,8,4,4
2014,2,A,골목상권,1000260,중랑천로10길,652,363,289
2014,2,A,골목상권,1000259,용마산로94길,422,263,159
2014,2,A,골목상권,1000258,용마산로118길,481,207,274
2014,2,A,골목상권,1000257,용마산로112길,233,111,122
2014,2,A,골목상권,1000256,용마산로100길,468,331,137
2014,2,A,골목상권,1000255,신내로7가길,286,66,220
2014,2,A,골목상권,1000254,사가정로54길,89,31,58
2014,2,A,골목상권,1000253,사가정로42길,69,22,47
2014,2,A,골목상권,1000252,봉화산로56길,558,142,416
2014,2,A,골목상권,1000251,봉화산로4길,264,105,159
2014,2,A,골목상권,1000250,봉화산로30길,333,221,112
2014,2,A,골목상권,1000249,봉우재로33길,50,21,29
2014,2,A,골목상권,1000248,면목로78길,229,128,101
2014,2,A,골목상권,1000247,면목로56길,255,209,46
2014,2,A,골목상권,1000246,면목로55길,410,131,279
2014,2,A,골목상권,1000245,면목로49길,533,169,364
2014,2,A,골목상권,1000244,면목로48길,94,49,45
2014,2,A,골목상권,1000243,면목로45길,85,39,46
2014,2,A,골목상권,1000242,면목로33길,420,171,249
2014,2,A,골목상권,1000241,면목로21길,29,17,12
2014,2,A,골목상권,1000240,망우로73길,7,3,4
2014,2,A,골목상권,1000239,망우로68길,93,49,44
2014,2,A,골목상권,1000238,동일로163길,100,69,31
2014,2,A,골목상권,1000237,동일로157길,167,89,78
2014,2,A,골목상권,1000236,동일로149길,1094,817,277
2014,2,A,골목상권,1000235,동일로140길,225,85,140
2014,2,A,골목상권,1000234,동일로139길,55,32,23
2014,2,A,골목상권,1000233,동일로139가길,1014,610,404
2014,2,A,골목상권,1000232,동일로130길,95,26,69
2014,2,A,골목상권,1000231,동일로123길,187,93,94
2014,2,A,골목상권,1000230,동일로112길,194,76,118
2014,2,A,골목상권,1000229,동일로101길,305,114,191
2014,2,A,골목상권,1000228,동일로100길,32,13,19
2014,2,A,골목상권,1000227,답십리로75길,81,43,38
2014,2,A,골목상권,1000226,공릉로2길,540,272,268
2014,2,A,골목상권,1000225,공릉로12가길,50,35,15
2014,2,A,골목상권,1000224,겸재로54길,96,53,43
2014,2,A,골목상권,1000223,겸재로36길,313,255,58
2014,2,A,골목상권,1000222,겸재로29길,426,198,228
2014,2,A,골목상권,1000221,휘경로3길,190,106,84
2014,2,A,골목상권,1000220,휘경로2길,6,2,4
2014,2,A,골목상권,1000219,휘경로23길,19,1,18
2014,2,A,골목상권,1000218,휘경로14길,78,35,43
2014,2,A,골목상권,1000217,한천로46길,357,120,237
2014,2,A,골목상권,1000216,한천로40길,280,163,117
2014,2,A,골목상권,1000215,한천로33길,83,31,52
2014,2,A,골목상권,1000214,한천로14길,550,335,215
2014,2,A,골목상권,1000213,천호대로97길,342,219,123
2014,2,A,골목상권,1000212,천호대로77길,2011,1104,907
2014,2,A,골목상권,1000211,천호대로45길,175,121,54
2014,2,A,골목상권,1000210,천호대로17길,1820,1119,701
2014,2,A,골목상권,1000209,천호대로12길,791,548,243
2014,2,A,골목상권,1000208,천장산로7길,1294,819,475
2014,2,A,골목상권,1000207,제기로5길,195,108,87
2014,2,A,골목상권,1000206,제기로21길,221,148,73
2014,2,A,골목상권,1000205,전농로4길,662,431,231
2014,2,A,골목상권,1000204,전농로3길,89,38,51
2014,2,A,골목상권,1000203,전농로29길,273,115,158
2014,2,A,골목상권,1000202,장한로8길,746,431,315
2014,2,A,골목상권,1000201,장한로5길,3554,2441,1113
2014,2,A,골목상권,1000200,장한로27길,143,49,94
2014,2,A,골목상권,1000199,장한로27가길,358,181,177
2014,2,A,골목상권,1000198,장한로26길,507,258,249
2014,2,A,골목상권,1000197,장한로26가길,292,147,145
2014,2,A,골목상권,1000196,장한로25길,930,429,501
2014,2,A,골목상권,1000195,장한로14길,208,179,29
2014,2,A,골목상권,1000194,이문로42길,219,81,138
2014,2,A,골목상권,1000193,왕산로43길,932,467,465
2014,2,A,골목상권,1000192,왕산로33길,172,110,62
2014,2,A,골목상권,1000191,왕산로32길,9,6,3
2014,2,A,골목상권,1000190,약령시로17길,247,139,108
2014,2,A,골목상권,1000189,서울시립대로4길,759,508,251
2014,2,A,골목상권,1000188,서울시립대로29길,187,112,75
2014,2,A,골목상권,1000187,서울시립대로16길,102,27,75
2014,2,A,골목상권,1000186,사가정로2길,139,99,40
2014,2,A,골목상권,1000185,사가정로23가길,102,70,32
2014,2,A,골목상권,1000184,사가정로13길,299,116,183
2014,2,A,골목상권,1000183,무학로45길,345,197,148
2014,2,A,골목상권,1000182,무학로16길,1081,933,148
2014,2,A,골목상권,1000181,망우로21길,180,96,84
2014,2,A,골목상권,1000180,망우로18길,614,283,331
2014,2,A,골목상권,1000179,망우로18가길,69,25,44
2014,2,A,골목상권,1000178,답십리로72길,8,6,2
2014,2,A,골목상권,1000177,답십리로69길,663,314,349
2014,2,A,골목상권,1000176,답십리로68길,144,92,52
2014,2,A,골목상권,1000175,답십리로64길,358,209,149
2014,2,A,골목상권,1000174,답십리로63길,67,44,23
2014,2,A,골목상권,1000173,답십리로60길,12,6,6
2014,2,A,골목상권,1000172,답십리로56길,8,6,2
2014,2,A,골목상권,1000171,답십리로23길,2,2,0
2014,2,A,골목상권,1000170,난계로30길,553,363,190
2014,2,A,골목상권,1000168,경희대로3길,247,166,81
2014,2,A,골목상권,1000167,천호대로129길,190,63,127
2014,2,A,골목상권,1000166,천호대로123길,301,144,157
2014,2,A,골목상권,1000165,천호대로109길,1429,801,628
2014,2,A,골목상권,1000164,자양번영로3길,76,34,42
2014,2,A,골목상권,1000162,자양로50길,27,10,17
2014,2,A,골목상권,1000161,자양로45길,512,283,229
2014,2,A,골목상권,1000160,자양로26길,336,117,219
2014,2,A,골목상권,1000159,자양로15길,337,207,130
2014,2,A,골목상권,1000158,자양로11길,1230,631,599
2014,2,A,골목상권,1000157,용마산로3길,827,481,346
2014,2,A,골목상권,1000156,용마산로21길,152,71,81
2014,2,A,골목상권,1000155,아차산로78길,1616,1052,564
2014,2,A,골목상권,1000154,아차산로65길,568,377,191
2014,2,A,골목상권,1000153,아차산로55길,588,273,315
2014,2,A,골목상권,1000152,아차산로51길,230,141,89
2014,2,A,골목상권,1000151,아차산로40길,478,268,210
2014,2,A,골목상권,1000150,면목로17길,241,151,90
2014,2,A,골목상권,1000149,뚝섬로64길,365,200,165
2014,2,A,골목상권,1000148,뚝섬로58길,202,85,117
2014,2,A,골목상권,1000147,뚝섬로54길,115,66,49
2014,2,A,골목상권,1000146,뚝섬로48길,728,334,394
2014,2,A,골목상권,1000145,뚝섬로24길,105,36,69
2014,2,A,골목상권,1000144,뚝섬로23길,96,65,31
2014,2,A,골목상권,1000143,동일로24길,9,2,7
2014,2,A,골목상권,1000142,동일로18길,132,65,67
2014,2,A,골목상권,1000141,능동로4길,210,82,128
2014,2,A,골목상권,1000140,능동로3길,162,73,89
2014,2,A,골목상권,1000139,능동로34길,742,455,287
2014,2,A,골목상권,1000138,능동로19길,326,205,121
2014,2,A,골목상권,1000137,능동로13길,286,86,200
2014,2,A,골목상권,1000136,긴고랑로9길,72,34,38
2014,2,A,골목상권,1000135,긴고랑로8길,230,206,24
2014,2,A,골목상권,1000134,긴고랑로7길,454,228,226
2014,2,A,골목상권,1000133,긴고랑로20길,499,225,274
2014,2,A,골목상권,1000132,광나루로52길,1552,784,768
2014,2,A,골목상권,1000131,광나루로40길,73,34,39
2014,2,A,골목상권,1000130,광나루로37길,244,148,96
2014,2,A,골목상권,1000129,광나루로36길,35,21,14
2014,2,A,골목상권,1000128,광나루로24길,94,54,40
2014,2,A,골목상권,1000127,광나루로12길,898,582,316
2014,2,A,골목상권,1000126,한림말길,88,55,33
2014,2,A,골목상권,1000124,청계천로10나길,1699,986,713
2014,2,A,골목상권,1000123,장터길,33,9,24
2014,2,A,골목상권,1000122,용답중앙길,80,44,36
2014,2,A,골목상권,1000121,용답29길,1777,851,926
2014,2,A,골목상권,1000120,왕십리로6길,1259,719,540
2014,2,A,골목상권,1000119,왕십리로31길,105,51,54
2014,2,A,골목상권,1000118,왕십리로26길,3343,2171,1172
2014,2,A,골목상권,1000117,왕십리로21길,141,45,96
2014,2,A,골목상권,1000116,왕십리로14길,1375,1147,228
2014,2,A,골목상권,1000115,아차산로5길,1797,1299,498
2014,2,A,골목상권,1000114,아차산로15길,3751,2766,985
2014,2,A,골목상권,1000113,아차산로11길,3301,2127,1174
2014,2,A,골목상권,1000112,송정4가길,1186,651,535
2014,2,A,골목상권,1000111,송정12라길,177,125,52
2014,2,A,골목상권,1000110,성수일로6길,2878,1709,1169
2014,2,A,골목상권,1000109,성수이로7길,612,350,262
2014,2,A,골목상권,1000108,성수이로18길,2275,1650,625
2014,2,A,골목상권,1000107,성덕정길,604,379,225
2014,2,A,골목상권,1000106,성덕정17길,204,114,90
2014,2,A,골목상권,1000105,서울숲2길,1533,786,747
2014,2,A,골목상권,1000104,상원길,1404,925,479
2014,2,A,골목상권,1000103,상원12길,147,94,53
2014,2,A,골목상권,1000102,사근동길,27,18,9
2014,2,A,골목상권,1000101,무학봉길,8,7,1
2014,2,A,골목상권,1000100,무학봉28길,140,62,78
2014,2,A,골목상권,1000099,무학로6길,335,198,137
2014,2,A,골목상권,1000098,무수막길,103,53,50
2014,2,A,골목상권,1000097,매봉길,20,10,10
2014,2,A,골목상권,1000096,마조로1길,193,73,120
2014,2,A,골목상권,1000095,마조로16길,839,583,256
2014,2,A,골목상권,1000094,마장로39길,17,15,2
2014,2,A,골목상권,1000093,마장로27길,91,32,59
2014,2,A,골목상권,1000091,둘레9길,517,321,196
2014,2,A,골목상권,1000090,금호산길,360,131,229
2014,2,A,골목상권,1000089,금호산2길,32,13,19
2014,2,A,골목상권,1000088,고산자로6길,15675,6612,9063
2014,2,A,골목상권,1000087,후암로28길,168,69,99
2014,2,A,골목상권,1000086,효창원로39길,47,30,17
2014,2,A,골목상권,1000085,회나무로13길,38,25,13
2014,2,A,골목상권,1000084,한남대로20길,813,499,314
2014,2,A,골목상권,1000082,한강대로7길,384,280,104
2014,2,A,골목상권,1000081,한강대로62길,693,504,189
2014,2,A,골목상권,1000080,한강대로52길,5995,1976,4019
2014,2,A,골목상권,1000079,한강대로43길,4766,3123,1643
2014,2,A,골목상권,1000078,한강대로15길,1801,409,1392
2014,2,A,골목상권,1000077,한강대로104길,4903,3592,1311
2014,2,A,골목상권,1000076,청파로73길,1613,870,743
2014,2,A,골목상권,1000075,청파로71길,248,135,113
2014,2,A,골목상권,1000074,청파로47나길,434,185,249
2014,2,A,골목상권,1000073,청파로47길,823,373,450
2014,2,A,골목상권,1000072,장문로45길,79,8,71
2014,2,A,골목상권,1000071,이태원로54길,1774,1116,658
2014,2,A,골목상권,1000070,이태원로27길,477,288,189
2014,2,A,골목상권,1000069,이촌로22길,197,117,80
2014,2,A,골목상권,1000068,원효로89길,902,736,166
2014,2,A,골목상권,1000067,원효로53길,717,457,260
2014,2,A,골목상권,1000066,원효로41길,2588,1864,724
2014,2,A,골목상권,1000065,원효로19길,910,671,239
2014,2,A,골목상권,1000064,우사단로4길,160,119,41
2014,2,A,골목상권,1000063,우사단로14길,1746,986,760
2014,2,A,골목상권,1000062,우사단로10길,54,29,25
2014,2,A,골목상권,1000061,신흥로20길,215,109,106
2014,2,A,골목상권,1000060,소월로20길,124,41,83
2014,2,A,골목상권,1000059,서빙고로71길,476,288,188
2014,2,A,골목상권,1000058,백범로90길,290,163,127
2014,2,A,골목상권,1000057,백범로79길,948,612,336
2014,2,A,골목상권,1000056,두텁바위로1길,2374,1359,1015
2014,2,A,골목상권,1000055,대사관로34길,325,180,145
2014,2,A,골목상권,1000054,녹사평대로46길,32,15,17
2014,2,A,골목상권,1000053,녹사평대로40나길,20,7,13
2014,2,A,골목상권,1000052,녹사평대로32길,385,189,196
2014,2,A,골목상권,1000051,녹사평대로26길,2026,1204,822
2014,2,A,골목상권,1000050,녹사평대로11길,259,168,91
2014,2,A,골목상권,1000049,퇴계로90길,468,192,276
2014,2,A,골목상권,1000048,퇴계로8길,2545,1390,1155
2014,2,A,골목상권,1000047,퇴계로56길,765,596,169
2014,2,A,골목상권,1000046,퇴계로46길,1890,753,1137
2014,2,A,골목상권,1000045,퇴계로18길,2637,1276,1361
2014,2,A,골목상권,1000044,퇴계로12길,1088,458,630
2014,2,A,골목상권,1000043,청구로1길,214,107,107
2014,2,A,골목상권,1000042,청구로17길,1659,763,896
2014,2,A,골목상권,1000041,장충단로8길,4136,1262,2874
2014,2,A,골목상권,1000040,삼일대로4길,1285,938,347
2014,2,A,골목상권,1000039,명동길,34330,18294,16036
2014,2,A,골목상권,1000037,동호로20길,912,414,498
2014,2,A,골목상권,1000036,동호로15길,5095,2724,2371
2014,2,A,골목상권,1000035,동호로11길,11,9,2
2014,2,A,골목상권,1000034,동호로10길,4210,2179,2031
2014,2,A,골목상권,1000033,다산로39길,923,572,351
2014,2,A,골목상권,1000032,다산로38길,1359,744,615
2014,2,A,골목상권,1000031,다산로36길,45,27,18
2014,2,A,골목상권,1000030,다산로33길,313,185,128
2014,2,A,골목상권,1000029,난계로21길,176,117,59
2014,2,A,골목상권,1000028,난계로11길,1433,899,534
2014,2,A,골목상권,1000026,평창길,161,66,95
2014,2,A,골목상권,1000025,통일로12길,129,40,89
2014,2,A,골목상권,1000024,창신길,239,66,173
2014,2,A,골목상권,1000023,창신5길,2,0,2
2014,2,A,골목상권,1000022,창신2길,45,27,18
2014,2,A,골목상권,1000021,창경궁로35길,1305,380,925
2014,2,A,골목상권,1000020,지봉로8길,152,68,84
2014,2,A,골목상권,1000019,종로65길,513,262,251
2014,2,A,골목상권,1000016,자하문로7길,504,295,209
2014,2,A,골목상권,1000015,이화장길,2011,1033,978
2014,2,A,골목상권,1000014,율곡로16길,69,25,44
2014,2,A,골목상권,1000013,율곡로10길,2100,1550,550
2014,2,A,골목상권,1000012,옥인길,474,224,250
2014,2,A,골목상권,1000011,숭인동길,13,6,7
2014,2,A,골목상권,1000010,성균관로5길,113,68,45
2014,2,A,골목상권,1000009,삼청로5길,413,159,254
2014,2,A,골목상권,1000008,북촌로5나길,1454,1037,417
2014,2,A,골목상권,1000007,북촌로5길,41,20,21
2014,2,A,골목상권,1000006,북촌로11길,17,7,10
2014,2,A,골목상권,1000005,백석동길,91,51,40
2014,2,A,골목상권,1000004,명륜길,7,5,2
2014,2,A,골목상권,1000003,돈화문로11가길,1028,564,464
2014,2,A,골목상권,1000001,계동길,777,378,399
